Reg_com,dep_com,siren,insee,nom_com,ptot_2023,pmun_2023,pcap_2023
84,01,210100012,01001,L'Abergement-Clémenciat,821,806,15
84,01,210100020,01002,L'Abergement-de-Varey,268,262,6
84,01,210100046,01004,Ambérieu-en-Bugey,14662,14288,374
84,01,210100053,01005,Ambérieux-en-Dombes,1806,1782,24
84,01,210100061,01006,Ambléon,113,113,0
84,01,210100079,01007,Ambronay,2946,2827,119
84,01,210100087,01008,Ambutrix,781,768,13
84,01,210100095,01009,Andert-et-Condon,332,324,8
84,01,210100103,01010,Anglefort,1116,1101,15
84,01,210100111,01011,Apremont,379,368,11
84,01,210100129,01012,Aranc,330,327,3
84,01,210100137,01013,Arandas,147,143,4
84,01,210100145,01014,Arbent,3427,3336,91
84,01,200053668,01015,Arboys en Bugey,678,663,15
84,01,210100160,01016,Arbigny,467,458,9
84,01,210100178,01017,Argis,456,445,11
84,01,210100194,01019,Armix,30,26,4
84,01,210100210,01021,Ars-sur-Formans,1520,1490,30
84,01,210100228,01022,Artemare,1229,1213,16
84,01,210100236,01023,Asnières-sur-Saône,76,76,0
84,01,210100244,01024,Attignat,3365,3299,66
84,01,200077220,01025,Bâgé-Dommartin,4172,4068,104
84,01,210100269,01026,Bâgé-le-Châtel,1045,977,68
84,01,210100277,01027,Balan,2699,2647,52
84,01,210100285,01028,Baneins,642,625,17
84,01,210100293,01029,Beaupont,691,683,8
84,01,210100301,01030,Beauregard,836,821,15
84,01,210100319,01031,Bellignat,3905,3671,234
84,01,210100327,01032,Béligneux,3443,3414,29
84,01,200083863,01033,Valserhône,16770,16434,336
84,01,210100343,01034,Belley,9550,9207,343
84,01,210100350,01035,Belleydoux,316,308,8
84,01,200086411,01036,Valromey-sur-Séran,1358,1334,24
84,01,210100376,01037,Bénonces,312,309,3
84,01,210100384,01038,Bény,778,759,19
84,01,210100400,01040,Béréziat,490,480,10
84,01,210100418,01041,Bettant,768,748,20
84,01,210100426,01042,Bey,298,291,7
84,01,210100434,01043,Beynost,4943,4829,114
84,01,210100442,01044,Billiat,645,628,17
84,01,210100459,01045,Birieux,288,285,3
84,01,210100467,01046,Biziat,920,912,8
84,01,210100475,01047,Blyes,1303,1269,34
84,01,210100491,01049,La Boisse,3412,3335,77
84,01,210100509,01050,Boissey,384,380,4
84,01,210100517,01051,Bolozon,92,91,1
84,01,210100525,01052,Bouligneux,338,332,6
84,01,210100533,01053,Bourg-en-Bresse,43363,41681,1682
84,01,210100541,01054,Bourg-Saint-Christophe,1517,1482,35
84,01,210100566,01056,Boyeux-Saint-Jérôme,355,351,4
84,01,210100574,01057,Boz,530,514,16
84,01,210100582,01058,Brégnier-Cordon,838,819,19
84,01,210100608,01060,Brénod,505,486,19
84,01,210100616,01061,Brens,1166,1133,33
84,01,210100624,01062,Bressolles,974,951,23
84,01,210100632,01063,Brion,577,561,16
84,01,210100640,01064,Briord,1114,1095,19
84,01,210100657,01065,Buellas,1889,1825,64
84,01,210100665,01066,La Burbanche,93,92,1
84,01,210100673,01067,Ceignes,271,259,12
84,01,210100681,01068,Cerdon,788,771,17
84,01,210100699,01069,Certines,1553,1514,39
84,01,210100715,01071,Cessy,5168,5045,123
84,01,210100723,01072,Ceyzériat,3265,3202,63
84,01,210100731,01073,Ceyzérieu,1020,995,25
84,01,210100749,01074,Chalamont,2612,2574,38
84,01,210100756,01075,Chaleins,1433,1402,31
84,01,210100764,01076,Chaley,125,122,3
84,01,210100772,01077,Challes-la-Montagne,194,192,2
84,01,210100780,01078,Challex,1631,1597,34
84,01,210100798,01079,Champagne-en-Valromey,852,822,30
84,01,200056695,01080,Champdor-Corcelles,652,636,16
84,01,210100814,01081,Champfromier,747,726,21
84,01,210100822,01082,Chanay,652,637,15
84,01,210100830,01083,Chaneins,982,965,17
84,01,210100848,01084,Chanoz-Châtenay,940,921,19
84,01,210100855,01085,La Chapelle-du-Châtelard,403,397,6
84,01,210100871,01087,Charix,289,279,10
84,01,210100889,01088,Charnoz-sur-Ain,930,902,28
84,01,210100897,01089,Château-Gaillard,2303,2254,49
84,01,210100905,01090,Châtenay,367,361,6
84,01,210100921,01092,Châtillon-la-Palud,1682,1622,60
84,01,210100939,01093,Châtillon-sur-Chalaronne,5171,4968,203
84,01,210100947,01094,Chavannes-sur-Reyssouze,773,761,12
84,01,200062537,01095,Nivigne et Suran,861,843,18
84,01,210100962,01096,Chaveyriat,1063,1033,30
84,01,200063121,01098,Chazey-Bons,1213,1175,38
84,01,210100996,01099,Chazey-sur-Ain,1650,1590,60
84,01,210101002,01100,Cheignieu-la-Balme,135,131,4
84,01,210101010,01101,Chevillard,159,152,7
84,01,210101028,01102,Chevroux,981,966,15
84,01,210101036,01103,Chevry,2276,2226,50
84,01,210101044,01104,Chézery-Forens,464,453,11
84,01,210101051,01105,Civrieux,1919,1867,52
84,01,210101069,01106,Cize,185,178,7
84,01,210101077,01107,Cleyzieu,140,136,4
84,01,210101085,01108,Coligny,1185,1161,24
84,01,210101093,01109,Collonges,2276,2230,46
84,01,210101101,01110,Colomieu,161,159,2
84,01,210101119,01111,Conand,135,133,2
84,01,210101127,01112,Condamine,473,467,6
84,01,210101135,01113,Condeissiat,829,817,12
84,01,210101143,01114,Confort,704,693,11
84,01,210101150,01115,Confrançon,1370,1339,31
84,01,210101168,01116,Contrevoz,510,496,14
84,01,210101176,01117,Conzieu,151,150,1
84,01,210101184,01118,Corbonod,1306,1279,27
84,01,210101218,01121,Corlier,117,116,1
84,01,210101234,01123,Cormoranche-sur-Saône,1195,1159,36
84,01,210101242,01124,Cormoz,710,702,8
84,01,210101259,01125,Corveissiat,617,604,13
84,01,210101275,01127,Courmangoux,514,506,8
84,01,210101283,01128,Courtes,302,301,1
84,01,210101291,01129,Crans,308,303,5
84,01,200086965,01130,Bresse Vallons,2406,2368,38
84,01,210101333,01133,Cressin-Rochefort,400,395,5
84,01,210101341,01134,Crottet,1836,1792,44
84,01,210101358,01135,Crozet,2269,2205,64
84,01,210101366,01136,Cruzilles-lès-Mépillat,943,922,21
84,01,200099406,01138,Culoz-Béon,3494,3426,68
84,01,210101390,01139,Curciat-Dongalon,449,444,5
84,01,210101408,01140,Curtafond,783,764,19
84,01,210101416,01141,Cuzieu,449,443,6
84,01,210101424,01142,Dagneux,4819,4765,54
84,01,210101432,01143,Divonne-les-Bains,10239,9999,240
84,01,210101457,01145,Dompierre-sur-Veyle,1214,1190,24
84,01,210101465,01146,Dompierre-sur-Chalaronne,439,436,3
84,01,210101473,01147,Domsure,512,509,3
84,01,210101481,01148,Dortan,1939,1892,47
84,01,210101499,01149,Douvres,1123,1094,29
84,01,210101507,01150,Drom,219,214,5
84,01,210101515,01151,Druillat,1168,1139,29
84,01,210101523,01152,Échallon,781,756,25
84,01,210101531,01153,Échenevex,2198,2123,75
84,01,210101556,01155,Évosges,147,142,5
84,01,210101564,01156,Faramans,855,843,12
84,01,210101572,01157,Fareins,2392,2339,53
84,01,210101580,01158,Farges,1072,1053,19
84,01,210101598,01159,Feillens,3438,3366,72
84,01,210101606,01160,Ferney-Voltaire,10784,10612,172
84,01,210101622,01162,Flaxieu,68,65,3
84,01,210101630,01163,Foissiat,2050,2016,34
84,01,210101655,01165,Francheleins,1619,1586,33
84,01,210101663,01166,Frans,2453,2417,36
84,01,210101671,01167,Garnerans,681,657,24
84,01,210101697,01169,Genouilleux,674,651,23
84,01,210101705,01170,Béard-Géovreissiat,1071,1044,27
84,01,210101713,01171,Géovreisset,871,830,41
84,01,210101739,01173,Gex,13467,13177,290
84,01,210101747,01174,Giron,178,176,2
84,01,210101754,01175,Gorrevod,813,790,23
84,01,210101770,01177,Grand-Corent,189,184,5
84,01,210101796,01179,Grièges,1936,1884,52
84,01,210101804,01180,Grilly,862,842,20
84,01,210101812,01181,Groissiat,1291,1241,50
84,01,210101838,01183,Guéreins,1516,1487,29
84,01,210101846,01184,Hautecourt-Romanèche,784,756,28
84,01,200086122,01185,Plateau d'Hauteville,4981,4824,157
84,01,200053676,01187,Haut Valromey,634,615,19
84,01,210101887,01188,Illiat,702,681,21
84,01,210101895,01189,Injoux-Génissiat,1150,1123,27
84,01,210101903,01190,Innimond,87,86,1
84,01,210101911,01191,Izenave,156,152,4
84,01,210101929,01192,Izernore,2327,2272,55
84,01,210101937,01193,Izieu,226,220,6
84,01,210101945,01194,Jassans-Riottier,6430,6337,93
84,01,210101952,01195,Jasseron,1861,1822,39
84,01,210101960,01196,Jayat,1261,1241,20
84,01,210101978,01197,Journans,391,377,14
84,01,210101986,01198,Joyeux,269,266,3
84,01,210101994,01199,Jujurieux,2173,2129,44
84,01,210102000,01200,Labalme,218,213,5
84,01,210102026,01202,Lagnieu,7340,7214,126
84,01,210102034,01203,Laiz,1336,1306,30
84,01,200053395,01204,Le Poizat-Lalleyriat,762,746,16
84,01,210102067,01206,Lantenay,280,274,6
84,01,210102075,01207,Lapeyrouse,326,314,12
84,01,210102083,01208,Lavours,136,135,1
84,01,210102091,01209,Léaz,812,796,16
84,01,210102109,01210,Lélex,235,231,4
84,01,210102117,01211,Lent,1436,1397,39
84,01,210102125,01212,Lescheroux,720,712,8
84,01,210102133,01213,Leyment,1361,1332,29
84,01,210102141,01214,Leyssard,166,161,5
84,01,200085306,01215,Surjoux-Lhopital,145,143,2
84,01,210102166,01216,Lhuis,914,893,21
84,01,210102190,01219,Lompnas,166,162,4
84,01,210102240,01224,Loyettes,3324,3296,28
84,01,210102257,01225,Lurcy,398,383,15
84,01,200084978,01227,Magnieu,654,642,12
84,01,210102281,01228,Maillat,682,668,14
84,01,210102299,01229,Malafretaz,1248,1226,22
84,01,210102307,01230,Mantenay-Montlin,317,310,7
84,01,210102315,01231,Manziat,1997,1948,49
84,01,210102323,01232,Marboz,2319,2275,44
84,01,210102331,01233,Marchamp,132,130,2
84,01,210102349,01234,Marignieu,170,167,3
84,01,210102356,01235,Marlieux,1266,1179,87
84,01,210102364,01236,Marsonnas,1050,1021,29
84,01,210102372,01237,Martignat,1740,1674,66
84,01,210102380,01238,Massieux,2767,2709,58
84,01,210102398,01239,Massignieu-de-Rives,640,631,9
84,01,210102406,01240,Matafelon-Granges,646,628,18
84,01,210102414,01241,Meillonnas,1414,1379,35
84,01,210102422,01242,Mérignat,138,136,2
84,01,210102430,01243,Messimy-sur-Saône,1299,1262,37
84,01,210102448,01244,Meximieux,8141,7998,143
84,01,210102455,01245,Bohas-Meyriat-Rignat,971,950,21
84,01,210102463,01246,Mézériat,2244,2204,40
84,01,210102471,01247,Mijoux,312,299,13
84,01,210102489,01248,Mionnay,2299,2245,54
84,01,210102497,01249,Miribel,10355,10202,153
84,01,210102505,01250,Misérieux,2249,1979,270
84,01,210102521,01252,Mogneneins,819,796,23
84,01,210102547,01254,Montagnat,2193,2142,51
84,01,210102554,01255,Montagnieu,662,651,11
84,01,210102570,01257,Montanges,361,351,10
84,01,210102588,01258,Montceaux,1216,1194,22
84,01,210102596,01259,Montcet,724,708,16
84,01,210102604,01260,Le Montellier,309,304,5
84,01,210102612,01261,Monthieux,705,681,24
84,01,210102620,01262,Montluel,6944,6864,80
84,01,210102638,01263,Montmerle-sur-Saône,3849,3761,88
84,01,210102646,01264,Montracol,1036,1017,19
84,01,210102653,01265,Montréal-la-Cluse,3580,3499,81
84,01,210102661,01266,Montrevel-en-Bresse,2619,2576,43
84,01,210102679,01267,Nurieux-Volognat,1035,1008,27
84,01,210102687,01268,Murs-et-Gélignieux,247,244,3
84,01,210102695,01269,Nantua,3587,3453,134
84,01,210102729,01272,Neuville-les-Dames,1511,1490,21
84,01,210102737,01273,Neuville-sur-Ain,1824,1799,25
84,01,210102745,01274,Les Neyrolles,645,632,13
84,01,210102752,01275,Neyron,2648,2596,52
84,01,210102760,01276,Niévroz,1652,1627,25
84,01,210102778,01277,Nivollet-Montgriffon,116,115,1
84,01,210102794,01279,Oncieu,82,77,5
84,01,210102802,01280,Ordonnaz,136,136,0
84,01,210102810,01281,Ornex,4766,4591,175
84,01,210102828,01282,Outriaz,265,258,7
84,01,210102836,01283,Oyonnax,22724,22271,453
84,01,210102844,01284,Ozan,713,700,13
84,01,210102851,01285,Parcieux,1366,1334,32
84,01,200059913,01286,Parves et Nattages,996,959,37
84,01,210102885,01288,Péron,2836,2777,59
84,01,210102893,01289,Péronnas,6735,6460,275
84,01,210102901,01290,Pérouges,1340,1309,31
84,01,210102919,01291,Perrex,852,844,8
84,01,210102935,01293,Peyriat,148,145,3
84,01,210102943,01294,Peyrieu,915,897,18
84,01,210102950,01295,Peyzieux-sur-Saône,686,676,10
84,01,210102968,01296,Pirajoux,424,413,11
84,01,210102976,01297,Pizay,906,890,16
84,01,210102984,01298,Plagne,159,157,2
84,01,210102992,01299,Le Plantay,599,589,10
84,01,210103016,01301,Polliat,2667,2606,61
84,01,210103024,01302,Pollieu,169,165,4
84,01,210103032,01303,Poncin,1735,1696,39
84,01,210103040,01304,Pont-d'Ain,2957,2904,53
84,01,210103057,01305,Pont-de-Vaux,2238,2195,43
84,01,210103065,01306,Pont-de-Veyle,1701,1637,64
84,01,210103073,01307,Port,861,840,21
84,01,210103081,01308,Pougny,817,803,14
84,01,210103099,01309,Pouillat,83,83,0
84,01,210103107,01310,Prémeyzel,253,249,4
84,01,210103115,01311,Prémillieu,44,44,0
84,01,210103131,01313,Prévessin-Moëns,9193,8948,245
84,01,210103149,01314,Priay,1756,1725,31
84,01,210103172,01317,Ramasse,337,331,6
84,01,210103180,01318,Rancé,753,735,18
84,01,210103198,01319,Relevant,476,467,9
84,01,210103206,01320,Replonges,3925,3833,92
84,01,210103214,01321,Revonnas,921,892,29
84,01,210103222,01322,Reyrieux,5192,5050,142
84,01,210103230,01323,Reyssouze,1035,1018,17
84,01,210103255,01325,Rignieux-le-Franc,1084,1065,19
84,01,210103289,01328,Romans,610,606,4
84,01,210103297,01329,Rossillon,159,157,2
84,01,210103305,01330,Ruffieu,187,180,7
84,01,210103313,01331,Saint-Alban,193,192,1
84,01,210103321,01332,Saint-André-de-Bâgé,815,792,23
84,01,210103339,01333,Saint-André-de-Corcy,3425,3366,59
84,01,210103347,01334,Saint-André-d'Huiriat,689,680,9
84,01,210103354,01335,Saint-André-le-Bouchoux,416,410,6
84,01,210103362,01336,Saint-André-sur-Vieux-Jonc,1209,1187,22
84,01,210103370,01337,Saint-Bénigne,1363,1336,27
84,01,200060143,01338,Groslée-Saint-Benoit,1279,1245,34
84,01,210103396,01339,Saint-Bernard,1528,1484,44
84,01,210103420,01342,Sainte-Croix,556,546,10
84,01,210103438,01343,Saint-Cyr-sur-Menthon,1863,1822,41
84,01,210103446,01344,Saint-Denis-lès-Bourg,6137,5971,166
84,01,210103453,01345,Saint-Denis-en-Bugey,2278,2245,33
84,01,210103461,01346,Saint-Didier-d'Aussiat,871,852,19
84,01,210103479,01347,Saint-Didier-de-Formans,2136,2072,64
84,01,210103487,01348,Saint-Didier-sur-Chalaronne,3069,3003,66
84,01,210103495,01349,Saint-Éloi,529,523,6
84,01,210103503,01350,Saint-Étienne-du-Bois,2575,2538,37
84,01,210103511,01351,Saint-Étienne-sur-Chalaronne,1629,1602,27
84,01,210103529,01352,Saint-Étienne-sur-Reyssouze,591,586,5
84,01,210103537,01353,Sainte-Euphémie,1752,1723,29
84,01,210103545,01354,Saint-Genis-Pouilly,14463,14274,189
84,01,210103552,01355,Saint-Genis-sur-Menthon,491,484,7
84,01,210103560,01356,Saint-Georges-sur-Renon,208,203,5
84,01,210103578,01357,Saint-Germain-de-Joux,509,502,7
84,01,210103586,01358,Saint-Germain-les-Paroisses,434,426,8
84,01,210103594,01359,Saint-Germain-sur-Renon,253,251,2
84,01,210103602,01360,Saint-Jean-de-Gonville,1982,1934,48
84,01,210103610,01361,Saint-Jean-de-Niost,1646,1600,46
84,01,210103628,01362,Saint-Jean-de-Thurigneux,821,809,12
84,01,210103636,01363,Saint-Jean-le-Vieux,1859,1786,73
84,01,210103644,01364,Saint-Jean-sur-Reyssouze,775,767,8
84,01,210103651,01365,Saint-Jean-sur-Veyle,1193,1165,28
84,01,210103669,01366,Sainte-Julie,1105,1088,17
84,01,210103677,01367,Saint-Julien-sur-Reyssouze,733,726,7
84,01,210103685,01368,Saint-Julien-sur-Veyle,857,842,15
84,01,210103693,01369,Saint-Just,980,955,25
84,01,210103701,01370,Saint-Laurent-sur-Saône,1702,1674,28
84,01,210103719,01371,Saint-Marcel,1248,1221,27
84,01,210103727,01372,Saint-Martin-de-Bavel,454,441,13
84,01,210103735,01373,Saint-Martin-du-Frêne,1038,1009,29
84,01,210103743,01374,Saint-Martin-du-Mont,1922,1877,45
84,01,210103750,01375,Saint-Martin-le-Châtel,807,788,19
84,01,210103768,01376,Saint-Maurice-de-Beynost,4107,4066,41
84,01,210103784,01378,Saint-Maurice-de-Gourdans,2755,2699,56
84,01,210103792,01379,Saint-Maurice-de-Rémens,774,762,12
84,01,210103800,01380,Saint-Nizier-le-Bouchoux,625,612,13
84,01,210103818,01381,Saint-Nizier-le-Désert,938,920,18
84,01,210103826,01382,Sainte-Olive,309,305,4
84,01,210103834,01383,Saint-Paul-de-Varax,1604,1583,21
84,01,210103842,01384,Saint-Rambert-en-Bugey,2201,2172,29
84,01,210103859,01385,Saint-Rémy,983,964,19
84,01,210103867,01386,Saint-Sorlin-en-Bugey,1177,1117,60
84,01,210103875,01387,Saint-Sulpice,259,256,3
84,01,210103883,01388,Saint-Trivier-de-Courtes,1124,1116,8
84,01,210103891,01389,Saint-Trivier-sur-Moignans,1866,1823,43
84,01,210103909,01390,Saint-Vulbas,1268,1247,21
84,01,210103917,01391,Salavre,281,273,8
84,01,210103925,01392,Samognat,682,654,28
84,01,210103933,01393,Sandrans,568,555,13
84,01,210103966,01396,Sault-Brénaz,1001,987,14
84,01,210103974,01397,Sauverny,1007,988,19
84,01,210103982,01398,Savigneux,1457,1438,19
84,01,210103990,01399,Ségny,2198,2145,53
84,01,210104006,01400,Seillonnaz,142,139,3
84,01,210104014,01401,Sergy,2282,2209,73
84,01,210104022,01402,Sermoyer,670,650,20
84,01,210104030,01403,Serrières-de-Briord,1350,1310,40
84,01,210104048,01404,Serrières-sur-Ain,136,134,2
84,01,210104055,01405,Servas,1301,1273,28
84,01,210104063,01406,Servignat,174,173,1
84,01,210104071,01407,Seyssel,1023,1006,17
84,01,210104089,01408,Simandre-sur-Suran,670,659,11
84,01,210104105,01410,Sonthonnax-la-Montagne,306,299,7
84,01,210104113,01411,Souclin,279,271,8
84,01,210104121,01412,Sulignat,623,611,12
84,01,210104154,01415,Talissieu,531,524,7
84,01,210104162,01416,Tenay,1024,1012,12
84,01,210104188,01418,Thil,1130,1103,27
84,01,210104196,01419,Thoiry,6299,6119,180
84,01,210104204,01420,Thoissey,1672,1664,8
84,01,210104212,01421,Torcieu,749,734,15
84,01,210104220,01422,Tossiat,1390,1354,36
84,01,210104238,01423,Toussieux,1191,1169,22
84,01,210104246,01424,Tramoyes,1867,1823,44
84,01,210104253,01425,La Tranclière,291,284,7
84,01,200057347,01426,Val-Revermont,2561,2506,55
84,01,210104279,01427,Trévoux,7108,6945,163
84,01,210104287,01428,Valeins,128,128,0
84,01,210104295,01429,Vandeins,729,714,15
84,01,210104303,01430,Varambon,648,636,12
84,01,210104311,01431,Vaux-en-Bugey,1253,1224,29
84,01,210104329,01432,Verjon,336,333,3
84,01,210104337,01433,Vernoux,310,306,4
84,01,210104345,01434,Versailleux,498,488,10
84,01,210104352,01435,Versonnex,2215,2146,69
84,01,210104360,01436,Vesancy,501,492,9
84,01,210104378,01437,Vescours,226,221,5
84,01,210104394,01439,Vésines,103,99,4
84,01,210104410,01441,Vieu-d'Izenave,761,743,18
84,01,210104436,01443,Villars-les-Dombes,5040,4946,94
84,01,210104444,01444,Villebois,1213,1195,18
84,01,210104451,01445,Villemotier,650,628,22
84,01,210104469,01446,Villeneuve,1599,1562,37
84,01,210104477,01447,Villereversure,1376,1345,31
84,01,210104485,01448,Villes,401,394,7
84,01,210104493,01449,Villette-sur-Ain,775,760,15
84,01,210104501,01450,Villieu-Loyes-Mollon,3827,3755,72
84,01,210104519,01451,Viriat,6817,6665,152
84,01,210104527,01452,Virieu-le-Grand,1151,1127,24
84,01,200086403,01453,Arvière-en-Valromey,729,712,17
84,01,210104543,01454,Virignin,1139,1118,21
84,01,210104568,01456,Vongnes,73,71,2
84,01,210104576,01457,Vonnas,3240,3198,42
32,02,210200010,02001,Abbécourt,516,505,11
32,02,210200028,02002,Achery,615,602,13
32,02,210200036,02003,Acy,1045,1019,26
32,02,210200044,02004,Agnicourt-et-Séchelles,190,185,5
32,02,210200051,02005,Aguilcourt,391,382,9
32,02,210200069,02006,Aisonville-et-Bernoville,269,260,9
32,02,210200077,02007,Aizelles,123,120,3
32,02,210200085,02008,Aizy-Jouy,303,299,4
32,02,210200093,02009,Alaincourt,537,531,6
32,02,210200101,02010,Allemant,175,171,4
32,02,210200119,02011,Ambleny,1214,1159,55
32,02,210200127,02012,Ambrief,73,73,0
32,02,210200135,02013,Amifontaine,399,390,9
32,02,210200143,02014,Amigny-Rouy,743,721,22
32,02,210200150,02015,Ancienville,75,74,1
32,02,210200168,02016,Andelain,223,215,8
32,02,210200176,02017,Anguilcourt-le-Sart,310,308,2
32,02,200084135,02018,Anizy-le-Grand,2641,2587,54
32,02,210200192,02019,Annois,364,359,5
32,02,210200200,02020,Any-Martin-Rieux,463,455,8
32,02,210200218,02021,Archon,83,82,1
32,02,210200226,02022,Arcy-Sainte-Restitue,407,401,6
32,02,210200234,02023,Armentières-sur-Ourcq,104,101,3
32,02,210200242,02024,Arrancy,49,49,0
32,02,210200259,02025,Artemps,369,367,2
32,02,210200275,02027,Assis-sur-Serre,218,210,8
32,02,210200283,02028,Athies-sous-Laon,2656,2597,59
32,02,210200291,02029,Attilly,363,351,12
32,02,210200309,02030,Aubencheul-aux-Bois,258,254,4
32,02,210200317,02031,Aubenton,667,659,8
32,02,210200325,02032,Aubigny-aux-Kaisnes,258,254,4
32,02,210200333,02033,Aubigny-en-Laonnois,104,102,2
32,02,210200341,02034,Audignicourt,125,122,3
32,02,210200358,02035,Audigny,292,283,9
32,02,210200366,02036,Augy,71,70,1
32,02,210200374,02037,Aulnois-sous-Laon,1410,1380,30
32,02,210200382,02038,Les Autels,61,60,1
32,02,210200390,02039,Autremencourt,177,174,3
32,02,210200408,02040,Autreppes,179,176,3
32,02,210200416,02041,Autreville,830,815,15
32,02,210200424,02042,Azy-sur-Marne,385,379,6
32,02,210200432,02043,Bagneux,65,64,1
32,02,210200440,02044,Bancigny,24,24,0
32,02,210200457,02046,Barenton-Bugny,567,557,10
32,02,210200465,02047,Barenton-Cel,109,108,1
32,02,210200473,02048,Barenton-sur-Serre,132,131,1
32,02,210200481,02049,Barisis-aux-Bois,753,740,13
32,02,210200499,02050,Barzy-en-Thiérache,322,320,2
32,02,210200507,02051,Barzy-sur-Marne,397,391,6
32,02,210200515,02052,Bassoles-Aulers,139,132,7
32,02,200056307,02053,Vallées en Champagne,579,573,6
32,02,200096410,02054,Bazoches-et-Saint-Thibaut,547,532,15
32,02,210200549,02055,Beaumé,89,87,2
32,02,210200556,02056,Beaumont-en-Beine,181,180,1
32,02,210200564,02057,Beaurevoir,1429,1411,18
32,02,210200572,02058,Beaurieux,862,851,11
32,02,210200580,02059,Beautor,2746,2718,28
32,02,210200598,02060,Beauvois-en-Vermandois,262,255,7
32,02,210200606,02061,Becquigny,252,245,7
32,02,210200614,02062,Belleau,138,136,2
32,02,210200622,02063,Bellenglise,387,379,8
32,02,210200630,02064,Belleu,3829,3762,67
32,02,210200648,02065,Bellicourt,598,587,11
32,02,210200655,02066,Benay,195,193,2
32,02,210200663,02067,Bergues-sur-Sambre,214,209,5
32,02,210200671,02068,Berlancourt,90,85,5
32,02,210200689,02069,Berlise,107,105,2
32,02,210200697,02070,Bernot,453,441,12
32,02,210200705,02071,Berny-Rivière,661,650,11
32,02,210200713,02072,Berrieux,186,183,3
32,02,210200721,02073,Berry-au-Bac,691,687,4
32,02,210200739,02074,Bertaucourt-Epourdon,603,592,11
32,02,210200747,02075,Berthenicourt,196,194,2
32,02,210200754,02076,Bertricourt,156,153,3
32,02,210200770,02078,Besmé,167,164,3
32,02,210200788,02079,Besmont,147,147,0
32,02,210200796,02080,Besny-et-Loizy,336,327,9
32,02,210200804,02081,Béthancourt-en-Vaux,440,432,8
32,02,210200812,02082,Beugneux,110,110,0
32,02,210200820,02083,Beuvardes,766,751,15
32,02,210200838,02084,Bézu-le-Guéry,260,255,5
32,02,210200846,02085,Bézu-Saint-Germain,1028,1003,25
32,02,210208245,02086,Bichancourt,1011,999,12
32,02,210200853,02087,Bieuxy,35,34,1
32,02,210200861,02088,Bièvres,93,88,5
32,02,210200879,02089,Billy-sur-Aisne,1167,1146,21
32,02,210200887,02090,Billy-sur-Ourcq,207,203,4
32,02,210200895,02091,Blanzy-lès-Fismes,95,94,1
32,02,210200903,02093,Blérancourt,1366,1306,60
32,02,210200911,02094,Blesmes,479,469,10
32,02,210200929,02095,Bohain-en-Vermandois,5778,5703,75
32,02,210200937,02096,Bois-lès-Pargny,196,194,2
32,02,210200945,02097,Boncourt,263,261,2
32,02,210200952,02098,Bonneil,392,378,14
32,02,210200960,02099,Bonnesvalyn,221,216,5
32,02,210200978,02100,Bony,138,138,0
32,02,210200986,02101,Bosmont-sur-Serre,189,186,3
32,02,210200994,02102,Bouconville-Vauclair,191,188,3
32,02,210201000,02103,Boué,1337,1331,6
32,02,210201018,02104,Bouffignereux,102,98,4
32,02,210201026,02105,Bouresches,195,193,2
32,02,210201034,02106,Bourg-et-Comin,819,810,9
32,02,210201042,02107,Bourguignon-sous-Coucy,109,105,4
32,02,210201059,02108,Bourguignon-sous-Montbavin,162,158,4
32,02,210201067,02109,La Bouteille,484,473,11
32,02,210201075,02110,Braine,2258,2232,26
32,02,210201083,02111,Brancourt-en-Laonnois,739,726,13
32,02,210201091,02112,Brancourt-le-Grand,566,554,12
32,02,210201109,02114,Brasles,1593,1558,35
32,02,210201117,02115,Braye-en-Laonnois,192,186,6
32,02,210201125,02116,Braye-en-Thiérache,143,142,1
32,02,210208070,02117,Bray-Saint-Christophe,67,67,0
32,02,210208088,02118,Braye,132,129,3
32,02,210208096,02119,Brécy,327,321,6
32,02,210208104,02120,Brenelle,202,196,6
32,02,210208146,02121,Breny,241,237,4
32,02,210201133,02122,Brie,56,55,1
32,02,210208112,02123,Brissay-Choigny,304,299,5
32,02,210208120,02124,Brissy-Hamégicourt,661,651,10
32,02,210208153,02125,Brumetz,193,183,10
32,02,210201141,02126,Brunehamel,453,448,5
32,02,210201158,02127,Bruyères-sur-Fère,196,191,5
32,02,210201166,02128,Bruyères-et-Montbérault,1493,1447,46
32,02,210201174,02129,Bruys,19,19,0
32,02,210201182,02130,Bucilly,207,198,9
32,02,210208161,02131,Bucy-le-Long,1924,1883,41
32,02,210201190,02132,Bucy-lès-Cerny,195,192,3
32,02,210201208,02133,Bucy-lès-Pierrepont,412,403,9
32,02,210201216,02134,Buire,873,854,19
32,02,210201224,02135,Buironfosse,1164,1148,16
32,02,210201232,02136,Burelles,131,128,3
32,02,210201240,02137,Bussiares,157,151,6
32,02,210201257,02138,Buzancy,203,200,3
32,02,210201265,02139,Caillouël-Crépigny,455,447,8
32,02,210201273,02140,Camelin,466,457,9
32,02,210201281,02141,La Capelle,1852,1772,80
32,02,210201299,02142,Castres,255,251,4
32,02,210201307,02143,Le Catelet,191,184,7
32,02,210201315,02144,Caulaincourt,143,140,3
32,02,210201323,02145,Caumont,555,545,10
32,02,210201331,02146,Celles-lès-Condé,97,96,1
32,02,210201356,02148,Celles-sur-Aisne,258,256,2
32,02,210201364,02149,Cerizy,62,60,2
32,02,210201372,02150,Cerny-en-Laonnois,62,62,0
32,02,210201380,02151,Cerny-lès-Bucy,119,116,3
32,02,210201398,02152,Cerseuil,88,87,1
32,02,200086338,02153,Cessières-Suzy,796,775,21
32,02,210201414,02154,Chacrise,372,365,7
32,02,210201422,02155,Chaillevois,178,177,1
32,02,210201430,02156,Chalandry,259,258,1
32,02,210201448,02157,Chambry,857,834,23
32,02,210201455,02158,Chamouille,273,271,2
32,02,210201463,02159,Champs,304,302,2
32,02,210201471,02160,Chaourse,545,527,18
32,02,210201497,02162,La Chapelle-sur-Chézy,306,298,8
32,02,210201505,02163,Charly-sur-Marne,2626,2585,41
32,02,210201513,02164,Le Charmel,334,327,7
32,02,210201521,02165,Charmes,1684,1655,29
32,02,210201539,02166,Chartèves,368,359,9
32,02,210201547,02167,Chassemy,902,888,14
32,02,210201554,02168,Château-Thierry,15618,15306,312
32,02,210201562,02169,Châtillon-lès-Sons,84,84,0
32,02,210201570,02170,Châtillon-sur-Oise,124,124,0
32,02,210201588,02171,Chaudardes,91,90,1
32,02,210201596,02172,Chaudun,259,251,8
32,02,210201604,02173,Chauny,11843,11438,405
32,02,210201612,02174,Chavignon,852,835,17
32,02,210201620,02175,Chavigny,168,164,4
32,02,210201638,02176,Chavonne,210,207,3
32,02,210201646,02177,Chérêt,142,141,1
32,02,210201653,02178,Chermizy-Ailles,112,110,2
32,02,210201661,02179,Chéry-Chartreuve,388,381,7
32,02,210201679,02180,Chéry-lès-Pouilly,740,726,14
32,02,210201687,02181,Chéry-lès-Rozoy,85,85,0
32,02,210201695,02182,Chevennes,116,113,3
32,02,210201703,02183,Chevregny,186,185,1
32,02,210201711,02184,Chevresis-Monceau,351,346,5
32,02,210201729,02185,Chézy-en-Orxois,400,385,15
32,02,210201737,02186,Chézy-sur-Marne,1366,1336,30
32,02,210201745,02187,Chierry,1166,1146,20
32,02,210201752,02188,Chigny,148,145,3
32,02,210201760,02189,Chivres-en-Laonnois,353,345,8
32,02,210201778,02190,Chivres-Val,530,523,7
32,02,210201786,02191,Chivy-lès-Étouvelles,518,511,7
32,02,210201794,02192,Chouy,377,370,7
32,02,210208260,02193,Cierges,66,65,1
32,02,210201810,02194,Cilly,187,179,8
32,02,210201828,02195,Ciry-Salsogne,928,900,28
32,02,210201836,02196,Clacy-et-Thierret,313,306,7
32,02,210201802,02197,Clairfontaine,631,530,101
32,02,210201844,02198,Clamecy,230,228,2
32,02,210201851,02199,Clastres,605,597,8
32,02,210201869,02200,Clermont-les-Fermes,105,104,1
32,02,210201877,02201,Coeuvres-et-Valsery,455,449,6
32,02,210201885,02203,Coincy,1287,1268,19
32,02,210201893,02204,Coingt,66,64,2
32,02,210201901,02205,Colligis-Crandelain,222,219,3
32,02,210201919,02206,Colonfay,78,75,3
32,02,210201927,02207,Commenchon,220,217,3
32,02,210201935,02208,Concevreux,268,262,6
32,02,210201943,02209,Condé-en-Brie,702,691,11
32,02,210201950,02210,Condé-sur-Aisne,367,361,6
32,02,210201968,02211,Condé-sur-Suippe,313,310,3
32,02,210201976,02212,Condren,710,702,8
32,02,210201984,02213,Connigis,344,342,2
32,02,210201992,02214,Contescourt,62,61,1
32,02,210202008,02215,Corbeny,848,842,6
32,02,210202016,02216,Corcy,294,290,4
32,02,210202024,02217,Coucy-le-Château-Auffrique,1002,992,10
32,02,210202032,02218,Coucy-lès-Eppes,639,627,12
32,02,210202040,02219,Coucy-la-Ville,260,196,64
32,02,210202057,02220,Coulonges-Cohan,457,442,15
32,02,210202065,02221,Coupru,158,154,4
32,02,210202073,02222,Courbes,34,34,0
32,02,210202081,02223,Courboin,318,304,14
32,02,210202099,02224,Courcelles-sur-Vesle,345,340,5
32,02,210202107,02225,Courchamps,84,83,1
32,02,210202115,02226,Courmelles,1905,1877,28
32,02,210202123,02227,Courmont,120,120,0
32,02,210202131,02228,Courtemont-Varennes,351,346,5
32,02,210202149,02229,Courtrizy-et-Fussigny,74,74,0
32,02,210202156,02230,Couvrelles,192,186,6
32,02,210202164,02231,Couvron-et-Aumencourt,958,949,9
32,02,210202172,02232,Coyolles,373,365,8
32,02,210202180,02233,Cramaille,153,145,8
32,02,210202198,02234,Craonne,86,84,2
32,02,210202206,02235,Craonnelle,117,114,3
32,02,210202214,02236,Crécy-au-Mont,332,329,3
32,02,210202222,02237,Crécy-sur-Serre,1516,1499,17
32,02,210202230,02238,Crépy,1829,1798,31
32,02,210202248,02239,Crézancy,1334,1250,84
32,02,210202255,02240,Croix-Fonsomme,201,198,3
32,02,210202263,02241,La Croix-sur-Ourcq,94,91,3
32,02,210202271,02242,Crouttes-sur-Marne,651,640,11
32,02,210202289,02243,Crouy,2995,2958,37
32,02,210202297,02244,Crupilly,66,63,3
32,02,210202305,02245,Cuffies,1831,1797,34
32,02,210202313,02246,Cugny,612,608,4
32,02,210202321,02248,Cuirieux,159,156,3
32,02,210202339,02249,Cuiry-Housse,101,101,0
32,02,210202347,02250,Cuiry-lès-Chaudardes,76,72,4
32,02,210202354,02251,Cuiry-lès-Iviers,28,27,1
32,02,210202362,02252,Cuissy-et-Geny,72,71,1
32,02,210202370,02253,Cuisy-en-Almont,360,357,3
32,02,210202388,02254,Cutry,133,128,5
32,02,210202396,02255,Cys-la-Commune,157,155,2
32,02,210202404,02256,Dagny-Lambercy,133,130,3
32,02,210202412,02257,Dallon,449,437,12
32,02,210202420,02258,Dammard,384,372,12
32,02,210202438,02259,Dampleux,405,390,15
32,02,210202446,02260,Danizy,665,654,11
32,02,210202453,02261,Dercy,399,389,10
32,02,210202461,02262,Deuillet,211,208,3
32,02,210202479,02263,Dhuizel,114,114,0
32,02,210202487,02264,Dizy-le-Gros,740,724,16
32,02,210202495,02265,Dohis,94,93,1
32,02,210202503,02266,Dolignon,46,44,2
32,02,210202511,02267,Dommiers,306,297,9
32,02,210202529,02268,Domptin,648,635,13
32,02,210202537,02269,Dorengt,160,154,6
32,02,210202545,02270,Douchy,167,164,3
32,02,210202552,02271,Dravegny,131,129,2
32,02,210202560,02272,Droizy,79,77,2
32,02,210202578,02273,Dury,199,199,0
32,02,210202586,02274,Ébouleau,198,192,6
32,02,210202594,02275,Effry,323,316,7
32,02,210202602,02276,Englancourt,120,115,5
32,02,210202610,02277,Épagny,350,343,7
32,02,210202628,02278,Éparcy,32,30,2
32,02,210202636,02279,Épaux-Bézu,576,552,24
32,02,210202644,02280,Épieds,420,408,12
32,02,210202651,02281,L'Épine-aux-Bois,263,252,11
32,02,210202669,02282,Eppes,440,432,8
32,02,210202677,02283,Erlon,292,285,7
32,02,210202685,02284,Erloy,104,104,0
32,02,210202693,02286,Esquéhéries,881,861,20
32,02,210202701,02287,Essigny-le-Grand,1072,1045,27
32,02,210202719,02288,Essigny-le-Petit,357,349,8
32,02,210202727,02289,Essises,424,413,11
32,02,210202735,02290,Essômes-sur-Marne,2797,2730,67
32,02,210202743,02291,Estrées,416,410,6
32,02,210202750,02292,Étampes-sur-Marne,1358,1331,27
32,02,210202768,02293,Étaves-et-Bocquiaux,561,551,10
32,02,210202776,02294,Étouvelles,214,206,8
32,02,210202784,02295,Étréaupont,860,850,10
32,02,210202792,02296,Étreillers,1208,1187,21
32,02,210202800,02297,Étrépilly,125,123,2
32,02,210202818,02298,Étreux,1467,1454,13
32,02,210202826,02299,Évergnicourt,540,534,6
32,02,210202842,02302,Faverolles,344,332,12
32,02,210202859,02303,Fayet,700,684,16
32,02,210202867,02304,La Fère,2981,2845,136
32,02,210202875,02305,Fère-en-Tardenois,3022,2970,52
32,02,210202883,02306,La Ferté-Chevresis,522,513,9
32,02,210202891,02307,La Ferté-Milon,2190,2055,135
32,02,210202909,02308,Fesmy-le-Sart,493,489,4
32,02,210202917,02309,Festieux,688,683,5
32,02,210202925,02310,Fieulaine,257,250,7
32,02,210202933,02311,Filain,120,118,2
32,02,210202941,02312,La Flamengrie,1098,1088,10
32,02,210202958,02313,Flavigny-le-Grand-et-Beaurain,449,444,5
32,02,210202966,02315,Flavy-le-Martel,1695,1660,35
32,02,210202974,02316,Fleury,129,124,5
32,02,210202982,02317,Fluquières,216,212,4
32,02,210202990,02318,Folembray,1395,1377,18
32,02,210203006,02319,Fonsomme,508,500,8
32,02,210203014,02320,Fontaine-lès-Clercs,237,233,4
32,02,210203022,02321,Fontaine-lès-Vervins,1081,892,189
32,02,210203030,02322,Fontaine-Notre-Dame,387,383,4
32,02,210203048,02323,Fontaine-Uterte,141,138,3
32,02,210203055,02324,Fontenelle,291,288,3
32,02,210203071,02326,Fontenoy,475,467,8
32,02,210203089,02327,Foreste,160,159,1
32,02,210203097,02328,Fossoy,519,512,7
32,02,210203105,02329,Fourdrain,443,434,9
32,02,210203113,02330,Francilly-Selency,554,546,8
32,02,210203121,02331,Franqueville,112,108,4
32,02,210203139,02332,Fresnes-en-Tardenois,275,271,4
32,02,210203147,02333,Fresnes-sous-Coucy,166,163,3
32,02,210203154,02334,Fresnoy-le-Grand,3015,2946,69
32,02,210203162,02335,Fressancourt,187,179,8
32,02,210203170,02336,Frières-Faillouël,997,981,16
32,02,210203188,02337,Froidestrées,182,177,5
32,02,210203196,02338,Froidmont-Cohartille,258,250,8
32,02,210203204,02339,Gandelu,704,695,9
32,02,210203212,02340,Gauchy,5283,5216,67
32,02,210203220,02341,Gercy,263,262,1
32,02,210203238,02342,Gergny,132,130,2
32,02,210203246,02343,Germaine,82,82,0
32,02,210203261,02345,Gibercourt,40,40,0
32,02,210203279,02346,Gizy,662,654,8
32,02,210203287,02347,Gland,444,438,6
32,02,210203303,02349,Goudelancourt-lès-Berrieux,56,56,0
32,02,210203311,02350,Goudelancourt-lès-Pierrepont,140,138,2
32,02,210203329,02351,Goussancourt,119,113,6
32,02,210203337,02352,Gouy,570,563,7
32,02,210203345,02353,Grandlup-et-Fay,291,281,10
32,02,210203352,02354,Grandrieux,81,79,2
32,02,210203360,02355,Gricourt,970,945,25
32,02,210203378,02356,Grisolles,236,234,2
32,02,210203386,02357,Gronard,72,70,2
32,02,210203394,02358,Grougis,324,321,3
32,02,210203402,02359,Grugies,1294,1274,20
32,02,200085280,02360,Villeneuve-sur-Aisne,2815,2780,35
32,02,210203428,02361,Guise,4628,4559,69
32,02,210203436,02362,Guivry,242,238,4
32,02,210203444,02363,Guny,377,374,3
32,02,210203451,02364,Guyencourt,258,254,4
32,02,210203469,02366,Hannapes,333,326,7
32,02,210203477,02367,Happencourt,146,146,0
32,02,210203485,02368,Haramont,577,568,9
32,02,210203493,02369,Harcigny,244,242,2
32,02,210203501,02370,Hargicourt,602,590,12
32,02,210203519,02371,Harly,1600,1567,33
32,02,210203527,02372,Hartennes-et-Taux,354,344,10
32,02,210203535,02373,Hary,198,193,5
32,02,210203543,02374,Lehaucourt,861,853,8
32,02,210203550,02375,Hautevesnes,163,160,3
32,02,210203568,02376,Hauteville,182,177,5
32,02,210203576,02377,Haution,141,133,8
32,02,210203584,02378,La Hérie,131,126,5
32,02,210203592,02379,Le Hérie-la-Viéville,324,198,126
32,02,210203600,02380,Hinacourt,26,26,0
32,02,210203618,02381,Hirson,8874,8685,189
32,02,210203626,02382,Holnon,1397,1360,37
32,02,210203634,02383,Homblières,1474,1441,33
32,02,210203642,02384,Houry,59,57,2
32,02,210203659,02385,Housset,169,165,4
32,02,210203667,02386,Iron,227,225,2
32,02,210203675,02387,Itancourt,1043,1007,36
32,02,210203683,02388,Iviers,226,221,5
32,02,210203691,02389,Jaulgonne,679,666,13
32,02,210203709,02390,Jeancourt,262,260,2
32,02,210203717,02391,Jeantes,217,212,5
32,02,210203725,02392,Joncourt,323,317,6
32,02,210203733,02393,Jouaignes,144,139,5
32,02,210203741,02395,Jumencourt,145,139,6
32,02,210203758,02396,Jumigny,65,63,2
32,02,210203766,02397,Jussy,1271,1252,19
32,02,210203774,02398,Juvigny,285,281,4
32,02,210203782,02399,Juvincourt-et-Damary,619,615,4
32,02,210203790,02400,Laffaux,156,152,4
32,02,210203808,02401,Laigny,193,191,2
32,02,210203816,02402,Lanchy,39,37,2
32,02,210203824,02403,Landifay-et-Bertaignemont,264,257,7
32,02,210203832,02404,Landouzy-la-Cour,187,183,4
32,02,210203840,02405,Landouzy-la-Ville,540,535,5
32,02,210203857,02406,Landricourt,131,131,0
32,02,210203865,02407,Laniscourt,217,208,9
32,02,210203873,02408,Laon,24738,24091,647
32,02,210203881,02409,Lappion,279,272,7
32,02,210203899,02410,Largny-sur-Automne,247,242,5
32,02,210203907,02411,Latilly,204,200,4
32,02,210203915,02412,Launoy,101,100,1
32,02,210203923,02413,Laval-en-Laonnois,245,241,4
32,02,210203931,02414,Lavaqueresse,206,201,5
32,02,210203949,02415,Laversine,164,159,5
32,02,210203956,02416,Lemé,421,417,4
32,02,210203964,02417,Lempire,120,120,0
32,02,210203972,02418,Lerzy,227,223,4
32,02,210203980,02419,Leschelle,278,268,10
32,02,210203998,02420,Lesdins,840,830,10
32,02,210204004,02421,Lesges,101,99,2
32,02,210204012,02422,Lesquielles-Saint-Germain,811,802,9
32,02,210204020,02423,Leuilly-sous-Coucy,434,426,8
32,02,210204038,02424,Leury,103,103,0
32,02,210204046,02425,Leuze,173,173,0
32,02,210204053,02426,Levergies,548,541,7
32,02,210204061,02427,Lhuys,141,140,1
32,02,210204079,02428,Licy-Clignon,76,74,2
32,02,210204087,02429,Lierval,124,123,1
32,02,210204095,02430,Liesse-Notre-Dame,1399,1270,129
32,02,210204103,02431,Liez,387,378,9
32,02,210204111,02432,Limé,195,190,5
32,02,210204129,02433,Lislet,226,219,7
32,02,210204145,02435,Logny-lès-Aubenton,82,82,0
32,02,210204152,02438,Longpont,253,244,9
32,02,200055606,02439,Les Septvallons,1209,1196,13
32,02,210204178,02440,Lor,138,138,0
32,02,210204186,02441,Louâtre,184,181,3
32,02,210204194,02442,Loupeigne,91,90,1
32,02,210204202,02443,Lucy-le-Bocage,212,206,6
32,02,210204210,02444,Lugny,125,125,0
32,02,210204228,02445,Luzoir,280,277,3
32,02,210204236,02446,Ly-Fontaine,119,118,1
32,02,210204244,02447,Maast-et-Violaine,153,148,5
32,02,210204251,02448,Mâchecourt,120,117,3
32,02,210204269,02449,Macogny,67,64,3
32,02,210204277,02450,Macquigny,365,361,4
32,02,210204293,02451,Magny-la-Fosse,122,122,0
32,02,210204285,02452,Maissemy,245,235,10
32,02,210204301,02453,Maizy,412,404,8
32,02,210204319,02454,La Malmaison,407,404,3
32,02,210204327,02455,Malzy,200,196,4
32,02,210204335,02456,Manicamp,299,295,4
32,02,210204343,02457,Marchais,399,389,10
32,02,200053411,02458,Dhuys et Morin-en-Brie,836,822,14
32,02,210204368,02459,Marcy,166,158,8
32,02,210204376,02460,Marcy-sous-Marle,207,206,1
32,02,210204384,02461,Marest-Dampcourt,377,369,8
32,02,210204392,02462,Mareuil-en-Dôle,231,229,2
32,02,210204400,02463,Marfontaine,87,87,0
32,02,210204418,02464,Margival,368,366,2
32,02,210204426,02465,Marigny-en-Orxois,534,527,7
32,02,210204434,02466,Marizy-Sainte-Geneviève,132,131,1
32,02,210204442,02467,Marizy-Saint-Mard,51,50,1
32,02,210204459,02468,Marle,2250,2219,31
32,02,210204467,02469,Marly-Gomont,500,487,13
32,02,210204475,02470,Martigny,445,433,12
32,02,210204483,02471,Martigny-Courpierre,138,136,2
32,02,210204491,02472,Mauregny-en-Haye,411,404,7
32,02,210204509,02473,Mayot,220,219,1
32,02,210204517,02474,Mennessis,398,394,4
32,02,210204533,02476,Mennevret,683,669,14
32,02,210204541,02477,Mercin-et-Vaux,986,964,22
32,02,210204558,02478,Merlieux-et-Fouquerolles,271,259,12
32,02,210204574,02480,Mesbrecourt-Richecourt,319,316,3
32,02,210204582,02481,Mesnil-Saint-Laurent,496,480,16
32,02,210204590,02482,Meurival,56,55,1
32,02,210204608,02483,Mézières-sur-Oise,522,511,11
32,02,210204616,02484,Mézy-Moulins,535,532,3
32,02,210204624,02485,Missy-aux-Bois,100,95,5
32,02,210204632,02486,Missy-lès-Pierrepont,107,106,1
32,02,210204640,02487,Missy-sur-Aisne,628,620,8
32,02,210204657,02488,Molain,160,158,2
32,02,210204665,02489,Molinchart,355,348,7
32,02,210204673,02490,Monampteuil,127,124,3
32,02,210204681,02491,Monceau-le-Neuf-et-Faucouzy,331,322,9
32,02,210204699,02492,Monceau-lès-Leups,453,445,8
32,02,210204707,02493,Monceau-le-Waast,229,223,6
32,02,210204715,02494,Monceau-sur-Oise,129,127,2
32,02,210204723,02495,Mondrepuis,1058,1043,15
32,02,210204731,02496,Monnes,99,98,1
32,02,210204749,02497,Mons-en-Laonnois,1181,1151,30
32,02,210204756,02498,Montaigu,779,762,17
32,02,210204764,02499,Montbavin,44,42,2
32,02,210204772,02500,Montbrehain,825,807,18
32,02,210204780,02501,Montchâlons,99,97,2
32,02,210204798,02502,Montcornet,1303,1291,12
32,02,210204806,02503,Mont-d'Origny,829,827,2
32,02,210204814,02504,Montescourt-Lizerolles,1635,1608,27
32,02,210204822,02505,Montfaucon,212,207,5
32,02,210204830,02506,Montgobert,201,197,4
32,02,210204848,02507,Montgru-Saint-Hilaire,31,31,0
32,02,210204855,02508,Monthenault,158,152,6
32,02,210204863,02509,Monthiers,153,153,0
32,02,210204871,02510,Monthurel,151,146,5
32,02,210204889,02511,Montigny-en-Arrouaise,308,302,6
32,02,210204897,02512,Montigny-l'Allier,274,269,5
32,02,210204905,02513,Montigny-le-Franc,138,136,2
32,02,210204913,02514,Montigny-Lengrain,717,702,15
32,02,210204921,02515,Montigny-lès-Condé,57,53,4
32,02,210204939,02516,Montigny-sous-Marle,70,69,1
32,02,210204947,02517,Montigny-sur-Crécy,300,295,5
32,02,210204954,02518,Montlevon,303,301,2
32,02,210204962,02519,Montloué,192,188,4
32,02,210204970,02520,Mont-Notre-Dame,742,737,5
32,02,210204988,02521,Montreuil-aux-Lions,1388,1374,14
32,02,210204996,02522,Mont-Saint-Jean,75,73,2
32,02,210205001,02523,Mont-Saint-Martin,72,71,1
32,02,210205019,02524,Mont-Saint-Père,710,692,18
32,02,210205027,02525,Morcourt,572,566,6
32,02,210205035,02526,Morgny-en-Thiérache,105,102,3
32,02,210205043,02527,Morsain,470,461,9
32,02,210205050,02528,Mortefontaine,229,223,6
32,02,210205068,02529,Mortiers,183,180,3
32,02,210205076,02530,Moulins,79,78,1
32,02,210205084,02531,Moussy-Verneuil,128,125,3
32,02,210205092,02532,Moÿ-de-l'Aisne,1001,983,18
32,02,210205100,02533,Muret-et-Crouttes,114,108,6
32,02,210205118,02534,Muscourt,48,47,1
32,02,210205126,02535,Nampcelles-la-Cour,118,113,5
32,02,210205134,02536,Nampteuil-sous-Muret,105,104,1
32,02,210205142,02537,Nanteuil-la-Fosse,204,203,1
32,02,210205159,02538,Nanteuil-Notre-Dame,74,74,0
32,02,210205167,02539,Nauroy,706,699,7
32,02,210205175,02540,Nesles-la-Montagne,1252,1216,36
32,02,210205183,02541,Neufchâtel-sur-Aisne,425,420,5
32,02,210205191,02542,Neuflieux,82,80,2
32,02,210205209,02543,Neuilly-Saint-Front,2089,2055,34
32,02,210205217,02544,Neuve-Maison,624,613,11
32,02,210205225,02545,La Neuville-Bosmont,189,187,2
32,02,210205233,02546,La Neuville-en-Beine,192,188,4
32,02,210205241,02547,La Neuville-Housset,67,66,1
32,02,210205258,02548,La Neuville-lès-Dorengt,388,382,6
32,02,210205266,02549,Neuville-Saint-Amand,871,849,22
32,02,210205274,02550,Neuville-sur-Ailette,123,120,3
32,02,210205282,02551,Neuville-sur-Margival,110,110,0
32,02,210205290,02552,Neuvillette,198,190,8
32,02,210205308,02553,Nizy-le-Comte,251,247,4
32,02,210205316,02554,Nogentel,1123,1100,23
32,02,210205324,02555,Nogent-l'Artaud,2140,2095,45
32,02,210205332,02556,Noircourt,79,77,2
32,02,210205340,02557,Noroy-sur-Ourcq,128,128,0
32,02,210205357,02558,Le Nouvion-en-Thiérache,2556,2531,25
32,02,210205365,02559,Nouvion-et-Catillon,489,483,6
32,02,210205373,02560,Nouvion-le-Comte,249,245,4
32,02,210205381,02561,Nouvion-le-Vineux,151,147,4
32,02,210205399,02562,Nouvron-Vingré,208,206,2
32,02,210205407,02563,Noyales,166,163,3
32,02,200098754,02564,Bernoy-le-Château,886,871,15
32,02,210205423,02565,oeuilly,296,293,3
32,02,210205431,02566,Ognes,1128,1106,22
32,02,210205449,02567,Ohis,283,275,8
32,02,210205456,02568,Oigny-en-Valois,169,165,4
32,02,210205464,02569,Oisy,479,476,3
32,02,210205472,02570,Ollezy,174,174,0
32,02,210205480,02571,Omissy,786,711,75
32,02,210205498,02572,Orainville,509,500,9
32,02,210205506,02573,Orgeval,58,57,1
32,02,210205514,02574,Origny-en-Thiérache,1430,1409,21
32,02,210205522,02575,Origny-Sainte-Benoite,1672,1660,12
32,02,210205530,02576,Osly-Courtil,336,328,8
32,02,210205548,02577,Ostel,92,91,1
32,02,210205555,02578,Oulches-la-Vallée-Foulon,87,86,1
32,02,210205563,02579,Oulchy-la-Ville,133,124,9
32,02,210205571,02580,Oulchy-le-Château,825,816,9
32,02,210205589,02581,Paars,321,320,1
32,02,210205597,02582,Paissy,79,77,2
32,02,210205605,02583,Pancy-Courtecon,55,53,2
32,02,210205613,02584,Papleux,124,117,7
32,02,210205621,02585,Parcy-et-Tigny,261,255,6
32,02,210205639,02586,Parfondeval,144,138,6
32,02,210205647,02587,Parfondru,364,353,11
32,02,210205654,02588,Pargnan,69,67,2
32,02,210205662,02589,Pargny-Filain,262,262,0
32,02,210205670,02590,Pargny-la-Dhuys,171,169,2
32,02,210205688,02591,Pargny-les-Bois,138,136,2
32,02,210205696,02592,Parpeville,198,193,5
32,02,210205704,02593,Pasly,1088,1067,21
32,02,210205712,02594,Passy-en-Valois,135,129,6
32,02,210205720,02595,Passy-sur-Marne,137,137,0
32,02,210205738,02596,Pavant,775,762,13
32,02,210205753,02598,Pernant,697,679,18
32,02,210205761,02599,Pierremande,256,253,3
32,02,210205779,02600,Pierrepont,345,340,5
32,02,210205787,02601,Pignicourt,194,190,4
32,02,210205795,02602,Pinon,1693,1668,25
32,02,210205803,02604,Pithon,82,82,0
32,02,210205811,02605,Pleine-Selve,197,192,5
32,02,210205829,02606,Le Plessier-Huleu,72,69,3
32,02,210205837,02607,Ploisy,85,84,1
32,02,210205845,02608,Plomion,470,468,2
32,02,210205852,02609,Ployart-et-Vaurseine,22,21,1
32,02,210205860,02610,Pommiers,752,741,11
32,02,210205878,02612,Pont-Arcy,126,124,2
32,02,210205886,02613,Pontavert,614,603,11
32,02,210205894,02614,Pontru,279,272,7
32,02,210205902,02615,Pontruet,370,357,13
32,02,210205910,02616,Pont-Saint-Mard,205,202,3
32,02,210205928,02617,Pouilly-sur-Serre,511,507,4
32,02,210205936,02618,Prémont,702,691,11
32,02,210205944,02619,Prémontré,643,637,6
32,02,210205951,02620,Presles-et-Boves,348,341,7
32,02,210205969,02621,Presles-et-Thierny,394,386,8
32,02,210205977,02622,Priez,55,55,0
32,02,210205985,02623,Prisces,99,96,3
32,02,210205993,02624,Proisy,337,272,65
32,02,210206009,02625,Proix,144,142,2
32,02,210206017,02626,Prouvais,343,336,7
32,02,210206025,02627,Proviseux-et-Plesnoy,128,126,2
32,02,210206033,02628,Puiseux-en-Retz,224,218,6
32,02,210206041,02629,Puisieux-et-Clanlieu,334,322,12
32,02,210206066,02631,Quierzy,414,409,5
32,02,210206074,02632,Quincy-Basse,57,56,1
32,02,210206082,02633,Quincy-sous-le-Mont,63,61,2
32,02,210206090,02634,Raillimont,89,85,4
32,02,210206108,02635,Ramicourt,148,146,2
32,02,210206116,02636,Regny,205,200,5
32,02,210206124,02637,Remaucourt,301,291,10
32,02,210206132,02638,Remies,239,238,1
32,02,210206140,02639,Remigny,353,346,7
32,02,210206157,02640,Renansart,159,155,4
32,02,210206165,02641,Renneval,114,111,3
32,02,210206173,02642,Résigny,169,166,3
32,02,210206181,02643,Ressons-le-Long,792,784,8
32,02,210206199,02644,Retheuil,352,340,12
32,02,210206207,02645,Reuilly-Sauvigny,196,188,8
32,02,210206223,02647,Ribeauville,59,59,0
32,02,210206231,02648,Ribemont,1951,1914,37
32,02,210206249,02649,Rocourt-Saint-Martin,313,309,4
32,02,210206256,02650,Rocquigny,365,359,6
32,02,210206264,02651,Rogécourt,107,106,1
32,02,210206272,02652,Rogny,104,103,1
32,02,210206280,02653,Romeny-sur-Marne,511,498,13
32,02,210206298,02654,Romery,84,83,1
32,02,210206306,02655,Ronchères,146,146,0
32,02,210206314,02656,Roucy,404,394,10
32,02,210206322,02657,Rougeries,239,234,5
32,02,210206330,02658,Roupy,245,239,6
32,02,210206348,02659,Rouvroy,518,505,13
32,02,210206355,02660,Rouvroy-sur-Serre,39,37,2
32,02,210206363,02661,Royaucourt-et-Chailvet,248,245,3
32,02,210206371,02662,Rozet-Saint-Albin,337,328,9
32,02,210206389,02663,Rozières-sur-Crise,230,225,5
32,02,210206397,02664,Rozoy-Bellevalle,125,122,3
32,02,210206405,02665,Grand-Rozoy,304,299,5
32,02,210206413,02666,Rozoy-sur-Serre,988,975,13
32,02,210206421,02667,Saconin-et-Breuil,206,201,5
32,02,210206439,02668,Sains-Richaumont,1044,1018,26
32,02,210206454,02670,Saint-Algis,151,150,1
32,02,210206462,02671,Saint-Aubin,288,283,5
32,02,210206470,02672,Saint-Bandry,262,254,8
32,02,210206488,02673,Saint-Christophe-à-Berry,449,442,7
32,02,210206496,02674,Saint-Clément,49,49,0
32,02,210206504,02675,Sainte-Croix,135,134,1
32,02,210206512,02676,Saint-Erme-Outre-et-Ramecourt,1737,1711,26
32,02,210206520,02677,Saint-Eugène,241,238,3
32,02,210206538,02678,Sainte-Geneviève,67,67,0
32,02,210206546,02679,Saint-Gengoulph,155,151,4
32,02,210206553,02680,Saint-Gobain,2343,2304,39
32,02,210206561,02681,Saint-Gobert,286,280,6
32,02,210206579,02682,Saint-Mard,118,115,3
32,02,210206587,02683,Saint-Martin-Rivière,110,108,2
32,02,210206595,02684,Saint-Michel,3339,3279,60
32,02,210206603,02685,Saint-Nicolas-aux-Bois,122,121,1
32,02,210206611,02686,Saint-Paul-aux-Bois,374,368,6
32,02,210206629,02687,Saint-Pierre-Aigle,344,335,9
32,02,210206637,02688,Saint-Pierre-lès-Franqueville,49,45,4
32,02,210206645,02689,Saint-Pierremont,42,41,1
32,02,210206652,02690,Sainte-Preuve,77,76,1
32,02,210206660,02691,Saint-Quentin,54347,53100,1247
32,02,210206678,02693,Saint-Rémy-Blanzy,226,223,3
32,02,210206686,02694,Saint-Simon,641,627,14
32,02,210206702,02696,Saint-Thomas,77,74,3
32,02,210206710,02697,Samoussy,388,383,5
32,02,210206728,02698,Sancy-les-Cheminots,104,102,2
32,02,210206736,02699,Saponay,279,276,3
32,02,210206744,02701,Saulchery,711,704,7
32,02,210206751,02702,Savy,618,605,13
32,02,210206769,02703,Seboncourt,1097,1082,15
32,02,210206777,02704,Selens,237,234,3
32,02,210206785,02705,La Selve,212,206,6
32,02,210206793,02706,Septmonts,580,568,12
32,02,210206801,02707,Septvaux,179,179,0
32,02,210206819,02708,Sequehart,222,214,8
32,02,210206827,02709,Serain,414,406,8
32,02,210206835,02710,Seraucourt-le-Grand,747,729,18
32,02,210206843,02711,Serches,291,285,6
32,02,210206850,02712,Sergy,144,141,3
32,02,210206868,02713,Seringes-et-Nesles,270,267,3
32,02,210206876,02714,Sermoise,362,361,1
32,02,210206884,02715,Serval,45,42,3
32,02,210206892,02716,Servais,296,290,6
32,02,210206900,02717,Séry-lès-Mézières,610,597,13
32,02,210206918,02718,Silly-la-Poterie,121,118,3
32,02,210206926,02719,Sinceny,2054,2013,41
32,02,210206934,02720,Sissonne,2135,2062,73
32,02,210206942,02721,Sissy,477,475,2
32,02,210206959,02722,Soissons,29543,28888,655
32,02,210206967,02723,Soize,98,97,1
32,02,210206975,02724,Sommelans,62,61,1
32,02,210206983,02725,Sommeron,143,137,6
32,02,210206991,02726,Sommette-Eaucourt,177,175,2
32,02,210207007,02727,Sons-et-Ronchères,214,211,3
32,02,210207015,02728,Sorbais,264,260,4
32,02,210207023,02729,Soucy,80,79,1
32,02,210207031,02730,Soupir,272,265,7
32,02,210207049,02731,Le Sourd,175,173,2
32,02,210207056,02732,Surfontaine,104,104,0
32,02,210207072,02734,Taillefontaine,278,272,6
32,02,210207080,02735,Tannières,17,17,0
32,02,210207098,02736,Tartiers,171,166,5
32,02,210207106,02737,Tavaux-et-Pontséricourt,564,552,12
32,02,210207114,02738,Tergnier,13694,13504,190
32,02,210207122,02739,Terny-Sorny,343,336,7
32,02,210207130,02740,Thenailles,227,221,6
32,02,210207148,02741,Thenelles,545,540,5
32,02,210207155,02742,Thiernu,117,117,0
32,02,210207163,02743,Le Thuel,157,156,1
32,02,210207171,02744,Torcy-en-Valois,72,70,2
32,02,210207189,02745,Toulis-et-Attencourt,118,117,1
32,02,210207197,02746,Travecy,669,658,11
32,02,210207205,02747,Trefcon,84,84,0
32,02,210207213,02748,Trélou-sur-Marne,959,934,25
32,02,210207221,02749,Troësnes,226,216,10
32,02,210207239,02750,Trosly-Loire,576,568,8
32,02,210207247,02751,Trucy,145,143,2
32,02,210207254,02752,Tugny-et-Pont,288,284,4
32,02,210207262,02753,Tupigny,331,327,4
32,02,210207270,02754,Ugny-le-Gay,189,186,3
32,02,210207288,02755,Urcel,583,571,12
32,02,210207296,02756,Urvillers,701,689,12
32,02,210207304,02757,Vadencourt,531,521,10
32,02,210207312,02758,Vailly-sur-Aisne,2054,2017,37
32,02,210207320,02759,La Vallée-au-Blé,372,366,6
32,02,210207338,02760,La Vallée-Mulâtre,141,138,3
32,02,210207346,02761,Variscourt,215,211,4
32,02,210207353,02762,Vassens,153,150,3
32,02,210207361,02763,Vasseny,223,219,4
32,02,210207379,02764,Vassogne,93,90,3
32,02,210207387,02765,Vaucelles-et-Beffecourt,247,237,10
32,02,210207395,02766,Vaudesson,240,236,4
32,02,210207403,02767,Vauxrezis,324,321,3
32,02,210207411,02768,Vauxaillon,540,530,10
32,02,210207429,02769,Vaux-Andigny,922,906,16
32,02,210207437,02770,Vauxbuin,805,785,20
32,02,210207452,02772,Vaux-en-Vermandois,159,154,5
32,02,210207460,02773,Vauxtin,39,39,0
32,02,210207478,02774,Vendelles,120,119,1
32,02,210207486,02775,Vendeuil,946,929,17
32,02,210207494,02776,Vendhuile,573,561,12
32,02,210207502,02777,Vendières,144,137,7
32,02,210207510,02778,Vendresse-Beaulne,95,94,1
32,02,210207528,02779,Vénérolles,223,220,3
32,02,210207536,02780,Venizel,1387,1363,24
32,02,210207544,02781,Verdilly,466,451,15
32,02,210207551,02782,Le Verguier,223,221,2
32,02,210207569,02783,Grand-Verly,137,137,0
32,02,210207577,02784,Petit-Verly,146,144,2
32,02,210207585,02785,Vermand,1132,1101,31
32,02,210207593,02786,Verneuil-sous-Coucy,128,126,2
32,02,210207601,02787,Verneuil-sur-Serre,262,260,2
32,02,210207619,02788,Versigny,469,462,7
32,02,210207627,02789,Vervins,2695,2600,95
32,02,210207635,02790,Vesles-et-Caumont,242,239,3
32,02,210207643,02791,Veslud,267,261,6
32,02,210207650,02792,Veuilly-la-Poterie,163,156,7
32,02,210207668,02793,Vézaponin,117,116,1
32,02,210207676,02794,Vézilly,195,187,8
32,02,210207684,02795,Vic-sur-Aisne,1623,1604,19
32,02,210207692,02796,Vichel-Nanteuil,88,86,2
32,02,210207700,02797,Viel-Arcy,172,172,0
32,02,210207718,02798,Viels-Maisons,1233,1214,19
32,02,210207726,02799,Vierzy,410,400,10
32,02,210207734,02800,Viffort,318,313,5
32,02,210207742,02801,Vigneux-Hocquet,276,270,6
32,02,210207759,02802,La Ville-aux-Bois-lès-Dizy,210,208,2
32,02,210207767,02803,La Ville-aux-Bois-lès-Pontavert,150,145,5
32,02,210207775,02804,Villemontoire,196,191,5
32,02,210207783,02805,Villeneuve-Saint-Germain,2591,2549,42
32,02,210207791,02806,Villeneuve-sur-Fère,305,300,5
32,02,210207809,02807,Villequier-Aumont,684,661,23
32,02,210207817,02808,Villeret,289,282,7
32,02,210207825,02809,Villers-Agron-Aiguizy,71,68,3
32,02,210207833,02810,Villers-Cotterêts,10803,10392,411
32,02,210207858,02812,Villers-Hélon,209,203,6
32,02,210207866,02813,Villers-le-Sec,252,245,7
32,02,210207874,02814,Villers-lès-Guise,161,161,0
32,02,210207882,02815,Villers-Saint-Christophe,442,427,15
32,02,210207890,02816,Villers-sur-Fère,541,535,6
32,02,210207908,02817,Ville-Savoye,83,82,1
32,02,210207916,02818,Villiers-Saint-Denis,1171,1161,10
32,02,210207924,02819,Vincy-Reuil-et-Magny,115,111,4
32,02,210207932,02820,Viry-Noureuil,1731,1688,43
32,02,210207940,02821,Vivaise,695,674,21
32,02,210207957,02822,Vivières,404,397,7
32,02,210207965,02823,Voharies,75,75,0
32,02,210207973,02824,Vorges,381,374,7
32,02,210207981,02826,Voulpaix,355,348,7
32,02,210207999,02827,Voyenne,310,306,4
32,02,210208005,02828,Vregny,92,92,0
32,02,210208013,02829,Vuillery,42,41,1
32,02,210208021,02830,Wassigny,975,959,16
32,02,210208039,02831,Watigny,384,378,6
32,02,210208047,02832,Wiège-Faty,191,186,5
32,02,210208054,02833,Wimy,500,493,7
32,02,210208062,02834,Wissignicourt,179,173,6
84,03,210300018,03001,Abrest,2961,2899,62
84,03,210300026,03002,Agonges,321,309,12
84,03,210300034,03003,Ainay-le-Château,1012,983,29
84,03,210300042,03004,Andelaroche,249,241,8
84,03,210300059,03005,Archignat,341,337,4
84,03,210300067,03006,Arfeuilles,646,629,17
84,03,210300075,03007,Arpheuilles-Saint-Priest,363,356,7
84,03,210300083,03008,Arronnes,385,376,9
84,03,210300091,03009,Aubigny,170,136,34
84,03,210300109,03010,Audes,428,419,9
84,03,210300117,03011,Aurouër,434,425,9
84,03,210300125,03012,Autry-Issards,321,316,5
84,03,210300133,03013,Avermes,4109,4012,97
84,03,210300141,03014,Avrilly,138,136,2
84,03,210300158,03015,Bagneux,342,331,11
84,03,210300166,03016,Barberier,144,142,2
84,03,210300174,03017,Barrais-Bussolles,193,187,6
84,03,210300182,03018,Bayet,694,680,14
84,03,210300190,03019,Beaulon,1652,1628,24
84,03,210300208,03020,Beaune-d'Allier,298,292,6
84,03,210300216,03021,Bègues,224,222,2
84,03,210300224,03022,Bellenaves,1002,985,17
84,03,210300232,03023,Bellerive-sur-Allier,9080,8844,236
84,03,210300240,03024,Bert,238,234,4
84,03,210300257,03025,Bessay-sur-Allier,1368,1347,21
84,03,210300265,03026,Besson,779,761,18
84,03,210300273,03027,Bézenet,948,920,28
84,03,210300281,03028,Billezois,370,362,8
84,03,210300299,03029,Billy,812,796,16
84,03,210300307,03030,Biozat,895,879,16
84,03,210300315,03031,Bizeneuille,304,293,11
84,03,210300323,03032,Blomard,244,243,1
84,03,210300331,03033,Bost,185,181,4
84,03,210300349,03034,Boucé,505,493,12
84,03,210300356,03035,Le Bouchaud,209,206,3
84,03,210300364,03036,Bourbon-l'Archambault,2635,2566,69
84,03,210300372,03037,Braize,262,260,2
84,03,210300380,03038,Bransat,535,526,9
84,03,210300398,03039,Bresnay,391,384,7
84,03,210300406,03040,Bressolles,1170,1132,38
84,03,210300414,03041,Le Brethon,329,321,8
84,03,210300422,03042,Le Breuil,542,531,11
84,03,210300430,03043,Broût-Vernet,1269,1191,78
84,03,210300448,03044,Brugheas,1567,1531,36
84,03,210300455,03045,Busset,851,833,18
84,03,210300463,03046,Buxières-les-Mines,1034,1010,24
84,03,210300471,03047,La Celle,412,405,7
84,03,210300489,03048,Cérilly,1328,1305,23
84,03,210300497,03049,Cesset,437,427,10
84,03,210300505,03050,La Chabanne,186,177,9
84,03,210300513,03051,Chambérat,302,294,8
84,03,210300521,03052,Chamblet,1116,1090,26
84,03,210300539,03053,Chantelle,1131,1105,26
84,03,210300547,03054,Chapeau,244,237,7
84,03,210300554,03055,La Chapelaude,960,945,15
84,03,210300562,03056,La Chapelle,395,388,7
84,03,210300570,03057,La Chapelle-aux-Chasses,202,196,6
84,03,210300588,03058,Chappes,247,240,7
84,03,210300596,03059,Chareil-Cintrat,375,367,8
84,03,210300604,03060,Charmeil,1056,1039,17
84,03,210300612,03061,Charmes,397,387,10
84,03,210300620,03062,Charroux,363,346,17
84,03,210300638,03063,Chassenard,1050,1030,20
84,03,210300646,03064,Château-sur-Allier,179,175,4
84,03,210300653,03065,Châtel-de-Neuvre,555,546,9
84,03,210300661,03066,Châtel-Montagne,326,321,5
84,03,210300679,03067,Châtelperron,138,134,4
84,03,210300687,03068,Châtelus,104,103,1
84,03,210300695,03069,Châtillon,317,311,6
84,03,210300703,03070,Chavenon,139,135,4
84,03,210300711,03071,Chavroches,254,250,4
84,03,210300729,03072,Chazemais,505,495,10
84,03,210300737,03073,Chemilly,633,621,12
84,03,210300745,03074,Chevagnes,663,648,15
84,03,210300752,03075,Chezelle,166,164,2
84,03,210300760,03076,Chézy,226,219,7
84,03,210300778,03077,Chirat-l'Église,130,128,2
84,03,210300786,03078,Chouvigny,237,229,8
84,03,210300794,03079,Cindré,300,296,4
84,03,210300802,03080,Cognat-Lyonne,713,702,11
84,03,210300810,03081,Colombier,336,323,13
84,03,210300828,03082,Commentry,6285,6100,185
84,03,210300836,03083,Contigny,587,575,12
84,03,210300844,03084,Cosne-d'Allier,2060,2031,29
84,03,210300851,03085,Coulandon,695,641,54
84,03,210300869,03086,Coulanges,313,305,8
84,03,210300877,03087,Couleuvre,603,597,6
84,03,210300885,03088,Courçais,320,316,4
84,03,210300893,03089,Coutansouze,161,154,7
84,03,210300901,03090,Couzon,314,307,7
84,03,210300919,03091,Créchy,445,436,9
84,03,210300927,03092,Cressanges,643,629,14
84,03,210300935,03093,Creuzier-le-Neuf,1247,1219,28
84,03,210300943,03094,Creuzier-le-Vieux,3385,3283,102
84,03,210300950,03095,Cusset,13154,12677,477
84,03,210300968,03096,Deneuille-lès-Chantelle,90,89,1
84,03,210300976,03097,Deneuille-les-Mines,368,359,9
84,03,210300984,03098,Désertines,4565,4465,100
84,03,210300992,03099,Deux-Chaises,400,388,12
84,03,210301008,03100,Diou,1408,1373,35
84,03,210301016,03101,Domérat,8871,8698,173
84,03,210301024,03102,Dompierre-sur-Besbre,3062,3010,52
84,03,210301032,03103,Le Donjon,1062,1046,16
84,03,210301040,03104,Doyet,1201,1167,34
84,03,210301057,03105,Droiturier,367,360,7
84,03,210301065,03106,Durdat-Larequille,1420,1317,103
84,03,210301073,03107,Ébreuil,1296,1269,27
84,03,210301081,03108,Échassières,379,373,6
84,03,210301099,03109,Escurolles,822,788,34
84,03,210301107,03110,Espinasse-Vozelle,1003,977,26
84,03,210301115,03111,Estivareilles,1141,1117,24
84,03,210301123,03112,Étroussat,674,665,9
84,03,210301131,03113,Ferrières-sur-Sichon,543,527,16
84,03,210301149,03114,La Ferté-Hauterive,278,271,7
84,03,210301156,03115,Fleuriel,350,344,6
84,03,210301164,03116,Fourilles,193,188,5
84,03,210301172,03117,Franchesse,491,479,12
84,03,210301180,03118,Gannat,6012,5815,197
84,03,210301198,03119,Gannay-sur-Loire,418,414,4
84,03,210301206,03120,Garnat-sur-Engièvre,724,711,13
84,03,210301214,03121,Gennetines,653,636,17
84,03,210301222,03122,Gipcy,240,235,5
84,03,210301248,03124,Gouise,223,219,4
84,03,210301255,03125,La Guillermie,124,122,2
84,03,210301263,03126,Hauterive,1190,1176,14
84,03,210301271,03127,Hérisson,616,601,15
84,03,210301289,03128,Huriel,2688,2632,56
84,03,210301297,03129,Hyds,320,308,12
84,03,210301305,03130,Isle-et-Bardais,286,280,6
84,03,210301313,03131,Isserpent,565,553,12
84,03,210301321,03132,Jaligny-sur-Besbre,570,554,16
84,03,210301339,03133,Jenzat,534,524,10
84,03,210301347,03134,Laféline,194,193,1
84,03,210301354,03135,Lalizolle,421,412,9
84,03,210301362,03136,Lamaids,234,225,9
84,03,210301370,03137,Langy,276,270,6
84,03,210301388,03138,Lapalisse,3210,3137,73
84,03,210301396,03139,Laprugne,325,314,11
84,03,210301404,03140,Lavault-Sainte-Anne,1161,1147,14
84,03,210301412,03141,Lavoine,151,149,2
84,03,210301420,03142,Lenax,246,242,4
84,03,210301438,03143,Lételon,94,91,3
84,03,210301446,03144,Liernolles,217,210,7
84,03,210301453,03145,Lignerolles,755,743,12
84,03,210301461,03146,Limoise,196,168,28
84,03,210301479,03147,Loddes,169,167,2
84,03,210301487,03148,Loriges,353,348,5
84,03,210301495,03149,Louchy-Montfand,440,429,11
84,03,210301503,03150,Louroux-Bourbonnais,207,202,5
84,03,210301511,03151,Louroux-de-Beaune,161,157,4
84,03,210301529,03152,Louroux-de-Bouble,235,230,5
84,03,210301545,03154,Luneau,276,273,3
84,03,210301552,03155,Lurcy-Lévis,1923,1881,42
84,03,210301560,03156,Lusigny,1722,1670,52
84,03,210301578,03157,Magnet,1058,1035,23
84,03,200058758,03158,Haut-Bocage,875,860,15
84,03,210301594,03159,Malicorne,790,776,14
84,03,210301602,03160,Marcenat,416,412,4
84,03,210301610,03161,Marcillat-en-Combraille,927,902,25
84,03,210301628,03162,Marigny,207,201,6
84,03,210301636,03163,Mariol,750,729,21
84,03,210301644,03164,Le Mayet-d'École,286,283,3
84,03,210301651,03165,Le Mayet-de-Montagne,1472,1386,86
84,03,210301669,03166,Mazerier,313,308,5
84,03,210301677,03167,Mazirat,291,287,4
84,03,200063501,03168,Meaulne-Vitray,921,908,13
84,03,210301693,03169,Meillard,329,323,6
84,03,210301701,03170,Meillers,131,125,6
84,03,210301719,03171,Mercy,249,243,6
84,03,210301727,03172,Mesples,124,122,2
84,03,210301735,03173,Molinet,1176,1144,32
84,03,210301743,03174,Molles,949,924,25
84,03,210301750,03175,Monestier,288,277,11
84,03,210301768,03176,Monétay-sur-Allier,552,542,10
84,03,210301776,03177,Monétay-sur-Loire,252,247,5
84,03,210301784,03178,Montaiguët-en-Forez,296,290,6
84,03,210301792,03179,Montaigu-le-Blin,302,298,4
84,03,210301800,03180,Montbeugny,665,654,11
84,03,210301818,03181,Montcombroux-les-Mines,297,295,2
84,03,210301826,03182,Monteignet-sur-l'Andelot,263,262,1
84,03,210301834,03183,Le Montet,473,469,4
84,03,210301842,03184,Montilly,512,504,8
84,03,210301859,03185,Montluçon,34868,33822,1046
84,03,210301867,03186,Montmarault,1541,1523,18
84,03,210301875,03187,Montoldre,634,625,9
84,03,210301883,03188,Montord,220,216,4
84,03,210301891,03189,Montvicq,734,709,25
84,03,210301909,03190,Moulins,19997,19444,553
84,03,210301917,03191,Murat,280,272,8
84,03,210301925,03192,Nades,153,150,3
84,03,210301933,03193,Nassigny,195,191,4
84,03,210301941,03194,Naves,127,125,2
84,03,210301958,03195,Néris-les-Bains,2686,2588,98
84,03,210301966,03196,Neuilly-en-Donjon,218,213,5
84,03,210301974,03197,Neuilly-le-Réal,1482,1452,30
84,03,210301982,03198,Neure,195,192,3
84,03,210302006,03200,Neuvy,1752,1493,259
84,03,210302014,03201,Nizerolles,314,301,13
84,03,210302022,03202,Noyant-d'Allier,608,593,15
84,03,210302030,03203,Paray-le-Frésil,393,385,8
84,03,210302048,03204,Paray-sous-Briailles,634,618,16
84,03,210302055,03205,Périgny,449,438,11
84,03,210302063,03206,La Petite-Marche,168,162,6
84,03,210302071,03207,Pierrefitte-sur-Loire,527,514,13
84,03,210302089,03208,Le Pin,433,425,8
84,03,210302097,03209,Poëzat,154,151,3
84,03,210302105,03210,Pouzy-Mésangy,398,394,4
84,03,210302113,03211,Prémilhat,2553,2506,47
84,03,210302121,03212,Quinssaines,1552,1527,25
84,03,210302139,03213,Reugny,257,253,4
84,03,210302147,03214,Rocles,370,365,5
84,03,210302154,03215,Rongères,551,543,8
84,03,210302162,03216,Ronnet,175,173,2
84,03,210302170,03217,Saint-Angel,795,761,34
84,03,210302188,03218,Saint-Aubin-le-Monial,278,270,8
84,03,210302196,03219,Saint-Bonnet-de-Four,218,215,3
84,03,210302204,03220,Saint-Bonnet-de-Rochefort,733,717,16
84,03,210302212,03221,Saint-Bonnet-Tronçais,740,732,8
84,03,210302220,03222,Saint-Caprais,94,89,5
84,03,210302238,03223,Saint-Christophe-en-Bourbonnais,451,437,14
84,03,210302246,03224,Saint-Clément,292,285,7
84,03,210302253,03225,Saint-Désiré,450,441,9
84,03,210302261,03226,Saint-Didier-en-Donjon,252,248,4
84,03,210302279,03227,Saint-Didier-la-Forêt,381,374,7
84,03,210302287,03228,Saint-Éloy-d'Allier,44,44,0
84,03,210302295,03229,Saint-Ennemond,621,605,16
84,03,210302303,03230,Saint-Étienne-de-Vicq,531,526,5
84,03,210302311,03231,Saint-Fargeol,197,188,9
84,03,210302329,03232,Saint-Félix,307,298,9
84,03,210302337,03233,Saint-Genest,396,389,7
84,03,210302345,03234,Saint-Gérand-de-Vaux,379,368,11
84,03,210302352,03235,Saint-Gérand-le-Puy,974,964,10
84,03,210302360,03236,Saint-Germain-des-Fossés,3723,3653,70
84,03,210302378,03237,Saint-Germain-de-Salles,434,426,8
84,03,210302386,03238,Saint-Hilaire,531,522,9
84,03,210302394,03239,Saint-Léger-sur-Vouzance,275,263,12
84,03,210302402,03240,Saint-Léon,549,539,10
84,03,210302410,03241,Saint-Léopardin-d'Augy,413,368,45
84,03,210302428,03242,Saint-Loup,578,565,13
84,03,210302436,03243,Saint-Marcel-en-Murat,126,124,2
84,03,210302444,03244,Saint-Marcel-en-Marcillat,128,127,1
84,03,210302451,03245,Saint-Martin-des-Lais,125,124,1
84,03,210302469,03246,Saint-Martinien,604,592,12
84,03,210302477,03247,Saint-Menoux,1152,1119,33
84,03,210302485,03248,Saint-Nicolas-des-Biefs,165,163,2
84,03,210302493,03249,Saint-Palais,164,161,3
84,03,210302501,03250,Saint-Pierre-Laval,354,347,7
84,03,210302519,03251,Saint-Plaisir,398,392,6
84,03,210302527,03252,Saint-Pont,715,698,17
84,03,210302535,03253,Saint-Pourçain-sur-Besbre,384,374,10
84,03,210302543,03254,Saint-Pourçain-sur-Sioule,5221,5100,121
84,03,210302550,03255,Saint-Priest-d'Andelot,147,144,3
84,03,210302568,03256,Saint-Priest-en-Murat,214,209,5
84,03,210302576,03257,Saint-Prix,823,801,22
84,03,210302584,03258,Saint-Rémy-en-Rollat,1783,1758,25
84,03,210302592,03259,Saint-Sauvier,336,333,3
84,03,210302600,03260,Saint-Sornin,229,223,6
84,03,210302618,03261,Sainte-Thérence,185,178,7
84,03,210302626,03262,Saint-Victor,2134,2097,37
84,03,210302634,03263,Saint-Voir,206,197,9
84,03,210302642,03264,Saint-Yorre,2610,2554,56
84,03,210302659,03265,Saligny-sur-Roudon,744,665,79
84,03,210302667,03266,Sanssat,286,278,8
84,03,210302675,03267,Saulcet,680,658,22
84,03,210302683,03268,Saulzet,389,386,3
84,03,210302691,03269,Sauvagny,87,84,3
84,03,210302709,03270,Sazeret,144,142,2
84,03,210302717,03271,Serbannes,837,805,32
84,03,210302725,03272,Servilly,282,275,7
84,03,210302733,03273,Seuillet,499,484,15
84,03,210302741,03274,Sorbier,324,318,6
84,03,210302758,03275,Souvigny,1786,1736,50
84,03,210302766,03276,Sussat,109,103,6
84,03,210302774,03277,Target,258,254,4
84,03,210302782,03278,Taxat-Senat,193,189,4
84,03,210302790,03279,Teillet-Argenty,563,555,8
84,03,210302808,03280,Terjat,190,181,9
84,03,210302816,03281,Le Theil,392,389,3
84,03,210302824,03282,Theneuille,366,360,6
84,03,210302832,03283,Thiel-sur-Acolin,1054,1035,19
84,03,210302840,03284,Thionne,297,288,9
84,03,210302857,03285,Tortezais,189,180,9
84,03,210302865,03286,Toulon-sur-Allier,1160,1140,20
84,03,210302873,03287,Treban,389,381,8
84,03,210302881,03288,Treignat,387,379,8
84,03,210302899,03289,Treteau,521,510,11
84,03,210302907,03290,Trévol,1690,1634,56
84,03,210302915,03291,Trézelles,420,407,13
84,03,210302923,03292,Tronget,892,883,9
84,03,210302931,03293,Urçay,303,293,10
84,03,210302949,03294,Ussel-d'Allier,170,169,1
84,03,210302956,03295,Valignat,73,72,1
84,03,210302964,03296,Valigny,385,373,12
84,03,210302972,03297,Vallon-en-Sully,1542,1514,28
84,03,210302980,03298,Varennes-sur-Allier,3713,3642,71
84,03,210302998,03299,Varennes-sur-Tèche,233,225,8
84,03,210303004,03300,Vaumas,547,535,12
84,03,210303012,03301,Vaux,1188,1163,25
84,03,210303020,03302,Veauce,39,38,1
84,03,210303038,03303,Venas,247,237,10
84,03,210303046,03304,Vendat,2323,2262,61
84,03,210303053,03305,Verneix,599,587,12
84,03,210303061,03306,Le Vernet,1957,1906,51
84,03,210303079,03307,Verneuil-en-Bourbonnais,239,236,3
84,03,210303087,03308,Vernusse,154,152,2
84,03,210303095,03309,Le Veurdre,456,452,4
84,03,210303103,03310,Vichy,25680,25372,308
84,03,210303111,03311,Vicq,304,297,7
84,03,210303129,03312,Vieure,283,272,11
84,03,210303137,03313,Le Vilhain,284,276,8
84,03,210303145,03314,Villebret,1366,1330,36
84,03,210303152,03315,Villefranche-d'Allier,1321,1282,39
84,03,210303160,03316,Villeneuve-sur-Allier,1090,1074,16
84,03,210303178,03317,Viplaix,298,291,7
84,03,210303194,03319,Voussac,499,489,10
84,03,210303202,03320,Ygrande,793,777,16
84,03,210303210,03321,Yzeure,13224,12701,523
93,04,210400016,04001,Aiglun,1448,1420,28
93,04,210400040,04004,Allemagne-en-Provence,558,544,14
93,04,210400057,04005,Allons,131,128,3
93,04,210400065,04006,Allos,845,837,8
93,04,210400073,04007,Angles,67,67,0
93,04,210400081,04008,Annot,1056,1021,35
93,04,210400099,04009,Archail,14,14,0
93,04,210400123,04012,Aubenas-les-Alpes,92,91,1
93,04,210400131,04013,Aubignosc,631,616,15
93,04,210400164,04016,Authon,63,63,0
93,04,210400172,04017,Auzet,106,101,5
93,04,210400180,04018,Banon,1074,1057,17
93,04,210400198,04019,Barcelonnette,2760,2561,199
93,04,210400206,04020,Barles,134,132,2
93,04,210400214,04021,Barras,150,146,4
93,04,210400222,04022,Barrême,418,410,8
93,04,210400230,04023,Bayons,197,193,4
93,04,210400248,04024,Beaujeu,128,125,3
93,04,210400255,04025,Beauvezer,406,392,14
93,04,210400263,04026,Bellaffaire,145,143,2
93,04,210400271,04027,Bevons,306,253,53
93,04,210400289,04028,Beynes,122,121,1
93,04,210400305,04030,Blieux,55,55,0
93,04,210400313,04031,Bras-d'Asse,565,554,11
93,04,210400321,04032,Braux,127,127,0
93,04,200071959,04033,Ubaye-Serre-Ponçon,800,782,18
93,04,210400347,04034,La Brillanne,1132,1117,15
93,04,210400354,04035,Brunet,295,289,6
93,04,210400362,04036,Le Brusquet,996,966,30
93,04,210400370,04037,Le Caire,76,74,2
93,04,210400396,04039,Castellane,1502,1462,40
93,04,210400404,04040,Le Castellard-Mélan,63,62,1
93,04,210400412,04041,Le Castellet,304,298,6
93,04,210400420,04042,Castellet-lès-Sausses,139,138,1
93,04,210400438,04043,Val-de-Chalvagne,88,85,3
93,04,210400453,04045,Céreste,1221,1198,23
93,04,210400461,04046,Le Chaffaut-Saint-Jurson,791,688,103
93,04,210400479,04047,Champtercier,877,856,21
93,04,210400495,04049,Château-Arnoux-Saint-Auban,5172,5063,109
93,04,210400503,04050,Châteaufort,26,26,0
93,04,210400511,04051,Châteauneuf-Miravail,75,73,2
93,04,210400537,04053,Châteauneuf-Val-Saint-Donat,514,502,12
93,04,210400545,04054,Châteauredon,74,73,1
93,04,210400552,04055,Chaudon-Norante,190,190,0
93,04,210400578,04057,Clamensane,181,178,3
93,04,210400586,04058,Claret,285,280,5
93,04,210400594,04059,Clumanc,224,221,3
93,04,210400610,04061,Colmars,484,479,5
93,04,210400628,04062,La Condamine-Châtelard,154,151,3
93,04,210400636,04063,Corbières-en-Provence,1277,1241,36
93,04,210400651,04065,Cruis,633,627,6
93,04,210400669,04066,Curbans,588,576,12
93,04,210400677,04067,Curel,52,51,1
93,04,210400685,04068,Dauphin,852,839,13
93,04,210400693,04069,Demandolx,132,127,5
93,04,210400701,04070,Digne-les-Bains,17804,16864,940
93,04,210400727,04072,Draix,113,111,2
93,04,210400735,04073,Enchastrayes,397,385,12
93,04,210400743,04074,Entrages,102,100,2
93,04,210400750,04075,Entrepierres,393,384,9
93,04,210400768,04076,Entrevaux,831,810,21
93,04,210400776,04077,Entrevennes,174,171,3
93,04,210400792,04079,L'Escale,1414,1378,36
93,04,210400818,04081,Esparron-de-Verdon,393,389,4
93,04,210400842,04084,Estoublon,494,487,7
93,04,210400859,04085,Faucon-du-Caire,61,59,2
93,04,210400867,04086,Faucon-de-Barcelonnette,311,295,16
93,04,210400875,04087,Fontienne,137,135,2
93,04,210400883,04088,Forcalquier,5210,5115,95
93,04,210400909,04090,Le Fugeret,210,206,4
93,04,210400917,04091,Ganagobie,92,92,0
93,04,210400925,04092,La Garde,125,121,4
93,04,210400933,04093,Gigors,61,60,1
93,04,210400941,04094,Gréoux-les-Bains,2825,2790,35
93,04,210400958,04095,L'Hospitalet,90,90,0
93,04,210400966,04096,Jausiers,1163,1137,26
93,04,210400974,04097,La Javie,380,375,5
93,04,210400990,04099,Lambruisse,90,85,5
93,04,210401014,04101,Lardiers,135,132,3
93,04,210401022,04102,Le Lauzet-Ubaye,181,178,3
93,04,210401048,04104,Limans,401,390,11
93,04,210401063,04106,Lurs,387,378,9
93,04,210401071,04107,Majastres,4,4,0
93,04,210401089,04108,Malijai,2015,1984,31
93,04,210401097,04109,Mallefougasse-Augès,329,325,4
93,04,210401105,04110,Mallemoisson,1022,994,28
93,04,210401113,04111,Mane,1380,1349,31
93,04,210401121,04112,Manosque,23689,23018,671
93,04,210401139,04113,Marcoux,463,449,14
93,04,210401154,04115,Méailles,122,120,2
93,04,210401162,04116,Les Mées,3813,3766,47
93,04,210401188,04118,Melve,124,123,1
93,04,200058618,04120,Val d'Oronaye,118,117,1
93,04,210401212,04121,Mézel,642,631,11
93,04,210401220,04122,Mirabeau,523,512,11
93,04,210401238,04123,Mison,1148,1118,30
93,04,210401246,04124,Montagnac-Montpezat,420,413,7
93,04,210401261,04126,Montclar,418,403,15
93,04,210401279,04127,Montfort,329,325,4
93,04,210401287,04128,Montfuron,235,226,9
93,04,210401295,04129,Montjustin,60,59,1
93,04,210401303,04130,Montlaux,209,207,2
93,04,210401329,04132,Montsalier,153,152,1
93,04,210401337,04133,Moriez,239,238,1
93,04,210401345,04134,La Motte-du-Caire,573,550,23
93,04,210401352,04135,Moustiers-Sainte-Marie,733,718,15
93,04,210401360,04136,La Mure-Argens,317,309,8
93,04,210401378,04137,Nibles,46,45,1
93,04,210401386,04138,Niozelles,291,285,6
93,04,210401394,04139,Noyers-sur-Jabron,532,523,9
93,04,210401402,04140,Les Omergues,130,127,3
93,04,210401410,04141,Ongles,370,363,7
93,04,210401428,04142,Oppedette,51,51,0
93,04,210401436,04143,Oraison,6035,5920,115
93,04,210401444,04144,La Palud-sur-Verdon,352,351,1
93,04,210401451,04145,Peipin,1496,1463,33
93,04,210401485,04148,Peyroules,259,250,9
93,04,210401493,04149,Peyruis,2847,2801,46
93,04,210401501,04150,Piégut,208,204,4
93,04,210401519,04151,Pierrerue,536,523,13
93,04,210401527,04152,Pierrevert,4070,3936,134
93,04,210401543,04154,Pontis,97,96,1
93,04,210401550,04155,Prads-Haute-Bléone,178,177,1
93,04,210401568,04156,Puimichel,271,270,1
93,04,210401576,04157,Puimoisson,691,683,8
93,04,210401584,04158,Quinson,414,406,8
93,04,210401592,04159,Redortiers,84,84,0
93,04,210401600,04160,Reillanne,1732,1697,35
93,04,210401618,04161,Méolans-Revel,331,324,7
93,04,210401626,04162,Revest-des-Brousses,265,259,6
93,04,210401634,04163,Revest-du-Bion,519,507,12
93,04,210401642,04164,Revest-Saint-Martin,89,88,1
93,04,210401667,04166,Riez,1700,1661,39
93,04,210401675,04167,La Robine-sur-Galabre,291,286,5
93,04,210401691,04169,La Rochegiron,107,105,2
93,04,210401709,04170,La Rochette,74,74,0
93,04,210401717,04171,Rougon,122,122,0
93,04,210401725,04172,Roumoules,745,734,11
93,04,210401733,04173,Saint-André-les-Alpes,1036,1015,21
93,04,210401741,04174,Saint-Benoît,153,152,1
93,04,210401758,04175,Sainte-Croix-à-Lauze,92,90,2
93,04,210401766,04176,Sainte-Croix-du-Verdon,121,117,4
93,04,210401774,04177,Hautes-Duyes,45,45,0
93,04,210401782,04178,Saint-Étienne-les-Orgues,1352,1316,36
93,04,210401790,04179,Saint-Geniez,108,106,2
93,04,210401808,04180,Saint-Jacques,85,81,4
93,04,210401816,04181,Saint-Jeannet,49,48,1
93,04,210401824,04182,Saint-Julien-d'Asse,217,215,2
93,04,210401832,04183,Saint-Julien-du-Verdon,156,153,3
93,04,210401840,04184,Saint-Jurs,139,136,3
93,04,210401865,04186,Saint-Laurent-du-Verdon,97,96,1
93,04,210401873,04187,Saint-Lions,41,40,1
93,04,210401881,04188,Saint-Maime,879,867,12
93,04,210401899,04189,Saint-Martin-de-Brômes,648,634,14
93,04,210401907,04190,Saint-Martin-les-Eaux,127,124,3
93,04,210401915,04191,Saint-Martin-lès-Seyne,14,12,2
93,04,210401923,04192,Saint-Michel-l'Observatoire,1254,1230,24
93,04,210401931,04193,Saint-Paul-sur-Ubaye,184,177,7
93,04,210401949,04194,Saint-Pierre,99,97,2
93,04,210401956,04195,Saint-Pons,613,600,13
93,04,210401972,04197,Sainte-Tulle,3559,3475,84
93,04,210401998,04199,Saint-Vincent-sur-Jabron,174,170,4
93,04,210402004,04200,Salignac,682,660,22
93,04,210402012,04201,Saumane,123,120,3
93,04,210402020,04202,Sausses,132,130,2
93,04,210402038,04203,Selonnet,481,472,9
93,04,210402046,04204,Senez,165,161,4
93,04,210402053,04205,Seyne,1400,1372,28
93,04,210402061,04206,Sigonce,434,426,8
93,04,210402079,04207,Sigoyer,105,101,4
93,04,210402087,04208,Simiane-la-Rotonde,623,607,16
93,04,210402095,04209,Sisteron,7910,7669,241
93,04,210402103,04210,Soleilhas,92,88,4
93,04,210402111,04211,Sourribes,181,178,3
93,04,210402145,04214,Tartonne,131,129,2
93,04,210402160,04216,Thèze,236,231,5
93,04,210402178,04217,Thoard,757,738,19
93,04,210402186,04218,Thorame-Basse,230,224,6
93,04,210402194,04219,Thorame-Haute,251,245,6
93,04,210402202,04220,Les Thuiles,381,370,11
93,04,210402228,04222,Turriers,351,343,8
93,04,210402244,04224,Ubraye,101,100,1
93,04,210402269,04226,Uvernet-Fours,574,562,12
93,04,210402277,04227,Vachères,296,289,7
93,04,210402285,04228,Valavoire,37,37,0
93,04,210402293,04229,Valbelle,243,239,4
93,04,210402301,04230,Valensole,3224,3158,66
93,04,210402319,04231,Valernes,250,244,6
93,04,210402335,04233,Vaumeilh,275,267,8
93,04,210402343,04234,Venterol,228,226,2
93,04,210402350,04235,Verdaches,63,62,1
93,04,210402368,04236,Vergons,107,107,0
93,04,210402376,04237,Le Vernet,128,125,3
93,04,210402400,04240,Villars-Colmars,255,250,5
93,04,210402418,04241,Villemus,199,194,5
93,04,210402426,04242,Villeneuve,4439,4355,84
93,04,210402442,04244,Volonne,1671,1639,32
93,04,210402459,04245,Volx,3283,3212,71
93,05,200083517,05001,Abriès-Ristolas,389,383,6
93,05,210500039,05003,Aiguilles,393,382,11
93,05,210500047,05004,Ancelle,930,916,14
93,05,210500062,05006,L'Argentière-la-Bessée,2324,2238,86
93,05,210500070,05007,Arvieux,362,354,8
93,05,210500088,05008,Aspremont,375,369,6
93,05,210500096,05009,Aspres-lès-Corps,100,97,3
93,05,210500104,05010,Aspres-sur-Buëch,813,802,11
93,05,210500112,05011,Avançon,428,419,9
93,05,210500120,05012,Baratier,641,627,14
93,05,210500138,05013,Barcillonnette,128,123,5
93,05,210500146,05014,Barret-sur-Méouge,185,181,4
93,05,210500161,05016,La Bâtie-Montsaléon,259,257,2
93,05,210500179,05017,La Bâtie-Neuve,2649,2579,70
93,05,210500187,05018,La Bâtie-Vieille,338,328,10
93,05,210500195,05019,La Beaume,154,150,4
93,05,210500211,05021,Le Bersac,142,141,1
93,05,210500229,05022,Bréziers,252,249,3
93,05,210500237,05023,Briançon,11095,10780,315
93,05,200075059,05024,Valdoule,226,218,8
93,05,210500252,05025,Buissard,216,209,7
93,05,210500260,05026,Ceillac,285,282,3
93,05,210500278,05027,Cervières,199,195,4
93,05,210500286,05028,Chabestan,173,169,4
93,05,210500294,05029,Chabottes,944,918,26
93,05,210500310,05031,Champcella,189,185,4
93,05,210500328,05032,Champoléon,139,136,3
93,05,210500336,05033,Chanousse,41,41,0
93,05,210500351,05035,Châteauneuf-d'Oze,33,30,3
93,05,210500369,05036,Châteauroux-les-Alpes,1235,1200,35
93,05,210500377,05037,Châteauvieux,539,519,20
93,05,210500385,05038,Château-Ville-Vieille,322,306,16
93,05,200077113,05039,Aubessagne,730,716,14
93,05,210500401,05040,Chorges,3156,3077,79
93,05,210500443,05044,Crévoux,128,125,3
93,05,210500450,05045,Crots,1156,1125,31
93,05,210500468,05046,Embrun,6781,6435,346
93,05,210500476,05047,Éourres,124,120,4
93,05,210500484,05048,L'Épine,209,203,6
93,05,210500492,05049,Esparron,58,58,0
93,05,210500500,05050,Espinasses,832,823,9
93,05,210500518,05051,Étoile-Saint-Cyrice,28,28,0
93,05,210500526,05052,Eygliers,812,800,12
93,05,200054211,05053,Garde-Colombe,536,525,11
93,05,210500542,05054,La Fare-en-Champsaur,458,448,10
93,05,210500559,05055,La Faurie,322,317,5
93,05,210500567,05056,Forest-Saint-Julien,341,333,8
93,05,210500575,05057,Fouillouse,267,261,6
93,05,210500583,05058,Freissinières,208,205,3
93,05,210500591,05059,La Freissinouse,953,933,20
93,05,210500609,05060,Furmeyer,189,181,8
93,05,210500617,05061,Gap,41528,40111,1417
93,05,210500625,05062,Le Glaizil,169,166,3
93,05,210500633,05063,La Grave,487,477,10
93,05,210500641,05064,La Chapelle-en-Valgaudémar,108,105,3
93,05,210500658,05065,Guillestre,2374,2291,83
93,05,210500666,05066,La Haute-Beaume,8,8,0
93,05,210500682,05068,Jarjayes,478,466,12
93,05,210500708,05070,Laragne-Montéglin,3631,3579,52
93,05,210500716,05071,Lardier-et-Valença,369,349,20
93,05,210500724,05072,Laye,248,243,5
93,05,210500732,05073,Lazer,355,341,14
93,05,210500740,05074,Lettret,201,201,0
93,05,210500757,05075,Manteyer,465,450,15
93,05,210500765,05076,Méreuil,92,92,0
93,05,210500773,05077,Molines-en-Queyras,302,300,2
93,05,210500781,05078,Monêtier-Allemont,294,284,10
93,05,210500799,05079,Le Monêtier-les-Bains,1085,1062,23
93,05,210500807,05080,Montbrand,64,63,1
93,05,210500815,05081,Montclus,54,50,4
93,05,210500823,05082,Mont-Dauphin,175,173,2
93,05,210500849,05084,Montgardin,472,465,7
93,05,210500856,05085,Montgenèvre,466,452,14
93,05,210500864,05086,Montjay,106,104,2
93,05,210500872,05087,Montmaur,552,537,15
93,05,210500898,05089,Montrond,88,87,1
93,05,210500906,05090,La Motte-en-Champsaur,214,209,5
93,05,210500914,05091,Moydans,44,40,4
93,05,210500922,05092,Neffes,796,781,15
93,05,210500930,05093,Névache,367,357,10
93,05,210500948,05094,Nossage-et-Bénévent,15,14,1
93,05,210500955,05095,Le Noyer,309,306,3
93,05,210500963,05096,Orcières,696,680,16
93,05,210500971,05097,Orpierre,377,344,33
93,05,210500989,05098,Les Orres,543,530,13
93,05,210500997,05099,Oze,104,103,1
93,05,210501003,05100,Pelleautier,841,810,31
93,05,200064657,05101,Vallouise-Pelvoux,1168,1129,39
93,05,210501029,05102,La Piarre,93,91,2
93,05,210501037,05103,Le Poët,812,791,21
93,05,210501045,05104,Poligny,352,337,15
93,05,210501060,05106,Prunières,307,300,7
93,05,210501078,05107,Puy-Saint-André,470,459,11
93,05,210501086,05108,Puy-Saint-Eusèbe,187,181,6
93,05,210501094,05109,Puy-Saint-Pierre,535,515,20
93,05,210501102,05110,Puy-Saint-Vincent,292,290,2
93,05,210501110,05111,Puy-Sanières,276,267,9
93,05,210501128,05112,Rabou,89,89,0
93,05,210501136,05113,Rambaud,392,375,17
93,05,210501144,05114,Réallon,249,248,1
93,05,210501151,05115,Remollon,468,458,10
93,05,210501169,05116,Réotier,211,209,2
93,05,210501177,05117,Ribeyret,114,114,0
93,05,200053148,05118,Val Buëch-Méouge,1356,1329,27
93,05,210501193,05119,Risoul,676,658,18
93,05,210501219,05121,Rochebrune,185,179,6
93,05,210501227,05122,La Roche-de-Rame,857,837,20
93,05,210501235,05123,La Roche-des-Arnauds,1621,1578,43
93,05,210501243,05124,La Rochette,482,473,9
93,05,210501268,05126,Rosans,477,469,8
93,05,210501276,05127,Rousset,182,177,5
93,05,210501284,05128,Saint-André-d'Embrun,719,697,22
93,05,210501292,05129,Saint-André-de-Rosans,157,154,3
93,05,210501300,05130,Saint-Apollinaire,201,196,5
93,05,210501318,05131,Saint-Auban-d'Oze,81,77,4
93,05,200034502,05132,Saint-Bonnet-en-Champsaur,2146,2078,68
93,05,210501334,05133,Saint-Chaffrey,1569,1523,46
93,05,210501342,05134,Saint-Clément-sur-Durance,326,321,5
93,05,210501359,05135,Sainte-Colombe,57,55,2
93,05,210501367,05136,Saint-Crépin,746,732,14
93,05,200033694,05139,Dévoluy,930,904,26
93,05,210501409,05140,Saint-Étienne-le-Laus,308,302,6
93,05,210501425,05142,Saint-Firmin,456,446,10
93,05,210501441,05144,Saint-Jacques-en-Valgodemard,139,134,5
93,05,210501458,05145,Saint-Jean-Saint-Nicolas,1166,1075,91
93,05,210501466,05146,Saint-Julien-en-Beauchêne,138,137,1
93,05,210501474,05147,Saint-Julien-en-Champsaur,377,372,5
93,05,210501482,05148,Saint-Laurent-du-Cros,556,548,8
93,05,210501490,05149,Saint-Léger-les-Mélèzes,378,366,12
93,05,210501516,05151,Saint-Martin-de-Queyrières,1164,1127,37
93,05,210501524,05152,Saint-Maurice-en-Valgodemard,124,123,1
93,05,210501532,05153,Saint-Michel-de-Chaillol,367,356,11
93,05,210501540,05154,Saint-Pierre-d'Argençon,163,163,0
93,05,210501557,05155,Saint-Pierre-Avez,31,30,1
93,05,210501565,05156,Saint-Sauveur,528,517,11
93,05,210501573,05157,Saint-Véran,176,171,5
93,05,210501581,05158,Le Saix,122,121,1
93,05,210501599,05159,Saléon,88,85,3
93,05,210501607,05160,Salérans,82,82,0
93,05,210501615,05161,La Salle-les-Alpes,953,931,22
93,05,210501623,05162,La Saulce,1431,1397,34
93,05,210501631,05163,Le Sauze-du-Lac,150,149,1
93,05,210501649,05164,Savines-le-Lac,1135,1080,55
93,05,210501656,05165,Savournon,254,248,6
93,05,210501664,05166,Serres,1319,1292,27
93,05,210501672,05167,Sigottier,87,85,2
93,05,210501680,05168,Sigoyer,749,727,22
93,05,210501698,05169,Sorbiers,40,40,0
93,05,210501706,05170,Tallard,2349,2295,54
93,05,210501714,05171,Théus,225,221,4
93,05,210501722,05172,Trescléoux,311,306,5
93,05,210501730,05173,Upaix,470,460,10
93,05,210501748,05174,Val-des-Prés,635,613,22
93,05,210501763,05176,Valserres,280,273,7
93,05,210501771,05177,Vars,565,554,11
93,05,210501789,05178,Ventavon,638,599,39
93,05,210501797,05179,Veynes,3378,3231,147
93,05,210501805,05180,Les Vigneaux,546,532,14
93,05,210501813,05181,Villar-d'Arêne,300,287,13
93,05,210501821,05182,Villar-Loubière,39,38,1
93,05,210501839,05183,Villar-Saint-Pancrace,1500,1466,34
93,05,210501847,05184,Vitrolles,218,210,8
93,06,210600011,06001,Aiglun,93,93,0
93,06,210600029,06002,Amirat,52,52,0
93,06,210600037,06003,Andon,649,644,5
93,06,210600045,06004,Antibes,75779,74709,1070
93,06,210600052,06005,Ascros,177,177,0
93,06,210600060,06006,Aspremont,2304,2271,33
93,06,210600078,06007,Auribeau-sur-Siagne,3243,3175,68
93,06,210600086,06008,Auvare,38,37,1
93,06,210600094,06009,Bairols,117,116,1
93,06,210600102,06010,Le Bar-sur-Loup,2989,2927,62
93,06,210600110,06011,Beaulieu-sur-Mer,3788,3762,26
93,06,210600128,06012,Beausoleil,13280,13153,127
93,06,210600136,06013,Belvédère,678,658,20
93,06,210600144,06014,Bendejun,946,940,6
93,06,210600151,06015,Berre-les-Alpes,1259,1236,23
93,06,210600169,06016,Beuil,556,552,4
93,06,210600177,06017,Bézaudun-les-Alpes,260,256,4
93,06,210600185,06018,Biot,9926,9575,351
93,06,210600193,06019,Blausasc,1681,1663,18
93,06,210600201,06020,La Bollène-Vésubie,602,594,8
93,06,210600219,06021,Bonson,727,723,4
93,06,210600227,06022,Bouyon,554,548,6
93,06,210600235,06023,Breil-sur-Roya,2173,2121,52
93,06,210600243,06024,Briançonnet,206,201,5
93,06,210600250,06025,Le Broc,1424,1417,7
93,06,210600268,06026,Cabris,1413,1386,27
93,06,210600276,06027,Cagnes-sur-Mer,52575,52100,475
93,06,210600284,06028,Caille,412,407,5
93,06,210600292,06029,Cannes,73159,72435,724
93,06,210600300,06030,Le Cannet,42524,42125,399
93,06,210600318,06031,Cantaron,1303,1293,10
93,06,210600326,06032,Cap-d'Ail,4585,4517,68
93,06,210600334,06033,Carros,13010,12875,135
93,06,210600342,06034,Castagniers,1690,1674,16
93,06,210600359,06035,Castellar,1142,1133,9
93,06,210600367,06036,Castillon,421,417,4
93,06,210600375,06037,Caussols,305,302,3
93,06,210600383,06038,Châteauneuf-Grasse,3750,3690,60
93,06,210600391,06039,Châteauneuf-Villevieille,965,956,9
93,06,210600409,06040,Châteauneuf-d'Entraunes,63,63,0
93,06,210600417,06041,Cipières,409,403,6
93,06,210600425,06042,Clans,682,670,12
93,06,210600433,06043,Coaraze,825,821,4
93,06,210600441,06044,La Colle-sur-Loup,8208,8048,160
93,06,210600458,06045,Collongues,73,71,2
93,06,210600466,06046,Colomars,3534,3494,40
93,06,210600474,06047,Conségudes,96,95,1
93,06,210600482,06048,Contes,7612,7534,78
93,06,210600490,06049,Courmes,110,108,2
93,06,210600508,06050,Coursegoules,535,529,6
93,06,210600516,06051,La Croix-sur-Roudoule,100,98,2
93,06,210600524,06052,Cuébris,165,164,1
93,06,210600532,06053,Daluis,142,141,1
93,06,210600540,06054,Drap,5195,5176,19
93,06,210600557,06055,Duranus,155,152,3
93,06,210600565,06056,Entraunes,145,143,2
93,06,210600573,06057,L'Escarène,2580,2562,18
93,06,210600581,06058,Escragnolles,627,612,15
93,06,210600599,06059,Èze,2259,2222,37
93,06,210600607,06060,Falicon,2098,2053,45
93,06,210600615,06061,Les Ferres,94,91,3
93,06,210600623,06062,Fontan,316,315,1
93,06,210600631,06063,Gars,74,74,0
93,06,210600649,06064,Gattières,4272,4229,43
93,06,210600656,06065,La Gaude,7225,7117,108
93,06,210600664,06066,Gilette,1609,1598,11
93,06,210600672,06067,Gorbio,1498,1485,13
93,06,210600680,06068,Gourdon,380,371,9
93,06,210600698,06069,Grasse,49607,48708,899
93,06,210600706,06070,Gréolières,577,564,13
93,06,210600714,06071,Guillaumes,592,585,7
93,06,210600722,06072,Ilonse,148,147,1
93,06,210600730,06073,Isola,667,653,14
93,06,210600748,06074,Lantosque,1215,1206,9
93,06,210600755,06075,Levens,5011,4963,48
93,06,210600763,06076,Lieuche,48,48,0
93,06,210600771,06077,Lucéram,1291,1279,12
93,06,210600789,06078,Malaussène,333,326,7
93,06,210600797,06079,Mandelieu-la-Napoule,22067,21772,295
93,06,210600805,06080,Marie,109,105,4
93,06,210600813,06081,Le Mas,102,100,2
93,06,210600821,06082,Massoins,105,104,1
93,06,210600839,06083,Menton,31163,30679,484
93,06,210600847,06084,Mouans-Sartoux,10397,10215,182
93,06,210600854,06085,Mougins,20626,20180,446
93,06,210600862,06086,Moulinet,254,252,2
93,06,210600870,06087,Les Mujouls,41,41,0
93,06,210600888,06088,Nice,346376,343477,2899
93,06,210600896,06089,Opio,2452,2375,77
93,06,210600904,06090,Pégomas,8047,7956,91
93,06,210600912,06091,Peille,2386,2369,17
93,06,210600920,06092,Peillon,1477,1465,12
93,06,210600938,06093,La Penne,227,223,4
93,06,210600946,06094,Péone,886,880,6
93,06,210600953,06095,Peymeinade,8400,8211,189
93,06,210600961,06096,Pierlas,104,103,1
93,06,210600979,06097,Pierrefeu,335,335,0
93,06,210600987,06098,Puget-Rostang,127,126,1
93,06,210600995,06099,Puget-Théniers,1906,1826,80
93,06,210601001,06100,Revest-les-Roches,230,229,1
93,06,210601019,06101,Rigaud,172,170,2
93,06,210601027,06102,Rimplas,113,112,1
93,06,210601035,06103,Roquebillière,1872,1822,50
93,06,210601043,06104,Roquebrune-Cap-Martin,13162,12966,196
93,06,210601050,06105,Roquefort-les-Pins,7476,7277,199
93,06,210601068,06106,Roquestéron,578,570,8
93,06,210601076,06107,La Roque-en-Provence,65,64,1
93,06,210601084,06108,La Roquette-sur-Siagne,5509,5413,96
93,06,210601092,06109,La Roquette-sur-Var,959,954,5
93,06,210601100,06110,Roubion,121,119,2
93,06,210601118,06111,Roure,119,116,3
93,06,210601126,06112,Le Rouret,4219,4115,104
93,06,210601134,06113,Sainte-Agnès,1359,1336,23
93,06,210601142,06114,Saint-André-de-la-Roche,5722,5694,28
93,06,210601159,06115,Saint-Antonin,89,86,3
93,06,210601167,06116,Saint-Auban,217,214,3
93,06,210601175,06117,Saint-Blaise,1360,1350,10
93,06,210601183,06118,Saint-Cézaire-sur-Siagne,4028,3927,101
93,06,210601191,06119,Saint-Dalmas-le-Selvage,107,105,2
93,06,210601209,06120,Saint-Étienne-de-Tinée,1566,1413,153
93,06,210601217,06121,Saint-Jean-Cap-Ferrat,1489,1481,8
93,06,210601225,06122,Saint-Jeannet,4431,4317,114
93,06,210601233,06123,Saint-Laurent-du-Var,30333,30141,192
93,06,210601241,06124,Saint-Léger,48,48,0
93,06,210601258,06125,Saint-Martin-d'Entraunes,160,153,7
93,06,210601266,06126,Saint-Martin-du-Var,3162,3143,19
93,06,210601274,06127,Saint-Martin-Vésubie,1443,1431,12
93,06,210601282,06128,Saint-Paul-de-Vence,3247,3179,68
93,06,210601290,06129,Saint-Sauveur-sur-Tinée,389,307,82
93,06,210601308,06130,Saint-Vallier-de-Thiey,3775,3671,104
93,06,210601316,06131,Sallagriffon,50,48,2
93,06,210601324,06132,Saorge,453,449,4
93,06,210601332,06133,Sauze,73,72,1
93,06,210601340,06134,Séranon,545,537,8
93,06,210601357,06135,Sigale,199,197,2
93,06,210601365,06136,Sospel,3879,3792,87
93,06,210601373,06137,Spéracèdes,1195,1171,24
93,06,210601381,06138,Théoule-sur-Mer,1377,1361,16
93,06,210601399,06139,Thiéry,110,107,3
93,06,210601407,06140,Le Tignet,3123,3069,54
93,06,210601415,06141,Toudon,349,348,1
93,06,210601423,06142,Touët-de-l'Escarène,309,308,1
93,06,210601431,06143,Touët-sur-Var,700,690,10
93,06,210601449,06144,La Tour,553,549,4
93,06,210601456,06145,Tourette-du-Château,140,138,2
93,06,210601464,06146,Tournefort,150,149,1
93,06,210601472,06147,Tourrette-Levens,4921,4887,34
93,06,210601480,06148,Tourrettes-sur-Loup,4164,4063,101
93,06,210601498,06149,La Trinité,10155,10103,52
93,06,210601506,06150,La Turbie,3052,2997,55
93,06,210601514,06151,Utelle,864,863,1
93,06,210601522,06152,Valbonne,13665,13162,503
93,06,210601530,06153,Valdeblore,1123,834,289
93,06,210601548,06154,Valderoure,481,473,8
93,06,210601555,06155,Vallauris,28168,27970,198
93,06,210601563,06156,Venanson,174,173,1
93,06,210601571,06157,Vence,19585,19315,270
93,06,210601589,06158,Villars-sur-Var,784,778,6
93,06,210601597,06159,Villefranche-sur-Mer,5037,5002,35
93,06,210601605,06160,Villeneuve-d'Entraunes,93,91,2
93,06,210601613,06161,Villeneuve-Loubet,16588,16329,259
93,06,210601621,06162,La Brigue,706,696,10
93,06,210601639,06163,Tende,2193,2144,49
84,07,210700019,07001,Accons,385,373,12
84,07,210700027,07002,Ailhon,569,551,18
84,07,210700035,07003,Aizac,171,170,1
84,07,210700043,07004,Ajoux,80,79,1
84,07,210700050,07005,Alba-la-Romaine,1533,1489,44
84,07,210700068,07006,Albon-d'Ardèche,164,158,6
84,07,210700076,07007,Alboussière,1011,998,13
84,07,210700084,07008,Alissas,1499,1447,52
84,07,210700092,07009,Andance,1223,1201,22
84,07,210700100,07010,Annonay,16962,16359,603
84,07,200085165,07011,Vallées-d'Antraigues-Asperjoc,885,867,18
84,07,210700126,07012,Arcens,388,379,9
84,07,210700134,07013,Ardoix,1270,1248,22
84,07,210700142,07014,Arlebosc,331,324,7
84,07,210700159,07015,Arras-sur-Rhône,552,528,24
84,07,210700175,07017,Les Assions,779,764,15
84,07,210700183,07018,Astet,48,48,0
84,07,210700191,07019,Aubenas,13177,12403,774
84,07,210700209,07020,Aubignas,479,468,11
84,07,210700225,07022,Baix,1280,1268,12
84,07,210700233,07023,Balazuc,378,372,6
84,07,210700241,07024,Banne,679,658,21
84,07,210700258,07025,Barnas,208,206,2
84,07,210700266,07026,Le Béage,260,255,5
84,07,210700274,07027,Beauchastel,1871,1840,31
84,07,210700282,07028,Beaulieu,534,524,10
84,07,210700290,07029,Beaumont,257,254,3
84,07,210700308,07030,Beauvène,211,206,5
84,07,210700316,07031,Berrias-et-Casteljau,773,755,18
84,07,210700324,07032,Berzème,162,161,1
84,07,210700332,07033,Bessas,227,225,2
84,07,210700340,07034,Bidon,259,256,3
84,07,210700357,07035,Boffres,629,610,19
84,07,210700365,07036,Bogy,459,448,11
84,07,210700373,07037,Borée,151,147,4
84,07,210700381,07038,Borne,49,49,0
84,07,210700399,07039,Bozas,261,256,5
84,07,210700407,07040,Boucieu-le-Roi,259,254,5
84,07,210700415,07041,Boulieu-lès-Annonay,2390,2332,58
84,07,210700423,07042,Bourg-Saint-Andéol,7353,7187,166
84,07,210700449,07044,Brossainc,258,250,8
84,07,210700456,07045,Burzet,532,525,7
84,07,210700472,07047,Cellier-du-Luc,88,86,2
84,07,210700480,07048,Chalencon,345,338,7
84,07,210700498,07049,Le Chambon,59,56,3
84,07,210700506,07050,Chambonas,971,955,16
84,07,210700514,07051,Champagne,595,577,18
84,07,210700522,07052,Champis,626,616,10
84,07,210700530,07053,Chandolas,538,535,3
84,07,210700548,07054,Chanéac,266,256,10
84,07,210700555,07055,Charmes-sur-Rhône,3120,3044,76
84,07,210700563,07056,Charnas,922,904,18
84,07,210700589,07058,Chassiers,1056,1019,37
84,07,210700597,07059,Châteaubourg,246,238,8
84,07,210700605,07060,Châteauneuf-de-Vernoux,270,265,5
84,07,210700613,07061,Chauzon,431,419,12
84,07,210700621,07062,Chazeaux,149,145,4
84,07,210700639,07063,Cheminas,413,404,9
84,07,210700647,07064,Le Cheylard,3004,2849,155
84,07,210700654,07065,Chirols,237,234,3
84,07,210700662,07066,Chomérac,3178,3004,174
84,07,210700670,07067,Colombier-le-Cardinal,331,327,4
84,07,210700688,07068,Colombier-le-Jeune,577,571,6
84,07,210700696,07069,Colombier-le-Vieux,674,652,22
84,07,210700704,07070,Cornas,2377,2328,49
84,07,210700712,07071,Coucouron,792,782,10
84,07,210700720,07072,Coux,1701,1659,42
84,07,210700738,07073,Le Crestet,531,521,10
84,07,210700746,07074,Creysseilles,159,153,6
84,07,210700753,07075,Cros-de-Géorand,153,149,4
84,07,210700761,07076,Cruas,3135,3069,66
84,07,210700779,07077,Darbres,261,259,2
84,07,210700787,07078,Davézieux,3223,3144,79
84,07,210700795,07079,Désaignes,1176,1156,20
84,07,210700803,07080,Devesset,307,298,9
84,07,210700811,07081,Dompnac,64,64,0
84,07,210700829,07082,Dornas,214,202,12
84,07,210700837,07083,Dunière-sur-Eyrieux,447,436,11
84,07,210700845,07084,Eclassan,1068,1031,37
84,07,210700852,07085,Empurany,620,603,17
84,07,210700860,07086,Étables,956,936,20
84,07,210700878,07087,Fabras,452,444,8
84,07,210700886,07088,Faugères,96,94,2
84,07,210700894,07089,Félines,1803,1754,49
84,07,210700902,07090,Flaviac,1257,1240,17
84,07,210700910,07091,Fons,335,328,7
84,07,210700928,07092,Freyssenet,47,46,1
84,07,210700936,07093,Genestelle,283,275,8
84,07,210700944,07094,Gilhac-et-Bruzac,181,178,3
84,07,210700951,07095,Gilhoc-sur-Ormèze,468,464,4
84,07,210700969,07096,Gluiras,371,368,3
84,07,210700977,07097,Glun,711,693,18
84,07,210700985,07098,Gourdon,84,80,4
84,07,210700993,07099,Gras,640,618,22
84,07,210701009,07100,Gravières,532,513,19
84,07,210701017,07101,Grospierres,932,911,21
84,07,210701025,07102,Guilherand-Granges,11154,10965,189
84,07,200085835,07103,Saint-Julien-d'Intres,313,310,3
84,07,210701041,07104,Issamoulenc,93,93,0
84,07,210701058,07105,Issanlas,103,100,3
84,07,210701066,07106,Issarlès,126,125,1
84,07,210701074,07107,Jaujac,1316,1291,25
84,07,210701082,07108,Jaunac,125,117,8
84,07,210701090,07109,Joannas,301,295,6
84,07,210701108,07110,Joyeuse,1769,1741,28
84,07,210701116,07111,Juvinas,178,175,3
84,07,210701124,07112,Labastide-sur-Bésorgues,264,259,5
84,07,210701132,07113,Labastide-de-Virac,318,311,7
84,07,210701140,07114,Labatie-d'Andaure,201,199,2
84,07,210701157,07115,Labeaume,685,674,11
84,07,210701165,07116,Labégude,1380,1359,21
84,07,210701173,07117,Lablachère,2251,2213,38
84,07,210701181,07118,Laboule,151,145,6
84,07,210701199,07119,Le Lac-d'Issarlès,257,252,5
84,07,210701207,07120,Lachamp-Raphaël,58,58,0
84,07,210701215,07121,Lachapelle-Graillouse,191,191,0
84,07,210701223,07122,Lachapelle-sous-Aubenas,1747,1699,48
84,07,210701231,07123,Lachapelle-sous-Chanéac,169,163,6
84,07,210701249,07124,Lafarre,41,40,1
84,07,210701264,07126,Lagorce,1203,1179,24
84,07,210701272,07127,Lalevade-d'Ardèche,1144,1131,13
84,07,210701280,07128,Lalouvesc,380,374,6
84,07,210701298,07129,Lamastre,2401,2361,40
84,07,210701306,07130,Lanarce,212,207,5
84,07,210701314,07131,Lanas,490,448,42
84,07,210701322,07132,Largentière,1623,1573,50
84,07,210701330,07133,Larnas,253,250,3
84,07,210701348,07134,Laurac-en-Vivarais,1059,1032,27
84,07,210701363,07136,Laveyrune,105,104,1
84,07,210701371,07137,Lavillatte,43,43,0
84,07,210701389,07138,Lavilledieu,2280,2230,50
84,07,210701397,07139,Laviolle,103,103,0
84,07,210701405,07140,Lemps,821,797,24
84,07,210701413,07141,Lentillères,241,234,7
84,07,210701421,07142,Lespéron,323,314,9
84,07,210701439,07143,Limony,802,785,17
84,07,210701447,07144,Loubaresse,51,49,2
84,07,210701454,07145,Lussas,1172,1154,18
84,07,210701462,07146,Lyas,614,598,16
84,07,210701470,07147,Malarce-sur-la-Thines,247,242,5
84,07,210701488,07148,Malbosc,152,146,6
84,07,210701496,07149,Marcols-les-Eaux,284,279,5
84,07,210701504,07150,Mariac,567,551,16
84,07,210701512,07151,Mars,266,254,12
84,07,210701520,07152,Mauves,1217,1191,26
84,07,210701538,07153,Mayres,272,264,8
84,07,210701546,07154,Mazan-l'Abbaye,124,122,2
84,07,210701553,07155,Mercuer,1276,1245,31
84,07,210701561,07156,Meyras,958,929,29
84,07,210701579,07157,Meysse,1385,1372,13
84,07,210701587,07158,Mézilhac,97,97,0
84,07,210701595,07159,Mirabel,746,736,10
84,07,210701603,07160,Monestier,63,62,1
84,07,210701611,07161,Montpezat-sous-Bauzon,760,737,23
84,07,210701629,07162,Montréal,590,577,13
84,07,210701637,07163,Montselgues,88,83,5
84,07,200085801,07165,Belsentes,575,553,22
84,07,210701660,07166,Nozières,246,244,2
84,07,210701678,07167,Les Ollières-sur-Eyrieux,1034,1011,23
84,07,210701686,07168,Orgnac-l'Aven,596,587,9
84,07,210701694,07169,Ozon,381,380,1
84,07,210701702,07170,Pailharès,249,243,6
84,07,210701710,07171,Payzac,546,538,8
84,07,210701728,07172,Peaugres,2357,2305,52
84,07,210701736,07173,Péreyres,50,50,0
84,07,210701744,07174,Peyraud,502,494,8
84,07,210701751,07175,Le Plagnal,79,77,2
84,07,210701769,07176,Planzolles,160,158,2
84,07,210701777,07177,Plats,862,843,19
84,07,210701785,07178,Pont-de-Labeaume,590,583,7
84,07,210701793,07179,Pourchères,136,135,1
84,07,210701819,07181,Le Pouzin,2916,2883,33
84,07,210701827,07182,Prades,1211,1180,31
84,07,210701835,07183,Pradons,504,496,8
84,07,210701843,07184,Pranles,521,510,11
84,07,210701850,07185,Préaux,718,709,9
84,07,210701868,07186,Privas,8826,8567,259
84,07,210701876,07187,Prunet,138,136,2
84,07,210701884,07188,Quintenas,1738,1707,31
84,07,210701892,07189,Ribes,332,325,7
84,07,210701900,07190,Rochecolombe,225,218,7
84,07,210701918,07191,Rochemaure,2336,2278,58
84,07,210701926,07192,Rochepaule,247,240,7
84,07,210701934,07193,Rocher,279,275,4
84,07,210701942,07194,Rochessauve,470,461,9
84,07,210701959,07195,La Rochette,65,63,2
84,07,210701967,07196,Rocles,261,257,4
84,07,210701975,07197,Roiffieux,2808,2724,84
84,07,210701983,07198,Rompon,1157,1131,26
84,07,210701991,07199,Rosières,1306,1280,26
84,07,210702007,07200,Le Roux,62,61,1
84,07,210702015,07201,Ruoms,2303,2281,22
84,07,210702023,07202,Sablières,178,174,4
84,07,210702031,07203,Sagnes-et-Goudoulet,119,116,3
84,07,210702049,07204,Saint-Agrève,2409,2350,59
84,07,210702056,07205,Saint-Alban-d'Ay,1442,1420,22
84,07,210702064,07206,Saint-Alban-en-Montagne,71,69,2
84,07,210702072,07207,Saint-Alban-Auriolles,1099,1083,16
84,07,210702080,07208,Saint-Andéol-de-Berg,124,121,3
84,07,210702098,07209,Saint-Andéol-de-Fourchades,57,55,2
84,07,210702106,07210,Saint-Andéol-de-Vals,527,516,11
84,07,210702114,07211,Saint-André-de-Cruzières,476,462,14
84,07,210702122,07212,Saint-André-en-Vivarais,211,210,1
84,07,210702130,07213,Saint-André-Lachamp,157,153,4
84,07,210702148,07214,Saint-Apollinaire-de-Rias,208,206,2
84,07,210702155,07215,Saint-Barthélemy-le-Meil,206,201,5
84,07,210702163,07216,Saint-Barthélemy-Grozon,518,497,21
84,07,210702171,07217,Saint-Barthélemy-le-Plain,854,842,12
84,07,210702189,07218,Saint-Basile,349,340,9
84,07,210702197,07219,Saint-Bauzile,331,326,5
84,07,210702205,07220,Saint-Christol,105,105,0
84,07,210702213,07221,Saint-Cierge-la-Serre,257,248,9
84,07,210702221,07222,Saint-Cierge-sous-le-Cheylard,216,211,5
84,07,210702239,07223,Saint-Cirgues-de-Prades,141,139,2
84,07,210702247,07224,Saint-Cirgues-en-Montagne,235,222,13
84,07,210702254,07225,Saint-Clair,1272,1225,47
84,07,210702262,07226,Saint-Clément,90,90,0
84,07,210702270,07227,Saint-Cyr,1451,1404,47
84,07,210702288,07228,Saint-Désirat,870,849,21
84,07,210702296,07229,Saint-Didier-sous-Aubenas,955,930,25
84,07,210702304,07230,Saint-Étienne-de-Boulogne,428,414,14
84,07,210702312,07231,Saint-Étienne-de-Fontbellon,2963,2880,83
84,07,210702320,07232,Saint-Étienne-de-Lugdarès,418,408,10
84,07,210702338,07233,Saint-Étienne-de-Serre,211,207,4
84,07,210702346,07234,Saint-Étienne-de-Valoux,299,296,3
84,07,210702353,07235,Sainte-Eulalie,216,213,3
84,07,210702361,07236,Saint-Félicien,1145,1125,20
84,07,210702379,07237,Saint-Fortunat-sur-Eyrieux,797,784,13
84,07,210702387,07238,Saint-Genest-de-Beauzon,344,337,7
84,07,210702395,07239,Saint-Genest-Lachamp,115,113,2
84,07,210702403,07240,Saint-Georges-les-Bains,2459,2408,51
84,07,210702411,07241,Saint-Germain,727,710,17
84,07,210702429,07242,Saint-Gineys-en-Coiron,118,114,4
84,07,210702437,07243,Saint-Jacques-d'Atticieux,295,290,5
84,07,210702445,07244,Saint-Jean-Chambre,258,254,4
84,07,210702452,07245,Saint-Jean-de-Muzols,2577,2507,70
84,07,210702478,07247,Saint-Jean-le-Centenier,866,856,10
84,07,210702486,07248,Saint-Jean-Roure,253,242,11
84,07,210702494,07249,Saint-Jeure-d'Andaure,95,93,2
84,07,210702502,07250,Saint-Jeure-d'Ay,502,493,9
84,07,210702510,07251,Saint-Joseph-des-Bancs,177,174,3
84,07,210702536,07253,Saint-Julien-du-Gua,172,169,3
84,07,210702544,07254,Saint-Julien-du-Serre,885,865,20
84,07,210702551,07255,Saint-Julien-en-Saint-Alban,1471,1434,37
84,07,210702577,07257,Saint-Julien-le-Roux,120,118,2
84,07,210702585,07258,Saint-Julien-Vocance,226,223,3
84,07,210702593,07259,Saint-Just-d'Ardèche,1718,1681,37
84,07,210702601,07260,Saint-Lager-Bressac,973,953,20
84,07,210702619,07261,Saint-Laurent-du-Pape,1633,1600,33
84,07,200085140,07262,Saint-Laurent-les-Bains-Laval-d'Aurelle,179,176,3
84,07,210702635,07263,Saint-Laurent-sous-Coiron,119,116,3
84,07,210702643,07264,Saint-Marcel-d'Ardèche,2448,2379,69
84,07,210702650,07265,Saint-Marcel-lès-Annonay,1418,1383,35
84,07,210702668,07266,Sainte-Marguerite-Lafigère,115,113,2
84,07,210702676,07267,Saint-Martial,272,268,4
84,07,210702684,07268,Saint-Martin-d'Ardèche,959,947,12
84,07,210702692,07269,Saint-Martin-de-Valamas,1131,1092,39
84,07,210702700,07270,Saint-Martin-sur-Lavezon,445,433,12
84,07,210702726,07272,Saint-Maurice-d'Ardèche,342,332,10
84,07,210702734,07273,Saint-Maurice-d'Ibie,217,216,1
84,07,210702742,07274,Saint-Maurice-en-Chalencon,205,200,5
84,07,210702759,07275,Saint-Mélany,103,100,3
84,07,210702767,07276,Saint-Michel-d'Aurance,285,265,20
84,07,210702775,07277,Saint-Michel-de-Boulogne,153,148,5
84,07,210702783,07278,Saint-Michel-de-Chabrillanoux,413,404,9
84,07,210702791,07279,Saint-Montan,1970,1926,44
84,07,210702809,07280,Saint-Paul-le-Jeune,984,965,19
84,07,210702817,07281,Saint-Péray,7754,7538,216
84,07,210702825,07282,Saint-Pierre-de-Colombier,468,440,28
84,07,210702833,07283,Saint-Pierre-la-Roche,64,62,2
84,07,210702841,07284,Saint-Pierre-Saint-Jean,185,181,4
84,07,210702858,07285,Saint-Pierre-sur-Doux,113,112,1
84,07,210702866,07286,Saint-Pierreville,519,517,2
84,07,210702874,07287,Saint-Pons,307,294,13
84,07,210702882,07288,Saint-Priest,1365,1320,45
84,07,210702890,07289,Saint-Privat,1721,1664,57
84,07,210702908,07290,Saint-Prix,277,270,7
84,07,210702916,07291,Saint-Remèze,877,854,23
84,07,210702924,07292,Saint-Romain-d'Ay,1251,1221,30
84,07,210702932,07293,Saint-Romain-de-Lerps,931,913,18
84,07,210702940,07294,Saint-Sauveur-de-Cruzières,556,544,12
84,07,210702957,07295,Saint-Sauveur-de-Montagut,1127,1103,24
84,07,210702965,07296,Saint-Sernin,1823,1772,51
84,07,210702973,07297,Saint-Sylvestre,516,509,7
84,07,210702981,07298,Saint-Symphorien-sous-Chomérac,819,787,32
84,07,210702999,07299,Saint-Symphorien-de-Mahun,123,119,4
84,07,210703005,07300,Saint-Thomé,481,465,16
84,07,210703013,07301,Saint-Victor,960,946,14
84,07,210703021,07302,Saint-Vincent-de-Barrès,855,833,22
84,07,210703039,07303,Saint-Vincent-de-Durfort,272,269,3
84,07,210703047,07304,Salavas,724,711,13
84,07,210703054,07305,Les Salelles,396,383,13
84,07,210703062,07306,Sampzon,247,240,7
84,07,210703070,07307,Sanilhac,457,448,9
84,07,210703088,07308,Sarras,2277,2242,35
84,07,210703096,07309,Satillieu,1529,1501,28
84,07,210703104,07310,Savas,921,897,24
84,07,210703112,07311,Sceautres,158,151,7
84,07,210703120,07312,Sécheras,540,524,16
84,07,210703138,07313,Serrières,1134,1117,17
84,07,210703146,07314,Silhac,394,382,12
84,07,210703153,07315,La Souche,384,376,8
84,07,210703161,07316,Soyons,2350,2299,51
84,07,210703179,07317,Talencieux,1140,1111,29
84,07,210703187,07318,Tauriers,205,200,5
84,07,210703195,07319,Le Teil,9051,8841,210
84,07,210703211,07321,Thorrenc,262,255,7
84,07,210703229,07322,Thueyts,1225,1213,12
84,07,210703237,07323,Toulaud,1779,1727,52
84,07,210703245,07324,Tournon-sur-Rhône,11421,10835,586
84,07,210703252,07325,Ucel,2128,2056,72
84,07,210703260,07326,Usclades-et-Rieutord,117,117,0
84,07,210703278,07327,Uzer,429,415,14
84,07,210703286,07328,Vagnas,620,603,17
84,07,210703294,07329,Valgorge,428,420,8
84,07,210703302,07330,Vallon-Pont-d'Arc,2474,2435,39
84,07,210703310,07331,Vals-les-Bains,3561,3495,66
84,07,210703328,07332,Valvignères,451,439,12
84,07,210703336,07333,Vanosc,964,952,12
84,07,210703344,07334,Les Vans,2710,2653,57
84,07,210703351,07335,Vaudevant,211,209,2
84,07,210703369,07336,Vernon,230,223,7
84,07,210703377,07337,Vernosc-lès-Annonay,2677,2594,83
84,07,210703385,07338,Vernoux-en-Vivarais,2003,1970,33
84,07,210703393,07339,Vesseaux,2085,2020,65
84,07,210703401,07340,Veyras,1558,1510,48
84,07,210703419,07341,Villeneuve-de-Berg,3135,3028,107
84,07,210703427,07342,Villevocance,1209,1183,26
84,07,210703435,07343,Vinezac,1450,1410,40
84,07,210703443,07344,Vinzieux,486,483,3
84,07,210703450,07345,Vion,963,944,19
84,07,210703468,07346,Viviers,3731,3667,64
84,07,210703476,07347,Vocance,634,623,11
84,07,210703484,07348,Vogüé,1096,1081,15
84,07,210703492,07349,La Voulte-sur-Rhône,4885,4828,57
44,08,210800017,08001,Acy-Romance,472,469,3
44,08,210800025,08003,Aiglemont,1678,1642,36
44,08,210800033,08004,Aire,245,244,1
44,08,210800041,08005,Alincourt,161,159,2
44,08,210800058,08006,Alland'Huy-et-Sausseuil,257,252,5
44,08,210800074,08008,Amagne,733,728,5
44,08,210800090,08010,Ambly-Fleury,137,133,4
44,08,210800108,08011,Anchamps,216,212,4
44,08,210800116,08013,Angecourt,393,388,5
44,08,210800124,08014,Annelles,149,143,6
44,08,210800132,08015,Antheny,105,100,5
44,08,210800140,08016,Aouste,209,207,2
44,08,210800157,08017,Apremont,121,118,3
44,08,210800165,08018,Ardeuil-et-Montfauxelles,78,76,2
44,08,210800173,08019,Les Grandes-Armoises,63,59,4
44,08,210800181,08020,Les Petites-Armoises,60,60,0
44,08,210800199,08021,Arnicourt,157,153,4
44,08,210800207,08022,Arreux,329,317,12
44,08,210800215,08023,Artaise-le-Vivier,66,65,1
44,08,210800223,08024,Asfeld,1097,1079,18
44,08,210800231,08025,Attigny,1133,1112,21
44,08,210800249,08026,Aubigny-les-Pothées,315,307,8
44,08,210800256,08027,Auboncourt-Vauzelles,98,97,1
44,08,210800264,08028,Aubrives,1002,982,20
44,08,210800272,08029,Auflance,87,85,2
44,08,210800280,08030,Auge,58,58,0
44,08,210800298,08031,Aure,44,41,3
44,08,210800306,08032,Aussonce,223,220,3
44,08,210800314,08033,Authe,93,91,2
44,08,210800322,08034,Autrecourt-et-Pourron,343,337,6
44,08,210800330,08035,Autruche,58,54,4
44,08,210800348,08036,Autry,114,108,6
44,08,210800355,08037,Auvillers-les-Forges,901,891,10
44,08,210800363,08038,Avançon,348,340,8
44,08,210800371,08039,Avaux,485,480,5
44,08,210800389,08040,Les Ayvelles,901,881,20
44,08,210800397,08041,Baâlons,212,204,8
44,08,210800413,08043,Balan,1661,1629,32
44,08,210800421,08044,Balham,170,169,1
44,08,210800439,08045,Ballay,269,257,12
44,08,210800447,08046,Banogne-Recouvrance,163,160,3
44,08,210804647,08047,Barbaise,108,108,0
44,08,210800454,08048,Barby,414,407,7
44,08,210800462,08049,Bar-lès-Buzancy,131,129,2
44,08,210800470,08052,Bayonville,75,73,2
44,08,200062826,08053,Bazeilles,2587,2405,182
44,08,210800496,08055,Beaumont-en-Argonne,431,424,7
44,08,210800504,08056,Beffu-et-le-Morthomme,44,44,0
44,08,210800512,08057,Belleville-et-Châtillon-sur-Bar,267,244,23
44,08,210800520,08058,Belval,227,221,6
44,08,210800538,08059,Belval-Bois-des-Dames,29,28,1
44,08,210800546,08060,Bergnicourt,299,298,1
44,08,210800553,08061,La Berlière,39,37,2
44,08,210800561,08062,Bertoncourt,131,126,5
44,08,210800579,08063,La Besace,134,133,1
44,08,210800587,08064,Biermes,314,310,4
44,08,210800595,08065,Bièvres,47,46,1
44,08,210800603,08066,Bignicourt,68,67,1
44,08,210800611,08067,Blagny,1127,1110,17
44,08,210800629,08069,Blanchefosse-et-Bay,144,142,2
44,08,210800637,08070,Blanzy-la-Salonnaise,382,376,6
44,08,210800645,08071,Blombay,137,135,2
44,08,210800678,08073,Bossus-lès-Rumigny,95,93,2
44,08,210800686,08074,Bouconville,59,57,2
44,08,210800694,08075,Boult-aux-Bois,141,138,3
44,08,210800702,08076,Boulzicourt,991,971,20
44,08,210800710,08077,Bourcq,53,52,1
44,08,210800728,08078,Bourg-Fidèle,855,845,10
44,08,210800744,08080,Bouvellemont,126,125,1
44,08,210800652,08081,Bogny-sur-Meuse,5082,5011,71
44,08,210800751,08082,Brécy-Brières,83,79,4
44,08,210800769,08083,Brévilly,365,359,6
44,08,210800777,08084,Brienne-sur-Aisne,276,274,2
44,08,210800785,08085,Brieulles-sur-Bar,230,225,5
44,08,210800793,08086,Briquenay,98,90,8
44,08,210800801,08087,Brognon,143,141,2
44,08,210800819,08088,Bulson,137,133,4
44,08,210800827,08089,Buzancy,380,372,8
44,08,210800835,08090,Carignan,2919,2875,44
44,08,210800843,08092,Cauroy,197,189,8
44,08,210800850,08094,Cernion,56,56,0
44,08,210800868,08095,Chagny,184,179,5
44,08,210800876,08096,Chalandry-Elaire,730,715,15
44,08,210800884,08097,Challerange,444,437,7
44,08,210800892,08098,Champigneulle,56,54,2
44,08,210800900,08099,Champigneul-sur-Vence,126,122,4
44,08,210800918,08100,Champlin,73,73,0
44,08,210800926,08101,La Chapelle,169,165,4
44,08,210800934,08102,Chappes,92,87,5
44,08,210800942,08103,Charbogne,225,221,4
44,08,210800959,08104,Chardeny,61,61,0
44,08,210800967,08105,Charleville-Mézières,47433,46388,1045
44,08,210800975,08106,Charnois,71,71,0
44,08,210800983,08107,Château-Porcien,1339,1323,16
44,08,210800991,08109,Chatel-Chéhéry,141,138,3
44,08,210801007,08110,Le Châtelet-sur-Sormonne,169,168,1
44,08,210801015,08111,Le Châtelet-sur-Retourne,778,776,2
44,08,210801023,08113,Chaumont-Porcien,516,506,10
44,08,200060366,08115,Chémery-Chéhéry,532,528,4
44,08,200056745,08116,Bairon et ses environs,1044,1026,18
44,08,210801064,08117,Chesnois-Auboncourt,160,160,0
44,08,210801072,08119,Cheveuges,463,456,7
44,08,210801080,08120,Chevières,47,45,2
44,08,210801098,08121,Chilly,140,135,5
44,08,210801106,08122,Chooz,771,756,15
44,08,210801114,08123,Chuffilly-Roche,71,70,1
44,08,210801122,08124,Clavy-Warby,353,344,9
44,08,210801130,08125,Cliron,416,407,9
44,08,210801148,08126,Condé-lès-Herpy,226,222,4
44,08,210801155,08128,Condé-lès-Autry,66,63,3
44,08,210801163,08130,Contreuve,84,83,1
44,08,210801171,08131,Cornay,68,65,3
44,08,210801189,08132,Corny-Machéroménil,195,193,2
44,08,210801197,08133,Coucy,523,518,5
44,08,210801205,08134,Coulommes-et-Marqueny,75,75,0
44,08,210801213,08135,La Croix-aux-Bois,156,153,3
44,08,210801221,08136,Daigny,356,347,9
44,08,210801239,08137,Damouzy,459,448,11
44,08,210801247,08138,Les Deux-Villes,261,253,8
44,08,210801254,08139,Deville,1051,1042,9
44,08,210801262,08140,Dom-le-Mesnil,1084,1064,20
44,08,210801270,08141,Dommery,188,183,5
44,08,210801288,08142,Donchery,2035,2008,27
44,08,210801296,08143,Doumely-Bégny,73,73,0
44,08,210801304,08144,Doux,104,103,1
44,08,200053437,08145,Douzy,2221,2182,39
44,08,210801320,08146,Draize,93,91,2
44,08,210801338,08147,Dricourt,88,80,8
44,08,210801346,08148,L'Écaille,276,272,4
44,08,210801353,08149,L'Échelle,147,142,5
44,08,210801361,08150,Écly,174,169,5
44,08,210801379,08151,Écordal,308,297,11
44,08,210801395,08153,Escombres-et-le-Chesnois,348,344,4
44,08,210801403,08154,Estrebay,85,82,3
44,08,210801411,08155,Étalle,100,99,1
44,08,210801429,08156,Éteignières,502,495,7
44,08,210801437,08158,Étrépigny,295,290,5
44,08,210801445,08159,Euilly-et-Lombut,113,110,3
44,08,210801452,08160,Évigny,193,189,4
44,08,210801460,08161,Exermont,37,36,1
44,08,210801478,08162,Fagnon,350,344,6
44,08,210801486,08163,Faissault,263,260,3
44,08,210801494,08164,Falaise,347,340,7
44,08,210801502,08165,Faux,62,59,3
44,08,210801510,08166,Fépin,267,258,9
44,08,210801528,08167,La Férée,75,73,2
44,08,210801536,08168,La Ferté-sur-Chiers,179,175,4
44,08,210801544,08169,Flaignes-Havys,103,96,7
44,08,210801551,08170,Fleigneux,225,222,3
44,08,210801569,08171,Fléville,98,94,4
44,08,210801577,08172,Fligny,178,177,1
44,08,200085983,08173,Flize,1755,1708,47
44,08,210801593,08174,Floing,2347,2293,54
44,08,210801601,08175,Foisches,250,242,8
44,08,210801619,08176,Fossé,57,56,1
44,08,210801627,08178,Fraillicourt,189,184,5
44,08,210801635,08179,Francheval,602,589,13
44,08,210801643,08180,La Francheville,1704,1664,40
44,08,210801650,08182,Le Fréty,58,57,1
44,08,210801668,08183,Fromelennes,1070,1046,24
44,08,210801676,08184,Fromy,86,84,2
44,08,210801684,08185,Fumay,3228,3181,47
44,08,210801692,08186,Germont,49,49,0
44,08,210801700,08187,Gernelle,320,312,8
44,08,210801718,08188,Gespunsart,1012,995,17
44,08,210801726,08189,Girondelle,167,165,2
44,08,210801734,08190,Givet,6487,6343,144
44,08,210801742,08191,Givonne,1083,1056,27
44,08,210801759,08192,Givron,89,89,0
44,08,210801767,08193,Givry,277,271,6
44,08,210801775,08194,Glaire,844,832,12
44,08,210801783,08195,Gomont,327,324,3
44,08,210801791,08196,Grandchamp,102,99,3
44,08,210801809,08197,Grandham,40,37,3
44,08,200055572,08198,Grandpré,531,514,17
44,08,210801825,08199,La Grandville,807,790,17
44,08,210801833,08200,Grivy-Loisy,188,184,4
44,08,210801841,08201,Gruyères,105,103,2
44,08,210801858,08202,Gué-d'Hossus,523,513,10
44,08,210801866,08203,Guignicourt-sur-Vence,280,274,6
44,08,210801874,08204,Guincourt,79,78,1
44,08,210801882,08205,Hagnicourt,70,70,0
44,08,210801890,08206,Ham-les-Moines,377,367,10
44,08,210801908,08207,Ham-sur-Meuse,232,228,4
44,08,210801916,08208,Hannappes,135,134,1
44,08,210801924,08209,Hannogne-Saint-Martin,471,463,8
44,08,210801932,08210,Hannogne-Saint-Rémy,117,113,4
44,08,210801940,08211,Haraucourt,724,720,4
44,08,210801957,08212,Harcy,514,504,10
44,08,210801965,08214,Hargnies,492,489,3
44,08,210801973,08215,Harricourt,46,44,2
44,08,210801981,08216,Haudrecy,327,314,13
44,08,210801999,08217,Haulmé,87,87,0
44,08,210802005,08218,Les Hautes-Rivières,1406,1382,24
44,08,210802013,08219,Hauteville,119,118,1
44,08,210802021,08220,Hauviné,346,338,8
44,08,210802047,08222,Haybes,1874,1829,45
44,08,210802054,08223,Herbeuval,125,123,2
44,08,210802062,08225,Herpy-l'Arlésienne,213,207,6
44,08,210802070,08226,Hierges,171,167,4
44,08,210802088,08228,La Horgne,166,161,5
44,08,210802096,08229,Houdilcourt,137,130,7
44,08,210802104,08230,Houldizy,398,392,6
44,08,210802112,08232,Illy,422,413,9
44,08,210804613,08233,Imécourt,46,45,1
44,08,210802120,08234,Inaumont,115,115,0
44,08,210802138,08235,Issancourt-et-Rumel,386,382,4
44,08,210802146,08236,Jandun,311,301,10
44,08,210802153,08237,Joigny-sur-Meuse,661,643,18
44,08,210802161,08238,Jonval,101,98,3
44,08,210802179,08239,Juniville,1275,1247,28
44,08,210802187,08240,Justine-Herbigny,173,169,4
44,08,210802195,08242,Laifour,430,423,7
44,08,210802203,08243,Lalobbe,167,164,3
44,08,210802211,08244,Lametz,76,73,3
44,08,210802229,08245,Lançon,33,31,2
44,08,210802237,08246,Landres-et-Saint-Georges,74,72,2
44,08,210802245,08247,Landrichamps,137,135,2
44,08,210802252,08248,Launois-sur-Vence,693,685,8
44,08,210802260,08249,Laval-Morency,247,237,10
44,08,210802278,08250,Leffincourt,188,187,1
44,08,210802286,08251,Lépron-les-Vallées,75,73,2
44,08,210802294,08252,Létanne,115,113,2
44,08,210802302,08254,Liart,628,618,10
44,08,210802310,08255,Linay,225,222,3
44,08,210802328,08256,Liry,87,84,3
44,08,210802336,08257,Logny-Bogny,157,154,3
44,08,210802344,08259,Longwé,73,71,2
44,08,210802351,08260,Lonny,627,619,8
44,08,210802377,08262,Lucquy,605,571,34
44,08,210802385,08263,Lumes,1140,1114,26
44,08,210802393,08264,Machault,527,513,14
44,08,210802419,08268,Maisoncelle-et-Villers,73,69,4
44,08,210802427,08269,Malandry,79,78,1
44,08,210802435,08271,Manre,103,102,1
44,08,210802443,08272,Maranwez,56,56,0
44,08,210802450,08273,Marby,74,73,1
44,08,210802468,08274,Marcq,100,96,4
44,08,210802476,08275,Margny,217,213,4
44,08,210802484,08276,Margut,738,725,13
44,08,210802492,08277,Marlemont,133,129,4
44,08,210802500,08278,Marquigny,80,80,0
44,08,210802518,08279,Mars-sous-Bourcq,64,62,2
44,08,210802526,08280,Marvaux-Vieux,75,73,2
44,08,210802534,08281,Matton-et-Clémency,479,469,10
44,08,210802542,08282,Maubert-Fontaine,1103,1031,72
44,08,210802559,08283,Mazerny,128,127,1
44,08,210802567,08284,Les Mazures,901,878,23
44,08,210802575,08286,Ménil-Annelles,121,116,5
44,08,210802583,08287,Ménil-Lépinois,140,137,3
44,08,210802591,08288,Mesmont,91,90,1
44,08,210802609,08289,Messincourt,614,605,9
44,08,210802617,08291,Mogues,245,240,5
44,08,210802625,08293,Moiry,145,140,5
44,08,210802633,08294,La Moncelle,134,132,2
44,08,210802641,08295,Mondigny,191,187,4
44,08,210802658,08296,Montcheutin,120,113,7
44,08,210804639,08297,Montcornet,308,300,8
44,08,210802666,08298,Montcy-Notre-Dame,1636,1589,47
44,08,210802674,08300,Le Mont-Dieu,15,14,1
44,08,210802682,08301,Montgon,72,69,3
44,08,210802690,08302,Monthermé,2268,2191,77
44,08,210802708,08303,Monthois,396,388,8
44,08,210802716,08304,Montigny-sur-Meuse,82,80,2
44,08,210802724,08305,Montigny-sur-Vence,246,244,2
44,08,210802732,08306,Mont-Laurent,56,53,3
44,08,210802740,08307,Montmeillant,84,83,1
44,08,210802757,08308,Mont-Saint-Martin,89,89,0
44,08,210802765,08309,Mont-Saint-Remy,59,58,1
44,08,210802773,08310,Mouron,77,70,7
44,08,200058543,08311,Mouzon,2266,2227,39
44,08,210802799,08312,Murtin-et-Bogny,197,190,7
44,08,210802807,08313,Nanteuil-sur-Aisne,148,146,2
44,08,210802815,08314,Neuflize,868,843,25
44,08,210802823,08315,Neufmaison,77,75,2
44,08,210802831,08316,Neufmanil,1007,993,14
44,08,210802849,08317,La Neuville-à-Maire,114,110,4
44,08,210802856,08318,La Neuville-aux-Joûtes,357,355,2
44,08,210802864,08319,Neuville-lez-Beaulieu,344,336,8
44,08,210802872,08320,La Neuville-en-Tourne-à-Fuy,559,543,16
44,08,210802880,08321,Neuville-Day,177,173,4
44,08,210802898,08322,Neuville-lès-This,372,359,13
44,08,210802906,08323,La Neuville-lès-Wasigny,160,160,0
44,08,210802914,08324,Neuvizy,116,114,2
44,08,210802922,08325,Noirval,27,25,2
44,08,210802930,08326,Nouart,119,117,2
44,08,210802948,08327,Nouvion-sur-Meuse,2277,2241,36
44,08,210802955,08328,Nouzonville,5702,5635,67
44,08,210802963,08329,Novion-Porcien,512,502,10
44,08,210802971,08330,Novy-Chevrières,800,792,8
44,08,210802989,08331,Noyers-Pont-Maugis,679,665,14
44,08,210802997,08332,Oches,45,41,4
44,08,210803003,08333,Olizy-Primat,243,235,8
44,08,210803011,08334,Omicourt,43,40,3
44,08,210803029,08335,Omont,80,79,1
44,08,210803037,08336,Osnes,232,229,3
44,08,210803045,08338,Pauvres,198,195,3
44,08,210803052,08339,Perthes,310,306,4
44,08,210803060,08340,Poilcourt-Sydney,178,174,4
44,08,210803078,08341,Poix-Terron,910,870,40
44,08,210803086,08342,Pouru-aux-Bois,244,239,5
44,08,210803094,08343,Pouru-Saint-Remy,1166,1144,22
44,08,210803102,08344,Prez,134,132,2
44,08,210803110,08346,Prix-lès-Mézières,1389,1355,34
44,08,210803128,08347,Puilly-et-Charbeaux,222,217,5
44,08,210803136,08348,Puiseux,115,112,3
44,08,210803144,08349,Pure,569,562,7
44,08,210803151,08350,Quatre-Champs,241,238,3
44,08,210803169,08351,Quilly,80,78,2
44,08,210803177,08352,Raillicourt,210,208,2
44,08,210803185,08353,Rancennes,739,720,19
44,08,210803193,08354,Raucourt-et-Flaba,835,821,14
44,08,210803201,08355,Regniowez,394,387,7
44,08,210803219,08356,Remaucourt,179,178,1
44,08,210803227,08357,Remilly-Aillicourt,800,779,21
44,08,210803235,08358,Remilly-les-Pothées,258,255,3
44,08,210803243,08360,Renneville,203,198,5
44,08,210803250,08361,Renwez,1693,1636,57
44,08,210803268,08362,Rethel,7739,7445,294
44,08,210803276,08363,Revin,5947,5825,122
44,08,210803284,08364,Rilly-sur-Aisne,128,128,0
44,08,210803292,08365,Rimogne,1350,1330,20
44,08,210803300,08366,Rocquigny,678,672,6
44,08,210803318,08367,Rocroi,2295,2266,29
44,08,210803326,08368,Roizy,224,221,3
44,08,210803334,08369,La Romagne,134,131,3
44,08,210803342,08370,Rouvroy-sur-Audry,577,571,6
44,08,210803367,08372,Rubigny,66,66,0
44,08,210803375,08373,Rumigny,288,284,4
44,08,210803383,08374,La Sabotterie,125,125,0
44,08,210803391,08375,Sachy,182,178,4
44,08,210803409,08376,Sailly,255,250,5
44,08,210804621,08377,Saint-Aignan,156,154,2
44,08,210803417,08378,Saint-Clément-à-Arnes,108,108,0
44,08,210803425,08379,Saint-Étienne-à-Arnes,253,243,10
44,08,210803433,08380,Saint-Fergeux,220,216,4
44,08,210803441,08381,Saint-Germainmont,830,818,12
44,08,210803458,08382,Saint-Jean-aux-Bois,99,96,3
44,08,210803466,08383,Saint-Juvin,105,101,4
44,08,210803474,08384,Saint-Lambert-et-Mont-de-Jeux,146,143,3
44,08,210803482,08385,Saint-Laurent,1236,1066,170
44,08,210803490,08386,Saint-Loup-en-Champagne,346,343,3
44,08,210803508,08387,Saint-Loup-Terrier,188,182,6
44,08,210803516,08388,Saint-Marceau,355,344,11
44,08,210803524,08389,Saint-Marcel,334,327,7
44,08,210803532,08390,Sainte-Marie,82,79,3
44,08,210803540,08391,Saint-Menges,956,941,15
44,08,210803557,08392,Saint-Morel,201,190,11
44,08,210803565,08393,Saint-Pierre-à-Arnes,66,66,0
44,08,210803573,08394,Saint-Pierremont,75,72,3
44,08,210803581,08395,Saint-Pierre-sur-Vence,148,144,4
44,08,210803599,08396,Saint-Quentin-le-Petit,122,122,0
44,08,210803607,08397,Saint-Remy-le-Petit,54,54,0
44,08,210803615,08398,Sainte-Vaubourg,93,91,2
44,08,210803623,08399,Sapogne-sur-Marche,141,138,3
44,08,210803631,08400,Sapogne-et-Feuchères,527,515,12
44,08,210803649,08401,Saulces-Champenoises,228,225,3
44,08,210803656,08402,Saulces-Monclin,852,835,17
44,08,210803664,08403,Sault-lès-Rethel,1943,1928,15
44,08,210803672,08404,Sault-Saint-Remy,219,214,5
44,08,210803680,08405,Sauville,244,235,9
44,08,210803698,08406,Savigny-sur-Aisne,386,373,13
44,08,210803706,08407,Séchault,59,59,0
44,08,210803714,08408,Sécheval,571,561,10
44,08,210803722,08409,Sedan,16730,16376,354
44,08,210803730,08410,Semide,194,177,17
44,08,210803748,08411,Semuy,88,88,0
44,08,210803755,08412,Senuc,159,156,3
44,08,210803763,08413,Seraincourt,260,257,3
44,08,210803771,08415,Sery,342,329,13
44,08,210803789,08416,Seuil,179,173,6
44,08,210803797,08417,Sévigny-la-Forêt,289,281,8
44,08,210803805,08418,Sévigny-Waleppe,226,223,3
44,08,210803813,08419,Signy-l'Abbaye,1369,1351,18
44,08,210803821,08420,Signy-le-Petit,1207,1186,21
44,08,210803839,08421,Signy-Montlibert,95,94,1
44,08,210803847,08422,Singly,139,135,4
44,08,210803854,08424,Sommauthe,131,128,3
44,08,210803862,08425,Sommerance,46,46,0
44,08,210803870,08426,Son,98,95,3
44,08,210803888,08427,Sorbon,212,211,1
44,08,210803896,08428,Sorcy-Bauthémont,146,144,2
44,08,210803904,08429,Sormonne,543,529,14
44,08,210803912,08430,Stonne,41,39,2
44,08,210803920,08431,Sugny,107,100,7
44,08,210803938,08432,Sury,108,105,3
44,08,210803946,08433,Suzanne,61,59,2
44,08,210803953,08434,Sy,54,52,2
44,08,210803961,08435,Tagnon,887,873,14
44,08,210803979,08436,Taillette,409,402,7
44,08,210803987,08437,Tailly,180,174,6
44,08,210803995,08438,Taizy,107,105,2
44,08,210804001,08439,Tannay,157,147,10
44,08,210804019,08440,Tarzy,131,129,2
44,08,210804027,08444,Tétaigne,132,128,4
44,08,210804050,08445,Thelonne,420,414,6
44,08,210804068,08446,Thénorgues,83,81,2
44,08,210804076,08448,Thilay,1043,1032,11
44,08,210804084,08449,Thin-le-Moutier,662,648,14
44,08,210804092,08450,This,233,224,9
44,08,210804100,08451,Le Thour,383,375,8
44,08,210804118,08452,Thugny-Trugny,272,265,7
44,08,210804126,08453,Toges,107,104,3
44,08,210804134,08454,Touligny,84,84,0
44,08,210804142,08455,Tourcelles-Chaumont,92,91,1
44,08,210804159,08456,Tournavaux,232,228,4
44,08,210804167,08457,Tournes,1091,1063,28
44,08,210804175,08458,Tourteron,185,180,5
44,08,210804183,08459,Tremblois-lès-Carignan,143,140,3
44,08,210804191,08460,Tremblois-lès-Rocroi,152,152,0
44,08,210804209,08461,Vandy,205,204,1
44,08,210804217,08462,Vaux-Champagne,132,128,4
44,08,210804225,08463,Vaux-en-Dieulet,56,55,1
44,08,210804233,08464,Vaux-lès-Mouron,79,79,0
44,08,210804241,08465,Vaux-lès-Rubigny,46,43,3
44,08,210804258,08466,Vaux-lès-Mouzon,71,69,2
44,08,210804266,08467,Vaux-Montreuil,107,107,0
44,08,210804274,08468,Vaux-Villaine,194,194,0
44,08,210804282,08469,Vendresse,489,477,12
44,08,210804290,08470,Verpel,67,66,1
44,08,210804308,08471,Verrières,33,32,1
44,08,210804316,08472,Viel-Saint-Remy,299,297,2
44,08,210804324,08473,Vieux-lès-Asfeld,309,302,7
44,08,210804340,08476,Villers-devant-le-Thour,425,418,7
44,08,210804357,08477,Villers-devant-Mouzon,109,109,0
44,08,210804365,08478,Villers-le-Tilleul,241,238,3
44,08,210804373,08479,Villers-le-Tourneur,205,202,3
44,08,210804381,08480,Villers-Semeuse,3653,3588,65
44,08,210804399,08481,Villers-sur-Bar,258,253,5
44,08,210804407,08482,Villers-sur-le-Mont,106,103,3
44,08,210804415,08483,Ville-sur-Lumes,539,526,13
44,08,210804423,08484,Ville-sur-Retourne,79,79,0
44,08,210804431,08485,Villy,210,199,11
44,08,210804449,08486,Vireux-Molhain,1496,1465,31
44,08,210804456,08487,Vireux-Wallerand,1994,1940,54
44,08,210804464,08488,Vivier-au-Court,2984,2901,83
44,08,210804472,08489,Voncq,218,216,2
44,08,200062388,08490,Vouziers,4305,4169,136
44,08,200067577,08491,Vrigne aux Bois,3608,3556,52
44,08,210804506,08492,Vrigne-Meuse,337,329,8
44,08,210804522,08494,Wadelincourt,462,455,7
44,08,210804530,08496,Wagnon,125,124,1
44,08,210804548,08497,Warcq,1252,1227,25
44,08,210804555,08498,Warnécourt,396,381,15
44,08,210804563,08499,Wasigny,319,316,3
44,08,210804571,08500,Wignicourt,57,56,1
44,08,210804589,08501,Williers,43,41,2
44,08,210804597,08502,Yoncq,94,91,3
44,08,210804605,08503,Yvernaumont,122,121,1
76,09,210900015,09001,Aigues-Juntes,58,57,1
76,09,210900023,09002,Aigues-Vives,654,634,20
76,09,210900031,09003,L'Aiguillon,390,381,9
76,09,210900049,09004,Albiès,120,120,0
76,09,210900056,09005,Aleu,130,128,2
76,09,210900064,09006,Alliat,56,56,0
76,09,210900072,09007,Allières,73,73,0
76,09,210900080,09008,Alos,122,120,2
76,09,210900098,09009,Alzen,273,267,6
76,09,210900114,09011,Antras,75,74,1
76,09,210900122,09012,Appy,30,28,2
76,09,210900130,09013,Arabaux,82,81,1
76,09,210900148,09014,Argein,197,192,5
76,09,210900155,09015,Arignac,721,702,19
76,09,210900163,09016,Arnave,225,217,8
76,09,210900171,09017,Arrien-en-Bethmale,113,112,1
76,09,210900189,09018,Arrout,94,90,4
76,09,210900197,09019,Artigat,569,560,9
76,09,210900205,09020,Artigues,35,35,0
76,09,210900213,09021,Artix,121,118,3
76,09,210900221,09022,Arvigna,224,222,2
76,09,210900239,09023,Ascou,120,119,1
76,09,210900247,09024,Aston,208,203,5
76,09,210900254,09025,Aucazein,57,53,4
76,09,210900262,09026,Audressein,151,151,0
76,09,210900270,09027,Augirein,79,79,0
76,09,210900296,09029,Aulus-les-Bains,165,159,6
76,09,210900304,09030,Auzat,506,501,5
76,09,210900312,09031,Axiat,44,43,1
76,09,210900320,09032,Ax-les-Thermes,1350,1285,65
76,09,210900338,09033,Bagert,37,36,1
76,09,210900346,09034,Balacet,38,38,0
76,09,210900353,09035,Balaguères,201,198,3
76,09,210900379,09037,Barjac,42,42,0
76,09,210900387,09038,La Bastide-de-Besplas,386,381,5
76,09,210900395,09039,La Bastide-de-Bousignac,352,339,13
76,09,210900403,09040,La Bastide-de-Lordat,296,289,7
76,09,210900411,09041,La Bastide-du-Salat,212,205,7
76,09,210900429,09042,La Bastide-de-Sérou,1004,992,12
76,09,210900437,09043,La Bastide-sur-l'Hers,691,672,19
76,09,210900445,09044,Baulou,169,167,2
76,09,210900452,09045,Bédeilhac-et-Aynat,198,197,1
76,09,210900460,09046,Bédeille,70,66,4
76,09,210900478,09047,Bélesta,1090,1072,18
76,09,210900486,09048,Belloc,82,82,0
76,09,210900494,09049,Bénac,180,177,3
76,09,210900502,09050,Benagues,536,529,7
76,09,210900510,09051,Bénaix,155,151,4
76,09,210900528,09052,Besset,174,166,8
76,09,210900536,09053,Bestiac,22,19,3
76,09,210900544,09054,Betchat,359,354,5
76,09,210900551,09055,Bethmale,93,92,1
76,09,200099182,09056,Bézac,465,454,11
76,09,210900577,09057,Biert,320,315,5
76,09,210900585,09058,Bompas,198,193,5
76,09,210900593,09059,Bonac-Irazein,126,122,4
76,09,210900601,09060,Bonnac,771,761,10
76,09,210900619,09061,Les Bordes-sur-Arize,504,499,5
76,09,200064053,09062,Bordes-Uchentein,218,212,6
76,09,210900635,09063,Le Bosc,117,115,2
76,09,210900643,09064,Bouan,40,40,0
76,09,210900650,09065,Boussenac,226,223,3
76,09,210900668,09066,Brassac,632,622,10
76,09,210900676,09067,Brie,214,211,3
76,09,210900684,09068,Burret,44,44,0
76,09,210900692,09069,Buzan,25,25,0
76,09,210900700,09070,Les Cabannes,340,332,8
76,09,210900718,09071,Cadarcet,228,220,8
76,09,210900726,09072,Calzan,38,37,1
76,09,210900734,09073,Camarade,201,200,1
76,09,210900742,09074,Camon,150,149,1
76,09,210900759,09075,Campagne-sur-Arize,288,283,5
76,09,210900767,09076,Canté,209,202,7
76,09,210900775,09077,Capoulet-et-Junac,191,190,1
76,09,210900783,09078,Carcanières,73,73,0
76,09,210900791,09079,Carla-Bayle,811,797,14
76,09,210900809,09080,Carla-de-Roquefort,177,172,5
76,09,210900817,09081,Le Carlaret,286,275,11
76,09,210900825,09082,Castelnau-Durban,462,453,9
76,09,210900833,09083,Castéras,21,21,0
76,09,210900841,09084,Castex,98,97,1
76,09,210900858,09085,Castillon-en-Couserans,415,412,3
76,09,210900866,09086,Caumont,342,334,8
76,09,210900874,09087,Caussou,45,45,0
76,09,210900882,09088,Caychax,15,15,0
76,09,210900890,09089,Cazals-des-Baylès,58,56,2
76,09,210900908,09090,Cazaux,45,38,7
76,09,210900916,09091,Cazavet,203,200,3
76,09,210900924,09092,Cazenave-Serres-et-Allens,64,61,3
76,09,210900932,09093,Celles,152,151,1
76,09,210900940,09094,Cérizols,142,138,4
76,09,210900957,09095,Cescau,157,154,3
76,09,210900965,09096,Château-Verdun,44,41,3
76,09,210900973,09097,Clermont,116,116,0
76,09,210900981,09098,Contrazy,68,67,1
76,09,210900999,09099,Cos,393,379,14
76,09,210901005,09100,Couflens,96,95,1
76,09,210901013,09101,Coussa,290,287,3
76,09,210901021,09102,Coutens,181,174,7
76,09,210901039,09103,Crampagna,911,895,16
76,09,210901047,09104,Dalou,793,775,18
76,09,210901054,09105,Daumazan-sur-Arize,750,741,9
76,09,210901062,09106,Dreuilhe,375,359,16
76,09,210901070,09107,Dun,642,625,17
76,09,210901088,09108,Durban-sur-Arize,178,174,4
76,09,210901096,09109,Durfort,187,184,3
76,09,210901104,09110,Encourtiech,96,93,3
76,09,210901112,09111,Engomer,311,307,4
76,09,210901138,09113,Ercé,572,569,3
76,09,210901146,09114,Erp,134,132,2
76,09,210901153,09115,Esclagne,127,126,1
76,09,210901161,09116,Escosse,373,370,3
76,09,210901179,09117,Esplas,106,106,0
76,09,210901187,09118,Esplas-de-Sérou,181,179,2
76,09,210901195,09119,Eycheil,552,540,12
76,09,210901203,09120,Fabas,352,348,4
76,09,210901211,09121,Ferrières-sur-Ariège,849,749,100
76,09,210901229,09122,Foix,9841,9515,326
76,09,210901237,09123,Fornex,115,114,1
76,09,210901245,09124,Le Fossat,1053,1041,12
76,09,210901252,09125,Fougax-et-Barrineuf,435,429,6
76,09,210901260,09126,Freychenet,85,82,3
76,09,210901278,09127,Gabre,128,125,3
76,09,210901286,09128,Gajan,326,316,10
76,09,210901294,09129,Galey,117,114,3
76,09,210901302,09130,Ganac,739,730,9
76,09,210901310,09131,Garanou,147,147,0
76,09,210901328,09132,Gaudiès,248,245,3
76,09,210901336,09133,Génat,24,23,1
76,09,210901344,09134,Gestiès,34,33,1
76,09,210901369,09136,Gourbit,75,72,3
76,09,210901377,09137,Gudas,205,201,4
76,09,210901385,09138,L'Herm,222,194,28
76,09,210901393,09139,L'Hospitalet-près-l'Andorre,103,103,0
76,09,210901401,09140,Ignaux,128,122,6
76,09,210901419,09141,Illartein,73,73,0
76,09,210901427,09142,Ilhat,125,125,0
76,09,210901435,09143,Illier-et-Laramade,37,37,0
76,09,210901450,09145,Les Issards,257,247,10
76,09,210901468,09146,Justiniac,58,58,0
76,09,210901476,09147,Labatut,179,177,2
76,09,210901484,09148,Lacave,126,121,5
76,09,210901492,09149,Lacourt,196,192,4
76,09,210901500,09150,Lagarde,206,200,6
76,09,210901518,09151,Lanoux,55,55,0
76,09,210901526,09152,Lapège,21,20,1
76,09,210901534,09153,Lapenne,123,119,4
76,09,210901542,09154,Larbont,63,61,2
76,09,210901559,09155,Larcat,48,48,0
76,09,210901567,09156,Larnat,20,20,0
76,09,210901575,09157,Laroque-d'Olmes,2435,2391,44
76,09,210901583,09158,Lasserre,261,254,7
76,09,210901591,09159,Lassur,93,91,2
76,09,210901609,09160,Lavelanet,6177,6052,125
76,09,210901617,09161,Léran,634,618,16
76,09,210901625,09162,Lercoul,15,15,0
76,09,210901633,09163,Lescousse,81,81,0
76,09,210901641,09164,Lescure,506,489,17
76,09,210901658,09165,Lesparrou,233,233,0
76,09,210901666,09166,Leychert,107,105,2
76,09,210901674,09167,Lézat-sur-Lèze,2400,2360,40
76,09,210901682,09168,Lieurac,191,183,8
76,09,210901690,09169,Limbrassac,124,121,3
76,09,210901708,09170,Lissac,259,250,9
76,09,210901716,09171,Lordat,70,70,0
76,09,210901724,09172,Loubaut,24,24,0
76,09,210901732,09173,Loubens,288,283,5
76,09,210901740,09174,Loubières,371,358,13
76,09,210901757,09175,Ludiès,97,93,4
76,09,210901765,09176,Luzenac,522,513,9
76,09,210901773,09177,Madière,252,246,6
76,09,210901781,09178,Malegoude,45,43,2
76,09,210901799,09179,Malléon,80,79,1
76,09,210901807,09180,Manses,120,119,1
76,09,210901815,09181,Le Mas-d'Azil,1199,1181,18
76,09,210901823,09182,Massat,744,734,10
76,09,210901831,09183,Mauvezin-de-Prat,106,102,4
76,09,210901849,09184,Mauvezin-de-Sainte-Croix,50,49,1
76,09,210901856,09185,Mazères,3955,3872,83
76,09,210901864,09186,Méras,101,101,0
76,09,210901872,09187,Mercenac,361,351,10
76,09,210901880,09188,Mercus-Garrabet,1227,1203,24
76,09,210901898,09189,Mérens-les-Vals,172,168,4
76,09,210901906,09190,Mérigon,113,112,1
76,09,210901922,09192,Miglos,115,112,3
76,09,210901930,09193,Mijanès,60,60,0
76,09,210901948,09194,Mirepoix,3236,3114,122
76,09,210901955,09195,Monesple,29,29,0
76,09,210901963,09196,Montagagne,80,79,1
76,09,210901971,09197,Montaillou,17,17,0
76,09,210901989,09198,Montardit,221,216,5
76,09,210901997,09199,Montaut,712,695,17
76,09,210902003,09200,Montbel,100,97,3
76,09,210902011,09201,Montégut-en-Couserans,79,78,1
76,09,210902029,09202,Montégut-Plantaurel,344,335,9
76,09,210902037,09203,Montels,163,154,9
76,09,210902045,09204,Montesquieu-Avantès,264,253,11
76,09,210902052,09205,Montfa,86,85,1
76,09,210902060,09206,Montferrier,566,553,13
76,09,210902078,09207,Montgailhard,1506,1476,30
76,09,210902086,09208,Montgauch,121,120,1
76,09,210902094,09209,Montjoie-en-Couserans,1031,1010,21
76,09,210902102,09210,Montoulieu,418,411,7
76,09,210902110,09211,Montségur,119,117,2
76,09,210902128,09212,Montseron,108,107,1
76,09,210902136,09213,Moulin-Neuf,242,240,2
76,09,210902144,09214,Moulis,784,768,16
76,09,210902151,09215,Nalzen,121,119,2
76,09,210902169,09216,Nescus,64,63,1
76,09,210902177,09217,Niaux,156,154,2
76,09,210902185,09218,Orgeix,93,92,1
76,09,210902193,09219,Orgibet,189,185,4
76,09,210902201,09220,Orlu,168,165,3
76,09,210902219,09221,Ornolac-Ussat-les-Bains,251,248,3
76,09,210902227,09222,Orus,27,27,0
76,09,210902235,09223,Oust,570,562,8
76,09,210902243,09224,Pailhès,487,486,1
76,09,210902250,09225,Pamiers,16421,15938,483
76,09,210902268,09226,Pech,37,37,0
76,09,210902276,09227,Péreille,195,194,1
76,09,210902284,09228,Perles-et-Castelet,231,226,5
76,09,210902292,09229,Le Peyrat,488,476,12
76,09,210902300,09230,Le Pla,62,62,0
76,09,210902318,09231,Le Port,166,165,1
76,09,210902326,09232,Prades,31,31,0
76,09,210902334,09233,Pradettes,46,45,1
76,09,210902342,09234,Pradières,124,121,3
76,09,210902359,09235,Prat-Bonrepaux,877,861,16
76,09,210902367,09236,Prayols,384,368,16
76,09,210902375,09237,Le Puch,31,30,1
76,09,210902383,09238,Les Pujols,857,840,17
76,09,210902391,09239,Quérigut,140,138,2
76,09,210902409,09240,Quié,298,295,3
76,09,210902417,09241,Rabat-les-Trois-Seigneurs,374,368,6
76,09,210902425,09242,Raissac,55,54,1
76,09,210902433,09243,Régat,88,85,3
76,09,210902441,09244,Rieucros,732,720,12
76,09,210902458,09245,Rieux-de-Pelleport,1306,1270,36
76,09,210902466,09246,Rimont,552,532,20
76,09,210902474,09247,Rivèrenert,170,160,10
76,09,210902490,09249,Roquefixade,150,146,4
76,09,210902508,09250,Roquefort-les-Cascades,92,90,2
76,09,210902516,09251,Roumengoux,172,165,7
76,09,210902524,09252,Rouze,90,90,0
76,09,210902532,09253,Sabarat,397,391,6
76,09,210902540,09254,Saint-Amadou,253,249,4
76,09,210902565,09256,Saint-Bauzeil,59,59,0
76,09,210902573,09257,Sainte-Croix-Volvestre,640,631,9
76,09,210902581,09258,Saint-Félix-de-Rieutord,476,466,10
76,09,210902599,09259,Saint-Félix-de-Tournegat,157,153,4
76,09,210902607,09260,Sainte-Foi,30,30,0
76,09,210902615,09261,Saint-Girons,6812,6415,397
76,09,210902623,09262,Saint-Jean-d'Aigues-Vives,383,378,5
76,09,210902631,09263,Saint-Jean-du-Castillonnais,23,23,0
76,09,210902649,09264,Saint-Jean-de-Verges,1302,1285,17
76,09,210902656,09265,Saint-Jean-du-Falga,2914,2855,59
76,09,210902664,09266,Saint-Julien-de-Gras-Capou,74,72,2
76,09,210902672,09267,Saint-Lary,127,125,2
76,09,210902680,09268,Saint-Lizier,1399,1367,32
76,09,210902698,09269,Saint-Martin-de-Caralp,376,365,11
76,09,210902706,09270,Saint-Martin-d'Oydes,234,230,4
76,09,210902714,09271,Saint-Michel,87,85,2
76,09,210902722,09272,Saint-Paul-de-Jarrat,1362,1337,25
76,09,210902730,09273,Saint-Pierre-de-Rivière,691,668,23
76,09,210902748,09274,Saint-Quentin-la-Tour,343,338,5
76,09,210902755,09275,Saint-Quirc,380,370,10
76,09,210902763,09276,Saint-Victor-Rouzaud,231,221,10
76,09,210902771,09277,Saint-Ybars,701,690,11
76,09,210902797,09279,Salsein,50,48,2
76,09,210902805,09280,Saurat,671,659,12
76,09,210902813,09281,Sautel,125,123,2
76,09,210902821,09282,Saverdun,4966,4815,151
76,09,210902839,09283,Savignac-les-Ormeaux,414,398,16
76,09,210902847,09284,Ségura,194,188,6
76,09,210902854,09285,Seix,718,704,14
76,09,210902870,09287,Senconac,11,11,0
76,09,210902896,09289,Lorp-Sentaraille,1484,1461,23
76,09,210902904,09290,Sentein,161,158,3
76,09,210902912,09291,Sentenac-d'Oust,108,105,3
76,09,210902920,09292,Sentenac-de-Sérou,58,58,0
76,09,210902938,09293,Serres-sur-Arget,688,678,10
76,09,210902946,09294,Sieuras,103,101,2
76,09,210902953,09295,Siguer,97,96,1
76,09,200082824,09296,Aulos-Sinsat,152,150,2
76,09,210902979,09297,Sor,27,27,0
76,09,210902987,09298,Sorgeat,84,83,1
76,09,210902995,09299,Soueix-Rogalle,437,430,7
76,09,210903001,09300,Soula,183,176,7
76,09,210903019,09301,Soulan,374,372,2
76,09,210903035,09303,Surba,327,319,8
76,09,210903043,09304,Suzan,17,17,0
76,09,210903050,09305,Tabre,359,352,7
76,09,210903068,09306,Tarascon-sur-Ariège,3044,3013,31
76,09,210903076,09307,Taurignan-Castet,156,154,2
76,09,210903084,09308,Taurignan-Vieux,215,207,8
76,09,210903092,09309,Teilhet,161,156,5
76,09,210903100,09310,Thouars-sur-Arize,46,44,2
76,09,210903118,09311,Tignac,21,21,0
76,09,210903126,09312,La Tour-du-Crieu,3303,3232,71
76,09,210903134,09313,Tourtouse,162,158,4
76,09,210903142,09314,Tourtrol,276,262,14
76,09,210903159,09315,Trémoulet,122,121,1
76,09,210903167,09316,Troye-d'Ariège,110,109,1
76,09,210903183,09318,Unac,127,126,1
76,09,210903191,09319,Unzent,118,114,4
76,09,210903209,09320,Urs,29,28,1
76,09,210903217,09321,Ussat,314,310,4
76,09,210903225,09322,Ustou,278,268,10
76,09,210903233,09323,Vals,91,90,1
76,09,210903241,09324,Varilhes,3552,3495,57
76,09,210903258,09325,Vaychis,32,32,0
76,09,210903266,09326,Vèbre,124,121,3
76,09,210903274,09327,Ventenac,237,235,2
76,09,210903282,09328,Verdun,222,213,9
76,09,210903290,09329,Vernajoul,718,698,20
76,09,210903308,09330,Vernaux,29,29,0
76,09,210903316,09331,Le Vernet,733,727,6
76,09,210903324,09332,Verniolle,2344,2295,49
76,09,200081784,09334,Val-de-Sos,617,554,63
76,09,210903357,09335,Villeneuve,41,41,0
76,09,210903365,09336,Villeneuve-d'Olmes,978,957,21
76,09,210903381,09338,Villeneuve-du-Latou,157,154,3
76,09,210903399,09339,Villeneuve-du-Paréage,792,778,14
76,09,210903407,09340,Vira,160,156,4
76,09,210903415,09341,Viviès,153,153,0
76,09,210903423,09342,Sainte-Suzanne,240,238,2
44,10,211000013,10002,Ailleville,237,232,5
44,10,200058840,10003,Aix-Villemaur-Pâlis,3576,3537,39
44,10,211000039,10004,Allibaudières,209,207,2
44,10,211000047,10005,Amance,262,250,12
44,10,211000054,10006,Arcis-sur-Aube,2845,2767,78
44,10,211000062,10007,Arconville,106,104,2
44,10,211000070,10008,Argançon,114,113,1
44,10,211000088,10009,Arrelles,88,86,2
44,10,211000096,10010,Arrembécourt,48,46,2
44,10,211000104,10011,Arrentières,209,208,1
44,10,211000112,10012,Arsonval,305,300,5
44,10,211000120,10013,Assenay,148,143,5
44,10,211000138,10014,Assencières,187,186,1
44,10,211000146,10015,Aubeterre,385,379,6
44,10,211000153,10017,Aulnay,126,123,3
44,10,211000161,10018,Auxon,1040,1030,10
44,10,211000179,10019,Val-d'Auzon,385,380,5
44,10,211000187,10020,Avant-lès-Marcilly,513,503,10
44,10,211000195,10021,Avant-lès-Ramerupt,160,156,4
44,10,211000203,10022,Avirey-Lingey,211,200,11
44,10,211000211,10023,Avon-la-Pèze,197,193,4
44,10,211000229,10024,Avreuil,173,170,3
44,10,211000237,10025,Bagneux-la-Fosse,176,172,4
44,10,211000245,10026,Bailly-le-Franc,37,37,0
44,10,211000252,10027,Balignicourt,61,59,2
44,10,211000260,10028,Balnot-la-Grange,119,117,2
44,10,211000278,10029,Balnot-sur-Laignes,156,154,2
44,10,211000286,10030,Barberey-Saint-Sulpice,1597,1568,29
44,10,211000294,10031,Barbuise,483,475,8
44,10,211000302,10032,Baroville,310,301,9
44,10,211000310,10033,Bar-sur-Aube,4968,4774,194
44,10,211000328,10034,Bar-sur-Seine,3128,2932,196
44,10,211000336,10035,Bayel,756,747,9
44,10,211000344,10037,Bercenay-en-Othe,442,432,10
44,10,211004346,10038,Bercenay-le-Hayer,199,197,2
44,10,211000351,10039,Bergères,119,114,5
44,10,211000369,10040,Bernon,173,165,8
44,10,211000377,10041,Bertignolles,51,51,0
44,10,211000385,10042,Bérulle,205,201,4
44,10,211004338,10043,Bessy,124,121,3
44,10,211000393,10044,Bétignicourt,34,34,0
44,10,211000401,10045,Beurey,189,180,9
44,10,211000419,10046,Blaincourt-sur-Aube,111,109,2
44,10,211000427,10047,Blignicourt,43,42,1
44,10,211000435,10048,Bligny,166,162,4
44,10,211000443,10049,Les Bordes-Aumont,534,525,9
44,10,211000450,10050,Bossancourt,197,194,3
44,10,211000468,10051,Bouilly,1125,1078,47
44,10,211000476,10052,Boulages,225,220,5
44,10,211000484,10053,Bouranton,612,603,9
44,10,211000492,10054,Bourdenay,111,110,1
44,10,211000500,10055,Bourguignons,272,261,11
44,10,211000518,10056,Bouy-Luxembourg,248,247,1
44,10,211000526,10057,Bouy-sur-Orvin,54,53,1
44,10,211000534,10058,Bragelogne-Beauvoir,239,235,4
44,10,211000542,10059,Braux,117,112,5
44,10,211000559,10060,Bréviandes,2989,2933,56
44,10,211000567,10061,Brévonnes,679,667,12
44,10,211000575,10062,Briel-sur-Barse,202,199,3
44,10,211000583,10063,Brienne-la-Vieille,415,402,13
44,10,211000591,10064,Brienne-le-Château,2779,2754,25
44,10,211000609,10065,Brillecourt,85,84,1
44,10,211000617,10066,Bucey-en-Othe,447,437,10
44,10,211000625,10067,Buchères,1918,1889,29
44,10,211000633,10068,Buxeuil,124,121,3
44,10,211000641,10069,Buxières-sur-Arce,115,115,0
44,10,211000658,10070,Celles-sur-Ource,501,482,19
44,10,211000666,10071,Chacenay,53,52,1
44,10,211000674,10072,La Chaise,34,34,0
44,10,211000682,10073,Chalette-sur-Voire,127,125,2
44,10,211000690,10074,Chamoy,512,504,8
44,10,211000708,10075,Champfleury,101,100,1
44,10,211000716,10076,Champignol-lez-Mondeville,264,257,7
44,10,211000724,10077,Champigny-sur-Aube,106,105,1
44,10,211000732,10078,Champ-sur-Barse,27,27,0
44,10,211000740,10079,Channes,135,133,2
44,10,211000757,10080,Chaource,1029,1017,12
44,10,211000765,10081,La Chapelle-Saint-Luc,12411,12324,87
44,10,211000773,10082,Chapelle-Vallon,245,240,5
44,10,211000781,10083,Chappes,349,344,5
44,10,211000799,10084,Charmont-sous-Barbuise,1040,1011,29
44,10,211000807,10085,Charmoy,65,65,0
44,10,211000815,10086,Charny-le-Bachot,265,257,8
44,10,211000823,10087,Chaserey,51,51,0
44,10,211000831,10089,Châtres,708,701,7
44,10,211000849,10090,Chauchigny,231,228,3
44,10,211000856,10091,Chaudrey,144,139,5
44,10,211000864,10092,Chauffour-lès-Bailly,129,129,0
44,10,211000872,10093,Chaumesnil,105,103,2
44,10,211000880,10094,Chavanges,604,593,11
44,10,211000898,10095,Le Chêne,292,287,5
44,10,211000906,10096,Chennegy,455,444,11
44,10,211000914,10097,Chervey,159,157,2
44,10,211000922,10098,Chesley,317,312,5
44,10,211000930,10099,Chessy-les-Prés,541,527,14
44,10,211000948,10100,Clérey,1158,1134,24
44,10,211000955,10101,Coclois,174,172,2
44,10,211000963,10102,Colombé-la-Fosse,182,181,1
44,10,211000971,10103,Colombé-le-Sec,155,154,1
44,10,211000989,10104,Cormost,309,306,3
44,10,211000997,10105,Courcelles-sur-Voire,27,26,1
44,10,211001003,10106,Courceroy,146,141,5
44,10,211001011,10107,Coursan-en-Othe,102,102,0
44,10,211001029,10108,Courtaoult,81,81,0
44,10,211001037,10109,Courtenot,228,226,2
44,10,211001045,10110,Courteranges,586,568,18
44,10,211001052,10111,Courteron,108,103,5
44,10,211001060,10112,Coussegrey,180,178,2
44,10,211001078,10113,Couvignon,200,198,2
44,10,211001086,10114,Crancey,721,706,15
44,10,211001094,10115,Creney-près-Troyes,2031,1997,34
44,10,211001102,10116,Crésantignes,321,317,4
44,10,211001110,10117,Crespy-le-Neuf,148,147,1
44,10,211001128,10118,Les Croûtes,96,92,4
44,10,211001136,10119,Cunfin,178,174,4
44,10,211001144,10120,Cussangy,202,200,2
44,10,211001151,10121,Dampierre,336,328,8
44,10,211001169,10122,Davrey,227,223,4
44,10,211001177,10123,Dienville,872,847,25
44,10,211001185,10124,Dierrey-Saint-Julien,270,266,4
44,10,211001193,10125,Dierrey-Saint-Pierre,317,312,5
44,10,211001201,10126,Dolancourt,133,129,4
44,10,211001219,10127,Dommartin-le-Coq,57,57,0
44,10,211001227,10128,Donnement,75,74,1
44,10,211001235,10129,Dosches,315,307,8
44,10,211001243,10130,Dosnon,104,98,6
44,10,211001250,10131,Droupt-Saint-Basle,360,354,6
44,10,211001268,10132,Droupt-Sainte-Marie,241,241,0
44,10,211001276,10133,Eaux-Puiseaux,263,257,6
44,10,211001284,10134,Échemines,92,86,6
44,10,211001292,10135,Éclance,99,96,3
44,10,211001300,10136,Éguilly-sous-Bois,118,117,1
44,10,211001318,10137,Engente,33,33,0
44,10,211001326,10138,Épagne,144,142,2
44,10,211001334,10139,Épothémont,164,160,4
44,10,211001342,10140,Ervy-le-Châtel,1134,1125,9
44,10,211001359,10141,Essoyes,730,718,12
44,10,211001367,10142,Estissac,1867,1849,18
44,10,211001375,10143,Étourvy,165,161,4
44,10,211001383,10144,Étrelles-sur-Aube,161,155,6
44,10,211001391,10145,Faux-Villecerf,214,207,7
44,10,211001409,10146,Fay-lès-Marcilly,95,92,3
44,10,211001417,10147,Fays-la-Chapelle,133,129,4
44,10,211001425,10148,Ferreux-Quincey,415,409,6
44,10,211001433,10149,Feuges,338,333,5
44,10,211001441,10150,Fontaine,255,250,5
44,10,211001458,10151,Fontaine-les-Grès,893,884,9
44,10,211001466,10153,Fontaine-Mâcon,625,611,14
44,10,211001474,10154,Fontenay-de-Bossery,72,71,1
44,10,211001482,10155,Fontette,188,182,6
44,10,211001490,10156,Fontvannes,715,707,8
44,10,211001508,10157,La Fosse-Corduan,220,214,6
44,10,211001516,10158,Fouchères,533,526,7
44,10,211001524,10159,Fralignes,87,86,1
44,10,211001532,10160,Fravaux,40,39,1
44,10,211001540,10161,Fresnay,52,49,3
44,10,211001557,10162,Fresnoy-le-Château,301,295,6
44,10,211001565,10163,Fuligny,43,41,2
44,10,211001573,10164,Gélannes,744,734,10
44,10,211001581,10165,Géraudot,342,336,6
44,10,211001599,10166,Les Grandes-Chapelles,403,397,6
44,10,211001607,10167,Grandville,91,90,1
44,10,211001615,10168,Les Granges,82,81,1
44,10,211001623,10169,Gumery,227,219,8
44,10,211001631,10170,Gyé-sur-Seine,485,476,9
44,10,211001649,10171,Hampigny,234,227,7
44,10,211001656,10172,Herbisse,155,154,1
44,10,211001664,10173,Isle-Aumont,468,460,8
44,10,211001672,10174,Isle-Aubigny,171,168,3
44,10,211001680,10175,Jasseines,175,171,4
44,10,211001698,10176,Jaucourt,162,156,6
44,10,211001706,10177,Javernant,157,150,7
44,10,211001714,10178,Jessains,263,257,6
44,10,211001722,10179,Jeugny,481,471,10
44,10,211001730,10180,Joncreuil,99,96,3
44,10,211001748,10181,Jully-sur-Sarce,226,214,12
44,10,211001755,10182,Juvancourt,120,119,1
44,10,211001763,10183,Juvanzé,36,35,1
44,10,211001771,10184,Juzanvigny,128,127,1
44,10,211001789,10185,Lagesse,213,209,4
44,10,211001797,10186,Laines-aux-Bois,545,529,16
44,10,211001805,10187,Landreville,401,391,10
44,10,211001813,10188,Lantages,217,210,7
44,10,211001821,10189,Lassicourt,58,58,0
44,10,211001839,10190,Laubressel,582,576,6
44,10,211001847,10191,Lavau,905,896,9
44,10,211001854,10192,Lentilles,130,129,1
44,10,211001862,10193,Lesmont,306,302,4
44,10,211001870,10194,Lévigny,96,94,2
44,10,211001888,10195,Lhuître,293,287,6
44,10,211001896,10196,Lignières,223,219,4
44,10,211001904,10197,Lignol-le-Château,180,170,10
44,10,211001912,10198,Lirey,106,104,2
44,10,211001920,10199,Loches-sur-Ource,353,347,6
44,10,211001938,10200,La Loge-aux-Chèvres,98,95,3
44,10,211001946,10201,La Loge-Pomblin,69,69,0
44,10,211001953,10202,Les Loges-Margueron,296,216,80
44,10,211001961,10203,Longchamp-sur-Aujon,387,374,13
44,10,211001979,10204,Longeville-sur-Mogne,144,141,3
44,10,211001987,10205,Longpré-le-Sec,87,85,2
44,10,211001995,10206,Longsols,129,128,1
44,10,211002001,10207,Longueville-sur-Aube,131,130,1
44,10,211002019,10208,La Louptière-Thénard,302,290,12
44,10,211002027,10209,Lusigny-sur-Barse,2282,2225,57
44,10,211002035,10210,Luyères,470,457,13
44,10,211002043,10211,Macey,1013,997,16
44,10,211002050,10212,Machy,116,113,3
44,10,211002068,10213,Magnant,162,159,3
44,10,211002076,10214,Magnicourt,91,90,1
44,10,211002084,10215,Magny-Fouchard,263,261,2
44,10,211002092,10216,Mailly-le-Camp,2064,2038,26
44,10,211002100,10217,Maison-des-Champs,33,33,0
44,10,211002118,10218,Maisons-lès-Chaource,169,168,1
44,10,211002126,10219,Maisons-lès-Soulaines,72,69,3
44,10,211002134,10220,Maizières-la-Grande-Paroisse,1548,1505,43
44,10,211002142,10221,Maizières-lès-Brienne,160,160,0
44,10,211002159,10222,Maraye-en-Othe,441,434,7
44,10,211002167,10223,Marcilly-le-Hayer,735,726,9
44,10,211002175,10224,Marigny-le-Châtel,1793,1761,32
44,10,211002183,10225,Marnay-sur-Seine,242,235,7
44,10,211002191,10226,Marolles-lès-Bailly,115,113,2
44,10,211002209,10227,Marolles-sous-Lignières,344,340,4
44,10,211002217,10228,Mathaux,206,204,2
44,10,211002225,10229,Maupas,104,102,2
44,10,211002233,10230,Mergey,683,674,9
44,10,211002241,10231,Le Mériot,634,624,10
44,10,211002258,10232,Merrey-sur-Arce,328,325,3
44,10,211002266,10233,Méry-sur-Seine,1531,1488,43
44,10,211002274,10234,Mesgrigny,271,271,0
44,10,211002282,10235,Mesnil-la-Comtesse,50,50,0
44,10,211002290,10236,Mesnil-Lettre,57,56,1
44,10,211002308,10237,Mesnil-Saint-Loup,619,590,29
44,10,211002316,10238,Mesnil-Saint-Père,448,439,9
44,10,211002324,10239,Mesnil-Sellières,613,589,24
44,10,211002332,10240,Messon,477,467,10
44,10,211002340,10241,Metz-Robert,61,61,0
44,10,211002357,10242,Meurville,161,158,3
44,10,211002365,10243,Molins-sur-Aube,109,104,5
44,10,211002373,10245,Montaulin,839,812,27
44,10,211002381,10246,Montceaux-lès-Vaudes,276,256,20
44,10,211002399,10247,Montfey,124,120,4
44,10,211002407,10248,Montgueux,404,393,11
44,10,211004312,10249,Montiéramey,411,403,8
44,10,211002423,10250,Montier-en-l'Isle,228,222,6
44,10,211002431,10251,Montigny-les-Monts,262,254,8
44,10,211002449,10252,Montmartin-le-Haut,63,61,2
44,10,211002456,10253,Montmorency-Beaufort,144,143,1
44,10,211002464,10254,Montpothier,338,329,9
44,10,211002472,10255,Montreuil-sur-Barse,292,287,5
44,10,211002480,10256,Montsuzain,409,405,4
44,10,211002498,10257,Morembert,29,29,0
44,10,211002506,10258,Morvilliers,284,277,7
44,10,211002514,10259,La Motte-Tilly,364,361,3
44,10,211002522,10260,Moussey,668,652,16
44,10,211002530,10261,Mussy-sur-Seine,1036,1021,15
44,10,211002548,10262,Neuville-sur-Seine,403,395,8
44,10,211002555,10263,Neuville-sur-Vanne,452,446,6
44,10,211002563,10264,Noé-les-Mallets,116,113,3
44,10,211002571,10265,Les Noës-près-Troyes,3311,3279,32
44,10,211002589,10266,Nogent-en-Othe,46,46,0
44,10,211002597,10267,Nogent-sur-Aube,303,297,6
44,10,211002605,10268,Nogent-sur-Seine,6062,5946,116
44,10,211002613,10269,Nozay,157,153,4
44,10,211002621,10270,Onjon,271,265,6
44,10,211002639,10271,Origny-le-Sec,605,598,7
44,10,211002647,10272,Ormes,182,179,3
44,10,211002654,10273,Ortillon,23,23,0
44,10,211002662,10274,Orvilliers-Saint-Julien,314,310,4
44,10,211002670,10275,Ossey-les-Trois-Maisons,603,596,7
44,10,211002688,10276,Paisy-Cosdon,341,335,6
44,10,211002704,10278,Pargues,140,136,4
44,10,211002712,10279,Pars-lès-Chavanges,48,47,1
44,10,211002720,10280,Pars-lès-Romilly,824,816,8
44,10,211002738,10281,Le Pavillon-Sainte-Julie,292,287,5
44,10,211002746,10282,Payns,1394,1375,19
44,10,211002753,10283,Pel-et-Der,131,129,2
44,10,211002761,10284,Périgny-la-Rose,153,150,3
44,10,211002779,10285,Perthes-lès-Brienne,69,69,0
44,10,211002787,10286,Petit-Mesnil,213,206,7
44,10,211002795,10287,Piney,1493,1477,16
44,10,211002803,10288,Plaines-Saint-Lange,269,265,4
44,10,211002811,10289,Plancy-l'Abbaye,982,966,16
44,10,211002829,10290,Planty,235,232,3
44,10,211002837,10291,Plessis-Barbuise,187,180,7
44,10,211002845,10293,Poivres,161,159,2
44,10,211002852,10294,Poligny,63,61,2
44,10,211002860,10295,Polisot,330,324,6
44,10,211002878,10296,Polisy,184,182,2
44,10,211002886,10297,Pont-Sainte-Marie,5237,5146,91
44,10,211002894,10298,Pont-sur-Seine,1180,1160,20
44,10,211002902,10299,Pouan-les-Vallées,530,513,17
44,10,211002910,10300,Pougy,291,289,2
44,10,211002928,10301,Pouy-sur-Vannes,180,176,4
44,10,211002936,10302,Praslin,87,85,2
44,10,211002944,10303,Précy-Notre-Dame,78,77,1
44,10,211002951,10304,Précy-Saint-Martin,185,183,2
44,10,211002969,10305,Prémierfait,88,87,1
44,10,211002977,10306,Proverville,242,236,6
44,10,211002985,10307,Prugny,375,365,10
44,10,211002993,10308,Prunay-Belleville,217,209,8
44,10,211003009,10309,Prusy,98,96,2
44,10,211003017,10310,Puits-et-Nuisement,218,211,7
44,10,211003025,10312,Racines,173,169,4
44,10,211003033,10313,Radonvilliers,360,356,4
44,10,211003041,10314,Ramerupt,414,410,4
44,10,211003058,10315,Rances,47,45,2
44,10,211003066,10316,Rhèges,219,216,3
44,10,211003074,10317,Les Riceys,1230,1207,23
44,10,211003082,10318,Rigny-la-Nonneuse,158,156,2
44,10,211003090,10319,Rigny-le-Ferron,331,322,9
44,10,211003108,10320,Rilly-Sainte-Syre,235,230,5
44,10,211003116,10321,La Rivière-de-Corps,3687,3621,66
44,10,211003124,10323,Romilly-sur-Seine,14959,14623,336
44,10,211003132,10324,Roncenay,162,159,3
44,10,211003140,10325,Rosières-près-Troyes,4961,4633,328
44,10,211003157,10326,Rosnay-l'Hôpital,177,169,8
44,10,211003165,10327,La Rothière,117,116,1
44,10,211003173,10328,Rouilly-Sacey,393,389,4
44,10,211003181,10329,Rouilly-Saint-Loup,559,521,38
44,10,211003199,10330,Rouvres-les-Vignes,113,112,1
44,10,211003207,10331,Rumilly-lès-Vaudes,578,568,10
44,10,211003215,10332,Ruvigny,506,495,11
44,10,211003223,10333,Saint-André-les-Vergers,12880,12701,179
44,10,211003231,10334,Saint-Aubin,598,590,8
44,10,211003249,10335,Saint-Benoist-sur-Vanne,242,237,5
44,10,211003256,10336,Saint-Benoît-sur-Seine,396,391,5
44,10,211003264,10337,Saint-Christophe-Dodinicourt,34,33,1
44,10,211003272,10338,Saint-Étienne-sous-Barbuise,180,177,3
44,10,211003280,10339,Saint-Flavy,300,294,6
44,10,211003298,10340,Saint-Germain,2353,2305,48
44,10,211003306,10341,Saint-Hilaire-sous-Romilly,364,355,9
44,10,211003314,10342,Saint-Jean-de-Bonneval,412,404,8
44,10,211003322,10343,Saint-Julien-les-Villas,6883,6738,145
44,10,211003330,10344,Saint-Léger-près-Troyes,927,912,15
44,10,211003348,10345,Saint-Léger-sous-Brienne,394,383,11
44,10,211003355,10346,Saint-Léger-sous-Margerie,52,51,1
44,10,211003363,10347,Saint-Loup-de-Buffigny,213,207,6
44,10,211003371,10348,Saint-Lupien,232,228,4
44,10,211003389,10349,Saint-Lyé,2951,2889,62
44,10,211003397,10350,Saint-Mards-en-Othe,652,638,14
44,10,211003405,10351,Saint-Martin-de-Bossenay,370,365,5
44,10,211003413,10352,Sainte-Maure,2046,1752,294
44,10,211003421,10353,Saint-Mesmin,902,891,11
44,10,211003439,10354,Saint-Nabord-sur-Aube,141,137,4
44,10,211003447,10355,Saint-Nicolas-la-Chapelle,69,69,0
44,10,211003454,10356,Saint-Oulph,318,311,7
44,10,211003462,10357,Saint-Parres-aux-Tertres,3227,3179,48
44,10,211003470,10358,Saint-Parres-lès-Vaudes,1080,1062,18
44,10,211003488,10359,Saint-Phal,521,510,11
44,10,211003496,10360,Saint-Pouange,1203,972,231
44,10,211003504,10361,Saint-Remy-sous-Barbuise,250,246,4
44,10,211003512,10362,Sainte-Savine,10847,10496,351
44,10,211003520,10363,Saint-Thibault,550,547,3
44,10,211003538,10364,Saint-Usage,74,72,2
44,10,211003546,10365,Salon,125,125,0
44,10,211003553,10366,Saulcy,65,63,2
44,10,211003561,10367,La Saulsotte,690,681,9
44,10,211003579,10368,Savières,1042,1025,17
44,10,211003587,10369,Semoine,206,202,4
44,10,211003595,10370,Soligny-les-Étangs,256,250,6
44,10,211003603,10371,Sommeval,313,308,5
44,10,211003611,10372,Soulaines-Dhuys,425,419,6
44,10,211003629,10373,Souligny,398,378,20
44,10,211003637,10374,Spoy,154,153,1
44,10,211003645,10375,Thennelières,344,334,10
44,10,211003652,10376,Thieffrain,157,154,3
44,10,211003660,10377,Thil,120,111,9
44,10,211003678,10378,Thors,71,68,3
44,10,211003686,10379,Torcy-le-Grand,466,457,9
44,10,211003694,10380,Torcy-le-Petit,79,77,2
44,10,211003702,10381,Torvilliers,1013,995,18
44,10,211003710,10382,Traînel,1049,1036,13
44,10,211004353,10383,Trancault,187,184,3
44,10,211003728,10384,Trannes,211,204,7
44,10,211003736,10386,Trouans,223,217,6
44,10,211003744,10387,Troyes,63708,62597,1111
44,10,211003751,10388,Turgy,44,43,1
44,10,211003769,10389,Unienville,116,112,4
44,10,211003777,10390,Urville,122,120,2
44,10,211003785,10391,Vailly,299,298,1
44,10,211003793,10392,Vallant-Saint-Georges,411,402,9
44,10,211003801,10393,Vallentigny,181,180,1
44,10,211003819,10394,Vallières,167,166,1
44,10,211003827,10395,Vanlay,297,293,4
44,10,211003835,10396,Vauchassis,506,499,7
44,10,211003843,10397,Vauchonvilliers,169,167,2
44,10,211003850,10398,Vaucogne,75,74,1
44,10,211003868,10399,Vaudes,729,721,8
44,10,211003876,10400,Vaupoisson,121,116,5
44,10,211003884,10401,Vendeuvre-sur-Barse,2358,2317,41
44,10,211003892,10402,La Vendue-Mignot,249,244,5
44,10,211003900,10403,Vernonvilliers,53,52,1
44,10,211003918,10404,Verpillières-sur-Ource,113,111,2
44,10,211003926,10405,Verricourt,58,58,0
44,10,211003934,10406,Verrières,1895,1858,37
44,10,211003942,10408,Viâpres-le-Petit,139,134,5
44,10,211003959,10409,Villacerf,615,611,4
44,10,211003967,10410,Villadin,109,105,4
44,10,211003975,10411,La Ville-aux-Bois,28,28,0
44,10,211004015,10412,Villechétif,969,949,20
44,10,211004023,10414,Villeloup,130,125,5
44,10,211004049,10416,Villemereuil,247,243,4
44,10,211004056,10417,Villemoiron-en-Othe,213,207,6
44,10,211004064,10418,Villemorien,208,198,10
44,10,211004072,10419,Villemoyenne,752,739,13
44,10,211004080,10420,Villenauxe-la-Grande,2729,2685,44
44,10,211004098,10421,La Villeneuve-au-Châtelot,151,147,4
44,10,211004106,10422,Villeneuve-au-Chemin,187,185,2
44,10,211004114,10423,La Villeneuve-au-Chêne,423,408,15
44,10,211004122,10424,Villeret,65,63,2
44,10,211004130,10425,Villery,273,270,3
44,10,211003983,10426,Ville-sous-la-Ferté,919,907,12
44,10,211003991,10427,Ville-sur-Arce,207,200,7
44,10,211004007,10428,Ville-sur-Terre,104,99,5
44,10,211004148,10429,Villette-sur-Aube,252,249,3
44,10,211004155,10430,Villiers-Herbisse,86,84,2
44,10,211004163,10431,Villiers-le-Bois,103,102,1
44,10,211004171,10432,Villiers-sous-Praslin,72,71,1
44,10,211004189,10433,Villy-en-Trodes,261,253,8
44,10,211004197,10434,Villy-le-Bois,58,57,1
44,10,211004205,10435,Villy-le-Maréchal,194,190,4
44,10,211004213,10436,Vinets,181,176,5
44,10,211004221,10437,Virey-sous-Bar,610,600,10
44,10,211004239,10438,Vitry-le-Croisé,224,222,2
44,10,211004247,10439,Viviers-sur-Artaut,126,123,3
44,10,211004254,10440,Voigny,150,144,6
44,10,211004262,10441,Vosnon,232,231,1
44,10,211004270,10442,Voué,708,699,9
44,10,211004288,10443,Vougrey,44,43,1
44,10,211004296,10444,Vulaines,229,226,3
44,10,211004304,10445,Yèvres-le-Petit,63,54,9
76,11,211100011,11001,Aigues-Vives,561,550,11
76,11,211100029,11002,Airoux,172,170,2
76,11,211100037,11003,Ajac,204,201,3
76,11,211100045,11004,Alaigne,342,337,5
76,11,211100052,11005,Alairac,1370,1338,32
76,11,211100060,11006,Albas,80,78,2
76,11,211100078,11007,Albières,123,119,4
76,11,211100086,11008,Alet-les-Bains,391,388,3
76,11,211100094,11009,Alzonne,1615,1592,23
76,11,211100102,11010,Antugnac,274,270,4
76,11,211100110,11011,Aragon,481,467,14
76,11,211100128,11012,Argeliers,2191,2155,36
76,11,211100136,11013,Argens-Minervois,361,355,6
76,11,211100144,11014,Armissan,1525,1495,30
76,11,211100151,11015,Arques,264,261,3
76,11,211100169,11016,Arquettes-en-Val,83,80,3
76,11,211100177,11017,Artigues,76,75,1
76,11,211100185,11018,Arzens,1244,1211,33
76,11,211100193,11019,Aunat,62,62,0
76,11,211100201,11020,Auriac,35,35,0
76,11,211100219,11021,Axat,522,513,9
76,11,211100227,11022,Azille,1146,1123,23
76,11,211100235,11023,Badens,759,745,14
76,11,211100243,11024,Bages,797,782,15
76,11,211100250,11025,Bagnoles,311,308,3
76,11,211100268,11026,Baraigne,175,172,3
76,11,211100276,11027,Barbaira,815,793,22
76,11,211100284,11028,Belcaire,383,376,7
76,11,211100292,11029,Belcastel-et-Buc,64,61,3
76,11,211100300,11030,Belflou,120,114,6
76,11,211100318,11031,Belfort-sur-Rebenty,23,21,2
76,11,211100326,11032,Bellegarde-du-Razès,249,247,2
76,11,211100334,11033,Belpech,1367,1339,28
76,11,211100342,11034,Belvèze-du-Razès,859,853,6
76,11,211100359,11035,Belvianes-et-Cavirac,247,238,9
76,11,211100367,11036,Belvis,164,161,3
76,11,211100375,11037,Berriac,960,950,10
76,11,211100383,11038,Bessède-de-Sault,46,46,0
76,11,211100391,11039,La Bezole,48,47,1
76,11,211100409,11040,Bizanet,1782,1754,28
76,11,211100417,11041,Bize-Minervois,1258,1243,15
76,11,211100425,11042,Blomac,242,235,7
76,11,211100433,11043,Bouilhonnac,227,221,6
76,11,211100441,11044,Bouisse,104,104,0
76,11,211100458,11045,Bouriège,145,144,1
76,11,211100466,11046,Bourigeole,55,55,0
76,11,211100474,11047,Le Bousquet,48,48,0
76,11,211100482,11048,Boutenac,737,722,15
76,11,211100490,11049,Bram,3304,3226,78
76,11,211100516,11051,Brézilhac,188,184,4
76,11,211100524,11052,Brousses-et-Villaret,345,340,5
76,11,211100532,11053,Brugairolles,292,287,5
76,11,211100540,11054,Les Brunels,280,269,11
76,11,211100557,11055,Bugarach,244,240,4
76,11,211100565,11056,Cabrespine,171,167,4
76,11,211100573,11057,Cahuzac,28,28,0
76,11,211100581,11058,Cailhau,261,251,10
76,11,211100599,11059,Cailhavel,145,144,1
76,11,211100607,11060,Cailla,51,50,1
76,11,211100615,11061,Cambieure,317,313,4
76,11,211100623,11062,Campagna-de-Sault,19,19,0
76,11,211100631,11063,Campagne-sur-Aude,612,606,6
76,11,211100649,11064,Camplong-d'Aude,377,373,4
76,11,211100656,11065,Camps-sur-l'Agly,51,51,0
76,11,211100664,11066,Camurac,105,104,1
76,11,211100672,11067,Canet,1850,1832,18
76,11,211100680,11068,Capendu,1512,1473,39
76,11,211100698,11069,Carcassonne,47854,46673,1181
76,11,211100706,11070,Carlipa,344,338,6
76,11,211100714,11071,Cascastel-des-Corbières,230,223,7
76,11,211100722,11072,La Cassaigne,171,163,8
76,11,211100730,11073,Cassaignes,59,59,0
76,11,211100748,11074,Les Cassés,317,307,10
76,11,211100755,11075,Castans,136,134,2
76,11,211100763,11076,Castelnaudary,12978,12467,511
76,11,211100771,11077,Castelnau-d'Aude,512,500,12
76,11,211100789,11078,Castelreng,213,206,7
76,11,211100797,11079,Caudebronde,218,215,3
76,11,200055598,11080,Val de Lambronne,169,167,2
76,11,211100813,11081,Caunes-Minervois,1630,1601,29
76,11,211100821,11082,Caunette-sur-Lauquet,10,10,0
76,11,211100839,11083,Caunettes-en-Val,56,56,0
76,11,211100847,11084,Caux-et-Sauzens,1028,1005,23
76,11,211100854,11085,Cavanac,1001,960,41
76,11,211100862,11086,Caves,908,897,11
76,11,211100870,11087,Cazalrenoux,94,93,1
76,11,211100888,11088,Cazilhac,1690,1640,50
76,11,211100896,11089,Cenne-Monestiés,418,408,10
76,11,211100904,11090,Cépie,632,615,17
76,11,211100912,11091,Chalabre,1151,1139,12
76,11,211100920,11092,Citou,94,91,3
76,11,211100938,11093,Le Clat,29,28,1
76,11,211100946,11094,Clermont-sur-Lauquet,27,27,0
76,11,211100953,11095,Comigne,317,312,5
76,11,211100961,11096,Comus,32,32,0
76,11,211100987,11098,Conilhac-Corbières,918,899,19
76,11,211100995,11099,Conques-sur-Orbiel,2641,2585,56
76,11,211101001,11100,Corbières,30,29,1
76,11,211101019,11101,Coudons,54,52,2
76,11,211101027,11102,Couffoulens,585,571,14
76,11,211101035,11103,Couiza,1143,1122,21
76,11,211101043,11104,Counozouls,52,52,0
76,11,211101050,11105,Cournanel,729,706,23
76,11,211101068,11106,Coursan,5880,5785,95
76,11,211101076,11107,Courtauly,78,77,1
76,11,211101084,11108,La Courtète,47,46,1
76,11,211101092,11109,Coustaussa,53,52,1
76,11,211101100,11110,Coustouge,116,116,0
76,11,211101118,11111,Cruscades,930,921,9
76,11,211101126,11112,Cubières-sur-Cinoble,84,83,1
76,11,211101134,11113,Cucugnan,118,113,5
76,11,211101142,11114,Cumiès,41,41,0
76,11,211101159,11115,Cuxac-Cabardès,928,916,12
76,11,211101167,11116,Cuxac-d'Aude,4115,4044,71
76,11,211101175,11117,Davejean,116,114,2
76,11,211101183,11118,Dernacueillette,46,46,0
76,11,211101191,11119,La Digne-d'Amont,297,293,4
76,11,211101209,11120,La Digne-d'Aval,540,527,13
76,11,211101217,11121,Donazac,112,111,1
76,11,211101225,11122,Douzens,784,771,13
76,11,211101233,11123,Duilhac-sous-Peyrepertuse,151,148,3
76,11,211101241,11124,Durban-Corbières,662,651,11
76,11,211101258,11125,Embres-et-Castelmaure,152,152,0
76,11,211101266,11126,Escales,482,477,5
76,11,211101274,11127,Escouloubre,75,71,4
76,11,211101282,11128,Escueillens-et-Saint-Just-de-Bélengard,148,146,2
76,11,211101290,11129,Espéraza,1742,1712,30
76,11,211101308,11130,Espezel,233,229,4
76,11,200085538,11131,Val-du-Faby,595,582,13
76,11,211101324,11132,Fabrezan,1271,1256,15
76,11,211101332,11133,Fajac-en-Val,45,45,0
76,11,211101340,11134,Fajac-la-Relenque,54,50,4
76,11,211101357,11135,La Fajolle,12,12,0
76,11,211101365,11136,Fanjeaux,945,859,86
76,11,211101373,11137,Félines-Termenès,134,129,5
76,11,211101381,11138,Fendeille,539,523,16
76,11,211101399,11139,Fenouillet-du-Razès,77,77,0
76,11,211101407,11140,Ferrals-les-Corbières,1277,1256,21
76,11,211101415,11141,Ferran,125,124,1
76,11,211101423,11142,Festes-et-Saint-André,199,194,5
76,11,211101431,11143,Feuilla,110,110,0
76,11,211101449,11144,Fitou,1111,1096,15
76,11,211101456,11145,Fleury,3773,3713,60
76,11,211101464,11146,Floure,420,412,8
76,11,211101472,11147,Fontanès-de-Sault,5,5,0
76,11,211101480,11148,Fontcouverte,566,559,7
76,11,211101498,11149,Fonters-du-Razès,80,79,1
76,11,211101506,11150,Fontiers-Cabardès,499,449,50
76,11,211101514,11151,Fontiès-d'Aude,534,523,11
76,11,211101522,11152,Fontjoncouse,134,131,3
76,11,211101530,11153,La Force,257,250,7
76,11,211101548,11154,Fournes-Cabardès,51,51,0
76,11,211101555,11155,Fourtou,80,79,1
76,11,211101563,11156,Fraisse-Cabardès,106,105,1
76,11,211101571,11157,Fraissé-des-Corbières,217,212,5
76,11,211101589,11158,Gaja-et-Villedieu,301,297,4
76,11,211101597,11159,Gaja-la-Selve,139,137,2
76,11,211101605,11160,Galinagues,35,35,0
76,11,211101613,11161,Gardie,131,127,4
76,11,211101621,11162,Generville,58,57,1
76,11,211101639,11163,Gincla,47,46,1
76,11,211101647,11164,Ginestas,1536,1515,21
76,11,211101654,11165,Ginoles,312,303,9
76,11,211101662,11166,Gourvieille,79,77,2
76,11,211101670,11167,Gramazie,130,125,5
76,11,211101688,11168,Granès,105,102,3
76,11,211101696,11169,Greffeil,95,90,5
76,11,211101704,11170,Gruissan,5215,5131,84
76,11,211101720,11172,Homps,608,597,11
76,11,211101738,11173,Hounoux,132,129,3
76,11,211101746,11174,Les Ilhes,56,56,0
76,11,211101753,11175,Issel,488,479,9
76,11,211101761,11176,Jonquières,56,56,0
76,11,211101779,11177,Joucou,31,31,0
76,11,211101787,11178,Labastide-d'Anjou,1293,1278,15
76,11,211101795,11179,Labastide-en-Val,92,90,2
76,11,211101803,11180,Labastide-Esparbairenque,61,61,0
76,11,211101811,11181,Labécède-Lauragais,414,406,8
76,11,211101829,11182,Lacombe,178,175,3
76,11,211101837,11183,Ladern-sur-Lauquet,277,268,9
76,11,211101845,11184,Lafage,96,93,3
76,11,211101852,11185,Lagrasse,553,544,9
76,11,211101860,11186,Lairière,54,54,0
76,11,211101878,11187,Lanet,61,60,1
76,11,211101886,11188,La Palme,1742,1712,30
76,11,211101894,11189,Laprade,109,108,1
76,11,211101902,11190,La Redorte,1263,1243,20
76,11,211101910,11191,Laroque-de-Fa,157,150,7
76,11,211101928,11192,Lasbordes,814,783,31
76,11,211101936,11193,Lasserre-de-Prouille,287,282,5
76,11,211101944,11194,Lastours,158,155,3
76,11,211101951,11195,Laurabuc,403,393,10
76,11,211101969,11196,Laurac,188,181,7
76,11,211101977,11197,Lauraguel,621,608,13
76,11,211101985,11198,Laure-Minervois,1028,1013,15
76,11,211101993,11199,Lavalette,1545,1517,28
76,11,211102009,11200,Lespinassière,137,134,3
76,11,211102017,11201,Leuc,869,851,18
76,11,211102025,11202,Leucate,4635,4581,54
76,11,211102033,11203,Lézignan-Corbières,11338,11112,226
76,11,211102041,11204,Lignairolles,43,43,0
76,11,211102058,11205,Limousis,132,131,1
76,11,211102066,11206,Limoux,10681,10161,520
76,11,211102074,11207,Loupia,246,241,5
76,11,211102082,11208,La Louvière-Lauragais,84,81,3
76,11,211102090,11209,Luc-sur-Aude,252,244,8
76,11,211102108,11210,Luc-sur-Orbieu,1142,1132,10
76,11,211102116,11211,Magrie,542,537,5
76,11,211102124,11212,Mailhac,588,577,11
76,11,211102132,11213,Maisons,47,47,0
76,11,211102140,11214,Malras,439,426,13
76,11,211102157,11215,Malves-en-Minervois,889,863,26
76,11,211102165,11216,Malviès,377,365,12
76,11,211102173,11217,Marcorignan,1337,1309,28
76,11,211102181,11218,Marquein,82,82,0
76,11,211102199,11219,Marsa,19,19,0
76,11,211102207,11220,Marseillette,715,702,13
76,11,211102215,11221,Les Martys,307,302,5
76,11,211102223,11222,Mas-Cabardès,181,176,5
76,11,211102231,11223,Mas-des-Cours,26,25,1
76,11,211102249,11224,Massac,28,27,1
76,11,211102256,11225,Mas-Saintes-Puelles,947,929,18
76,11,211102264,11226,Mayreville,85,84,1
76,11,211102272,11227,Mayronnes,41,40,1
76,11,211102280,11228,Mazerolles-du-Razès,152,148,4
76,11,211102298,11229,Mazuby,27,26,1
76,11,211102306,11230,Mérial,32,32,0
76,11,211102314,11231,Mézerville,101,98,3
76,11,211102322,11232,Miraval-Cabardès,46,46,0
76,11,211102330,11233,Mirepeisset,765,752,13
76,11,211102348,11234,Mireval-Lauragais,190,185,5
76,11,211102355,11235,Missègre,60,58,2
76,11,211102363,11236,Molandier,247,245,2
76,11,211102389,11238,Molleville,147,141,6
76,11,211102397,11239,Montauriol,83,81,2
76,11,211102405,11240,Montazels,565,556,9
76,11,211102413,11241,Montbrun-des-Corbières,340,339,1
76,11,211102421,11242,Montclar,175,175,0
76,11,211102439,11243,Montferrand,635,625,10
76,11,211102447,11244,Montfort-sur-Boulzane,93,90,3
76,11,211102454,11245,Montgaillard,38,38,0
76,11,211102462,11246,Montgradail,45,45,0
76,11,211102470,11247,Monthaut,38,38,0
76,11,211102488,11248,Montirat,70,69,1
76,11,211102496,11249,Montjardin,84,83,1
76,11,211102504,11250,Montjoi,36,35,1
76,11,200085512,11251,Val-de-Dagne,751,737,14
76,11,211102520,11252,Montmaur,321,320,1
76,11,211102538,11253,Montolieu,847,833,14
76,11,211102546,11254,Montréal,2171,1980,191
76,11,211102553,11255,Montredon-des-Corbières,1502,1482,20
76,11,211102561,11256,Montséret,633,621,12
76,11,211102579,11257,Monze,237,234,3
76,11,211102587,11258,Moussan,2088,2041,47
76,11,211102595,11259,Moussoulens,1034,1003,31
76,11,211102603,11260,Mouthoumet,110,109,1
76,11,211102611,11261,Moux,715,707,8
76,11,211102629,11262,Narbonne,57320,56123,1197
76,11,211102637,11263,Nébias,269,261,8
76,11,211102645,11264,Névian,1310,1277,33
76,11,211102652,11265,Niort-de-Sault,42,41,1
76,11,211102660,11266,Port-la-Nouvelle,5975,5905,70
76,11,211102678,11267,Ornaisons,1138,1113,25
76,11,211102686,11268,Orsans,117,117,0
76,11,211102694,11269,Ouveillan,2605,2554,51
76,11,211102702,11270,Padern,140,140,0
76,11,211102710,11271,Palairac,32,32,0
76,11,211102728,11272,Palaja,2567,2496,71
76,11,211102736,11273,Paraza,709,698,11
76,11,211102744,11274,Pauligne,389,374,15
76,11,211102751,11275,Payra-sur-l'Hers,208,205,3
76,11,211102769,11276,Paziols,542,525,17
76,11,211102777,11277,Pécharic-et-le-Py,31,29,2
76,11,211102785,11278,Pech-Luna,77,75,2
76,11,211102793,11279,Pennautier,2764,2714,50
76,11,211102801,11280,Pépieux,1116,1087,29
76,11,211102819,11281,Pexiora,1274,1241,33
76,11,211102827,11282,Peyrefitte-du-Razès,55,53,2
76,11,211102835,11283,Peyrefitte-sur-l'Hers,83,78,5
76,11,211102843,11284,Peyrens,482,466,16
76,11,211102850,11285,Peyriac-de-Mer,1165,1143,22
76,11,211102868,11286,Peyriac-Minervois,1197,1177,20
76,11,211102876,11287,Peyrolles,89,87,2
76,11,211102884,11288,Pezens,1737,1584,153
76,11,211102892,11289,Pieusse,985,968,17
76,11,211102900,11290,Plaigne,119,117,2
76,11,211102918,11291,Plavilla,121,120,1
76,11,211102926,11292,La Pomarède,178,177,1
76,11,211102934,11293,Pomas,943,920,23
76,11,211102942,11294,Pomy,57,56,1
76,11,211102959,11295,Portel-des-Corbières,1343,1322,21
76,11,211102967,11296,Pouzols-Minervois,581,576,5
76,11,211102975,11297,Pradelles-Cabardès,149,148,1
76,11,211102991,11299,Preixan,639,625,14
76,11,211103007,11300,Puginier,155,155,0
76,11,211103015,11301,Puichéric,1203,1186,17
76,11,211103023,11302,Puilaurens,272,263,9
76,11,211103031,11303,Puivert,452,436,16
76,11,200059418,11304,Quillan,3237,3141,96
76,11,211103056,11305,Quintillan,48,48,0
76,11,211103064,11306,Quirbajou,52,51,1
76,11,211103072,11307,Raissac-d'Aude,264,258,6
76,11,211103080,11308,Raissac-sur-Lampy,471,462,9
76,11,211103098,11309,Rennes-le-Château,92,91,1
76,11,211103106,11310,Rennes-les-Bains,199,197,2
76,11,211103114,11311,Ribaute,270,267,3
76,11,211103122,11312,Ribouisse,114,109,5
76,11,211103130,11313,Ricaud,316,310,6
76,11,211103148,11314,Rieux-en-Val,92,85,7
76,11,211103155,11315,Rieux-Minervois,1962,1937,25
76,11,211103163,11316,Rivel,215,212,3
76,11,211103171,11317,Rodome,109,107,2
76,11,211103189,11318,Roquecourbe-Minervois,137,131,6
76,11,211103197,11319,Roquefère,79,77,2
76,11,211103205,11320,Roquefeuil,301,291,10
76,11,211103213,11321,Roquefort-de-Sault,83,83,0
76,11,211103221,11322,Roquefort-des-Corbières,1023,1005,18
76,11,200085561,11323,Roquetaillade-et-Conilhac,276,273,3
76,11,211103247,11324,Roubia,516,503,13
76,11,211103254,11325,Rouffiac-d'Aude,464,453,11
76,11,211103262,11326,Rouffiac-des-Corbières,77,76,1
76,11,211103270,11327,Roullens,519,508,11
76,11,211103288,11328,Routier,241,238,3
76,11,211103304,11330,Rustiques,520,509,11
76,11,211103312,11331,Saint-Amans,63,60,3
76,11,211103320,11332,Saint-André-de-Roquelongue,1394,1377,17
76,11,211103338,11333,Saint-Benoît,110,107,3
76,11,211103346,11334,Sainte-Camelle,120,118,2
76,11,211103353,11335,Sainte-Colombe-sur-Guette,45,45,0
76,11,211103361,11336,Sainte-Colombe-sur-l'Hers,443,438,5
76,11,211103379,11337,Saint-Couat-d'Aude,385,381,4
76,11,211103387,11338,Saint-Couat-du-Razès,41,40,1
76,11,211103395,11339,Saint-Denis,512,500,12
76,11,211103403,11340,Sainte-Eulalie,528,518,10
76,11,211103411,11341,Saint-Ferriol,112,110,2
76,11,211103429,11342,Saint-Frichoux,240,236,4
76,11,211103437,11343,Saint-Gaudéric,118,116,2
76,11,211103445,11344,Saint-Hilaire,727,713,14
76,11,211103452,11345,Saint-Jean-de-Barrou,263,263,0
76,11,211103460,11346,Saint-Jean-de-Paracol,135,131,4
76,11,211103478,11347,Saint-Julia-de-Bec,106,104,2
76,11,211103486,11348,Saint-Julien-de-Briola,87,85,2
76,11,211103502,11350,Saint-Just-et-le-Bézu,54,51,3
76,11,211103510,11351,Saint-Laurent-de-la-Cabrerisse,750,735,15
76,11,211103528,11352,Saint-Louis-et-Parahou,53,51,2
76,11,211103536,11353,Saint-Marcel-sur-Aude,2074,2028,46
76,11,211103544,11354,Saint-Martin-des-Puits,29,28,1
76,11,211103551,11355,Saint-Martin-de-Villereglan,378,370,8
76,11,211103569,11356,Saint-Martin-Lalande,1141,1117,24
76,11,211103577,11357,Saint-Martin-le-Vieil,219,212,7
76,11,211103585,11358,Saint-Martin-Lys,24,24,0
76,11,211103593,11359,Saint-Michel-de-Lanès,487,481,6
76,11,211103601,11360,Saint-Nazaire-d'Aude,2113,2076,37
76,11,211103619,11361,Saint-Papoul,880,866,14
76,11,211103627,11362,Saint-Paulet,208,204,4
76,11,211103635,11363,Saint-Pierre-des-Champs,187,182,5
76,11,211103643,11364,Saint-Polycarpe,143,141,2
76,11,211103650,11365,Saint-Sernin,43,41,2
76,11,211103668,11366,Sainte-Valière,546,536,10
76,11,211103676,11367,Saissac,942,919,23
76,11,211103684,11368,Sallèles-Cabardès,123,121,2
76,11,211103692,11369,Sallèles-d'Aude,3082,3039,43
76,11,211103700,11370,Salles-d'Aude,3327,3251,76
76,11,211103718,11371,Salles-sur-l'Hers,728,715,13
76,11,211103726,11372,Salsigne,382,378,4
76,11,211103734,11373,Salvezines,70,69,1
76,11,211103742,11374,Salza,20,20,0
76,11,211103759,11375,Seignalens,30,29,1
76,11,211103767,11376,La Serpent,99,95,4
76,11,211103775,11377,Serres,81,81,0
76,11,211103783,11378,Serviès-en-Val,204,198,6
76,11,211103791,11379,Sigean,5640,5542,98
76,11,211103809,11380,Sonnac-sur-l'Hers,134,133,1
76,11,211103817,11381,Sougraigne,128,124,4
76,11,211103825,11382,Souilhanels,417,359,58
76,11,211103833,11383,Souilhe,344,333,11
76,11,211103841,11384,Soulatgé,129,128,1
76,11,211103858,11385,Soupex,241,234,7
76,11,211103866,11386,Talairan,475,467,8
76,11,211103874,11387,Taurize,111,110,1
76,11,211103882,11388,Termes,47,47,0
76,11,211103890,11389,Terroles,15,15,0
76,11,211103908,11390,Thézan-des-Corbières,564,554,10
76,11,211103916,11391,La Tourette-Cabardès,26,24,2
76,11,211103924,11392,Tournissan,272,268,4
76,11,211103932,11393,Tourouzelle,496,489,7
76,11,211103940,11394,Tourreilles,130,130,0
76,11,211103957,11395,Trassanel,28,28,0
76,11,211103965,11396,Trausse,601,598,3
76,11,211103973,11397,Trèbes,5560,5438,122
76,11,211103981,11398,Treilles,260,255,5
76,11,211103999,11399,Tréville,111,106,5
76,11,211104005,11400,Tréziers,106,105,1
76,11,211104013,11401,Tuchan,802,790,12
76,11,211104021,11402,Valmigère,24,24,0
76,11,211104047,11404,Ventenac-Cabardès,986,955,31
76,11,211104054,11405,Ventenac-en-Minervois,585,575,10
76,11,211104062,11406,Véraza,34,32,2
76,11,211104070,11407,Verdun-en-Lauragais,292,286,6
76,11,211104088,11408,Verzeille,503,489,14
76,11,211104096,11409,Vignevieille,106,105,1
76,11,211104104,11410,Villalier,987,970,17
76,11,211104112,11411,Villanière,140,137,3
76,11,211104120,11412,Villardebelle,56,56,0
76,11,211104138,11413,Villardonnel,510,500,10
76,11,211104146,11414,Villar-en-Val,25,24,1
76,11,211104153,11415,Villar-Saint-Anselme,125,125,0
76,11,211104161,11416,Villarzel-Cabardès,262,257,5
76,11,211104179,11417,Villarzel-du-Razès,98,98,0
76,11,211104187,11418,Villasavary,1252,1212,40
76,11,211104195,11419,Villautou,64,64,0
76,11,211104203,11420,Villebazy,142,139,3
76,11,211104211,11421,Villedaigne,562,554,8
76,11,211104229,11422,Villedubert,360,345,15
76,11,211104237,11423,Villefloure,160,156,4
76,11,211104245,11424,Villefort,86,85,1
76,11,211104252,11425,Villegailhenc,1711,1658,53
76,11,211104260,11426,Villegly,1220,1196,24
76,11,211104278,11427,Villelongue-d'Aude,307,299,8
76,11,211104286,11428,Villemagne,254,247,7
76,11,211104294,11429,Villemoustaussou,4583,4501,82
76,11,211104302,11430,Villeneuve-la-Comptal,1421,1380,41
76,11,211104310,11431,Villeneuve-les-Corbières,258,251,7
76,11,211104328,11432,Villeneuve-lès-Montréal,346,335,11
76,11,211104336,11433,Villeneuve-Minervois,972,955,17
76,11,211104344,11434,Villepinte,1287,1260,27
76,11,211104351,11435,Villerouge-Termenès,163,157,6
76,11,211104369,11436,Villesèque-des-Corbières,372,370,2
76,11,211104377,11437,Villesèquelande,925,899,26
76,11,211104385,11438,Villesiscle,391,381,10
76,11,211104393,11439,Villespy,416,408,8
76,11,211104401,11440,Villetritouls,34,34,0
76,11,211104419,11441,Vinassan,2716,2662,54
76,12,211200019,12001,Agen-d'Aveyron,1112,1086,26
76,12,211200027,12002,Aguessac,916,887,29
76,12,211200035,12003,Les Albres,347,342,5
76,12,211200043,12004,Almont-les-Junies,460,441,19
76,12,211200068,12006,Alrance,355,345,10
76,12,211200076,12007,Ambeyrac,185,177,8
76,12,211200084,12008,Anglars-Saint-Félix,938,918,20
76,12,211200092,12009,Arnac-sur-Dourdou,37,36,1
76,12,211200100,12010,Arques,160,158,2
76,12,211200118,12011,Arvieu,791,764,27
76,12,211200126,12012,Asprières,764,755,9
76,12,211200134,12013,Aubin,3777,3640,137
76,12,211200159,12015,Auriac-Lagast,234,229,5
76,12,211200167,12016,Auzits,838,817,21
76,12,211200175,12017,Ayssènes,223,218,5
76,12,211200183,12018,Balaguier-d'Olt,187,180,7
76,12,211200191,12019,Balaguier-sur-Rance,92,88,4
76,12,200055408,12021,Le Bas Ségala,1606,1576,30
76,12,211200225,12022,La Bastide-Pradines,113,113,0
76,12,211200233,12023,La Bastide-Solages,105,104,1
76,12,211200241,12024,Belcastel,196,193,3
76,12,211200258,12025,Belmont-sur-Rance,982,970,12
76,12,211200266,12026,Bertholène,1081,1060,21
76,12,211200274,12027,Bessuéjouls,216,209,7
76,12,211200282,12028,Boisse-Penchot,530,520,10
76,12,211200290,12029,Bor-et-Bar,205,200,5
76,12,211200308,12030,Bouillac,393,376,17
76,12,211200316,12031,Bournazel,361,346,15
76,12,211200324,12032,Boussac,616,598,18
76,12,211200332,12033,Bozouls,3037,2951,86
76,12,211200340,12034,Brandonnet,303,295,8
76,12,211200357,12035,Brasc,180,173,7
76,12,211200365,12036,Brommat,645,637,8
76,12,211200373,12037,Broquiès,624,609,15
76,12,211200381,12038,Brousse-le-Château,169,165,4
76,12,211200399,12039,Brusque,265,261,4
76,12,211200415,12041,Cabanès,274,268,6
76,12,211200423,12042,Calmels-et-le-Viala,208,201,7
76,12,211200431,12043,Calmont,2261,2184,77
76,12,211200449,12044,Camarès,1055,1025,30
76,12,211200456,12045,Camboulazet,393,380,13
76,12,211200464,12046,Camjac,584,574,10
76,12,211200472,12047,Campagnac,455,450,5
76,12,211200480,12048,Campouriez,349,341,8
76,12,211200498,12049,Campuac,467,457,10
76,12,211200506,12050,Canet-de-Salars,459,447,12
76,12,211200514,12051,Cantoin,314,310,4
76,12,211200522,12052,Capdenac-Gare,4516,4400,116
76,12,211200530,12053,La Capelle-Balaguier,343,337,6
76,12,211200548,12054,La Capelle-Bleys,355,347,8
76,12,211200555,12055,La Capelle-Bonance,83,83,0
76,12,211200563,12056,Baraqueville,3259,3158,101
76,12,211200571,12057,Cassagnes-Bégonhès,969,936,33
76,12,211200589,12058,Cassuéjouls,110,105,5
76,12,211200597,12059,Castanet,540,516,24
76,12,211200605,12060,Castelmary,117,113,4
76,12,211200613,12061,Castelnau-de-Mandailles,581,570,11
76,12,211200621,12062,Castelnau-Pégayrols,350,348,2
76,12,211200639,12063,La Cavalerie,2219,2188,31
76,12,211200647,12064,Le Cayrol,280,274,6
76,12,211200654,12065,Centrès,479,464,15
76,12,211200662,12066,Clairvaux-d'Aveyron,1172,1146,26
76,12,211200670,12067,Le Clapier,75,75,0
76,12,211200688,12068,Colombiès,899,872,27
76,12,211200696,12069,Combret,268,261,7
76,12,211200704,12070,Compeyre,544,518,26
76,12,211200712,12071,Compolibat,344,337,7
76,12,211200720,12072,Comprégnac,235,228,7
76,12,211200738,12073,Comps-la-Grand-Ville,647,628,19
76,12,211200746,12074,Condom-d'Aubrac,306,292,14
76,12,211200753,12075,Connac,106,104,2
76,12,200055929,12076,Conques-en-Rouergue,1640,1586,54
76,12,211200779,12077,Cornus,526,514,12
76,12,211200787,12078,Les Costes-Gozon,184,180,4
76,12,211200795,12079,Coubisou,507,488,19
76,12,211200803,12080,Coupiac,372,363,9
76,12,211200829,12082,La Couvertoirade,193,191,2
76,12,211200837,12083,Cransac,1515,1472,43
76,12,211200845,12084,Creissels,1613,1558,55
76,12,211200852,12085,Crespin,315,315,0
76,12,211200860,12086,La Cresse,339,323,16
76,12,211200886,12088,Curières,227,223,4
76,12,211200894,12089,Decazeville,5408,5196,212
76,12,200064665,12090,Druelle Balsac,3289,3196,93
76,12,211200910,12091,Drulhe,469,458,11
76,12,211200928,12092,Durenque,533,523,10
76,12,211200936,12093,Le Fel,185,181,4
76,12,211200944,12094,Entraygues-sur-Truyère,999,981,18
76,12,211200951,12095,Escandolières,248,242,6
76,12,211200969,12096,Espalion,4798,4643,155
76,12,211200977,12097,Espeyrac,253,250,3
76,12,211200985,12098,Estaing,492,476,16
76,12,211200993,12099,Fayet,242,238,4
76,12,211201009,12100,Firmi,2427,2363,64
76,12,211201017,12101,Flagnac,1113,1081,32
76,12,211201025,12102,Flavin,2441,2365,76
76,12,211201033,12103,Florentin-la-Capelle,291,283,8
76,12,211201041,12104,Foissac,497,487,10
76,12,211201058,12105,La Fouillade,1138,1108,30
76,12,211201066,12106,Gabriac,560,549,11
76,12,211201074,12107,Gaillac-d'Aveyron,323,318,5
76,12,211201082,12108,Galgan,380,374,6
76,12,211201090,12109,Gissac,100,98,2
76,12,211201108,12110,Golinhac,352,340,12
76,12,211201116,12111,Goutrens,506,488,18
76,12,211201132,12113,Gramond,528,517,11
76,12,211201157,12115,L'Hospitalet-du-Larzac,313,308,5
76,12,211201165,12116,Huparlac,267,261,6
76,12,211201181,12118,Lacroix-Barrez,534,525,9
76,12,211201199,12119,Laguiole,1257,1230,27
76,12,200056398,12120,Laissac-Sévérac l'Église,2256,2153,103
76,12,211201215,12121,Lanuéjouls,742,726,16
76,12,211201223,12122,Lapanouse-de-Cernon,132,124,8
76,12,211201249,12124,Lassouts,324,315,9
76,12,211201256,12125,Laval-Roquecezière,281,277,4
76,12,211201272,12127,Lédergues,658,638,20
76,12,211201280,12128,Lescure-Jaoul,226,219,7
76,12,211201298,12129,Lestrade-et-Thouels,461,448,13
76,12,211201306,12130,Livinhac-le-Haut,1153,1123,30
76,12,211201314,12131,La Loubière,1561,1518,43
76,12,211201330,12133,Luc-la-Primaube,6126,5962,164
76,12,211201348,12134,Lugan,358,351,7
76,12,211201355,12135,Lunac,446,439,7
76,12,211201363,12136,Maleville,954,936,18
76,12,211201371,12137,Manhac,852,841,11
76,12,211201389,12138,Marcillac-Vallon,1778,1724,54
76,12,211201397,12139,Marnhagues-et-Latour,139,138,1
76,12,211201405,12140,Martiel,999,975,24
76,12,211201413,12141,Martrin,227,219,8
76,12,211201421,12142,Mayran,645,629,16
76,12,211201439,12143,Mélagues,62,62,0
76,12,211201447,12144,Meljac,124,122,2
76,12,211201454,12145,Millau,22178,21482,696
76,12,211201462,12146,Le Monastère,2385,2306,79
76,12,211201470,12147,Montagnol,142,141,1
76,12,211201488,12148,Montbazens,1458,1417,41
76,12,211201496,12149,Montclar,155,150,5
76,12,211201504,12150,Monteils,569,481,88
76,12,211201512,12151,Montézic,227,218,9
76,12,211201520,12152,Montfranc,130,128,2
76,12,211201538,12153,Montjaux,433,426,7
76,12,211201546,12154,Montlaur,643,633,10
76,12,211201553,12155,Fondamente,343,334,9
76,12,211201561,12156,Montpeyroux,538,528,10
76,12,211201579,12157,Montrozier,1767,1717,50
76,12,211201587,12158,Montsalès,334,326,8
76,12,211201595,12159,Morlhon-le-Haut,581,556,25
76,12,211201603,12160,Mostuéjouls,325,320,5
76,12,211201611,12161,Mouret,562,549,13
76,12,211201629,12162,Moyrazès,1104,1076,28
76,12,211201637,12163,Murasson,215,211,4
76,12,211201645,12164,Mur-de-Barrez,710,696,14
76,12,211201652,12165,Muret-le-Château,377,362,15
76,12,211201660,12166,Murols,114,113,1
76,12,211201678,12167,Najac,723,701,22
76,12,211201686,12168,Nant,1010,992,18
76,12,211201694,12169,Naucelle,2172,2023,149
76,12,211201702,12170,Naussac,381,373,8
76,12,211201710,12171,Nauviale,605,588,17
76,12,211201728,12172,Le Nayrac,540,528,12
76,12,211201744,12174,Olemps,3573,3471,102
76,12,211201751,12175,Ols-et-Rinhodes,191,189,2
76,12,211201769,12176,Onet-le-Château,12371,11797,574
76,12,200056620,12177,Palmas d'Aveyron,1043,1028,15
76,12,211201785,12178,Paulhe,381,371,10
76,12,211201793,12179,Peux-et-Couffouleux,87,85,2
76,12,211201801,12180,Peyreleau,75,73,2
76,12,211201819,12181,Peyrusse-le-Roc,216,210,6
76,12,211201827,12182,Pierrefiche,289,284,5
76,12,211201835,12183,Plaisance,222,219,3
76,12,211201843,12184,Pomayrols,126,120,6
76,12,211201850,12185,Pont-de-Salars,1704,1632,72
76,12,211201868,12186,Pousthomy,214,212,2
76,12,211201876,12187,Prades-d'Aubrac,352,348,4
76,12,211201884,12188,Prades-Salars,329,319,10
76,12,211201892,12189,Pradinas,360,354,6
76,12,211201900,12190,Prévinquières,299,288,11
76,12,211201918,12191,Privezac,334,324,10
76,12,211201926,12192,Mounes-Prohencoux,190,186,4
76,12,211201934,12193,Pruines,292,282,10
76,12,211201942,12194,Quins,873,852,21
76,12,211201959,12195,Rebourguil,273,270,3
76,12,211201975,12197,Réquista,2056,1978,78
76,12,211201983,12198,Rieupeyroux,2015,1940,75
76,12,211201991,12199,Rignac,2147,2006,141
76,12,211202007,12200,Rivière-sur-Tarn,1056,1029,27
76,12,211202015,12201,Rodelle,1116,1071,45
76,12,211202023,12202,Rodez,26266,24397,1869
76,12,211202031,12203,Roquefort-sur-Soulzon,570,555,15
76,12,211202049,12204,La Roque-Sainte-Marguerite,181,177,4
76,12,211202056,12205,La Rouquette,786,770,16
76,12,211202064,12206,Roussennac,649,631,18
76,12,211202072,12207,Rullac-Saint-Cirq,360,346,14
76,12,211202080,12208,Saint-Affrique,8651,8018,633
76,12,211202098,12209,Saint-Amans-des-Cots,762,749,13
76,12,211202106,12210,Saint-André-de-Najac,460,455,5
76,12,211202114,12211,Saint-André-de-Vézines,134,133,1
76,12,211202122,12212,Saint-Beaulize,94,87,7
76,12,211202130,12213,Saint-Beauzély,640,624,16
76,12,211202148,12214,Saint-Chély-d'Aubrac,531,518,13
76,12,211202155,12215,Saint-Christophe-Vallon,1218,1171,47
76,12,211202163,12216,Saint-Côme-d'Olt,1464,1426,38
76,12,211202171,12217,Sainte-Croix,764,744,20
76,12,211202197,12219,Sainte-Eulalie-d'Olt,385,377,8
76,12,211202205,12220,Sainte-Eulalie-de-Cernon,299,299,0
76,12,211202213,12221,Saint-Félix-de-Lunel,360,354,6
76,12,211202221,12222,Saint-Félix-de-Sorgues,191,187,4
76,12,200055846,12223,Argences en Aubrac,1641,1602,39
76,12,200055366,12224,Saint Geniez d'Olt et d'Aubrac,2256,2217,39
76,12,211202254,12225,Saint-Georges-de-Luzençon,1661,1606,55
76,12,211202262,12226,Saint-Hippolyte,438,424,14
76,12,211202270,12227,Saint-Igest,183,178,5
76,12,211202288,12228,Saint-Izaire,315,308,7
76,12,211202296,12229,Saint-Jean-d'Alcapiès,255,244,11
76,12,211202304,12230,Saint-Jean-Delnous,409,393,16
76,12,211202312,12231,Saint-Jean-du-Bruel,724,717,7
76,12,211202320,12232,Saint-Jean-et-Saint-Paul,289,281,8
76,12,211202338,12233,Saint-Juéry,297,294,3
76,12,211202346,12234,Sainte-Juliette-sur-Viaur,632,624,8
76,12,211202353,12235,Saint-Just-sur-Viaur,212,204,8
76,12,211202361,12236,Saint-Laurent-de-Lévézou,158,153,5
76,12,211202379,12237,Saint-Laurent-d'Olt,730,648,82
76,12,211202387,12238,Saint-Léons,441,425,16
76,12,211202395,12239,Saint-Martin-de-Lenne,337,324,13
76,12,211202403,12240,Saint-Parthem,411,401,10
76,12,211202411,12241,Sainte-Radegonde,1826,1759,67
76,12,211202429,12242,Saint-Rémy,321,306,15
76,12,211202437,12243,Saint-Rome-de-Cernon,970,957,13
76,12,211202445,12244,Saint-Rome-de-Tarn,899,889,10
76,12,211202460,12246,Saint-Santin,545,530,15
76,12,211202478,12247,Saint-Saturnin-de-Lenne,300,297,3
76,12,211202486,12248,Saint-Sernin-sur-Rance,710,607,103
76,12,211202494,12249,Saint-Sever-du-Moustier,195,189,6
76,12,211202502,12250,Saint-Symphorien-de-Thénières,216,210,6
76,12,211202510,12251,Saint-Victor-et-Melvieu,329,322,7
76,12,211202528,12252,Salles-Courbatiès,451,439,12
76,12,211202536,12253,Salles-Curan,1035,1005,30
76,12,211202544,12254,Salles-la-Source,2357,2286,71
76,12,211202551,12255,Salmiech,788,762,26
76,12,211202569,12256,Salvagnac-Cajarc,377,367,10
76,12,211202577,12257,Causse-et-Diège,814,797,17
76,12,211202585,12258,La Salvetat-Peyralès,1004,989,15
76,12,211202593,12259,Sanvensa,661,643,18
76,12,211202601,12260,Sauclières,171,169,2
76,12,211202619,12261,Saujac,128,124,4
76,12,211202627,12262,Sauveterre-de-Rouergue,727,713,14
76,12,211202635,12263,Savignac,777,752,25
76,12,211202643,12264,Sébazac-Concourès,3420,3330,90
76,12,211202650,12265,Sébrazac,544,529,15
76,12,211202668,12266,Ségur,552,547,5
76,12,211202676,12267,La Selve,638,626,12
76,12,211202684,12268,Sénergues,440,424,16
76,12,211202692,12269,La Serre,129,126,3
76,12,200055424,12270,Sévérac d'Aveyron,4198,4079,119
76,12,211202726,12272,Sonnac,532,519,13
76,12,211202734,12273,Soulages-Bonneval,306,298,8
76,12,211202742,12274,Sylvanès,116,114,2
76,12,211202759,12275,Tauriac-de-Camarès,36,35,1
76,12,211202767,12276,Tauriac-de-Naucelle,371,359,12
76,12,211202775,12277,Taussac,532,523,9
76,12,211202783,12278,Tayrac,187,185,2
76,12,211202809,12280,Thérondels,404,391,13
76,12,211202817,12281,Toulonjac,768,745,23
76,12,211202825,12282,Tournemire,431,424,7
76,12,211202833,12283,Trémouilles,491,476,15
76,12,211202841,12284,Le Truel,345,344,1
76,12,211202866,12286,Vabres-l'Abbaye,1250,1219,31
76,12,211202874,12287,Vailhourles,654,636,18
76,12,211202882,12288,Valady,1633,1595,38
76,12,211202890,12289,Valzergues,214,206,8
76,12,211202908,12290,Vaureilles,500,490,10
76,12,211202916,12291,Verrières,387,378,9
76,12,211202924,12292,Versols-et-Lapeyre,430,416,14
76,12,211202932,12293,Veyreau,137,136,1
76,12,211202940,12294,Vézins-de-Lévézou,667,649,18
76,12,211202957,12295,Viala-du-Pas-de-Jaux,99,97,2
76,12,211202965,12296,Viala-du-Tarn,541,528,13
76,12,211202973,12297,Le Vibal,529,510,19
76,12,211202981,12298,Villecomtal,425,417,8
76,12,211202999,12299,Villefranche-de-Panat,710,684,26
76,12,211203005,12300,Villefranche-de-Rouergue,12195,11681,514
76,12,211203013,12301,Villeneuve,2022,1976,46
76,12,211203039,12303,Vimenet,256,251,5
76,12,211203054,12305,Viviez,1248,1227,21
76,12,211203070,12307,Curan,308,293,15
93,13,211300017,13001,Aix-en-Provence,150358,147122,3236
93,13,211300025,13002,Allauch,21769,21546,223
93,13,211300033,13003,Alleins,2762,2695,67
93,13,211300041,13004,Arles,51691,50968,723
93,13,211300058,13005,Aubagne,47640,47190,450
93,13,211300066,13006,Aureille,1575,1545,30
93,13,211300074,13007,Auriol,12834,12667,167
93,13,211300082,13008,Aurons,581,565,16
93,13,211300090,13009,La Barben,879,845,34
93,13,211300108,13010,Barbentane,4367,4228,139
93,13,211300116,13011,Les Baux-de-Provence,319,315,4
93,13,211300124,13012,Beaurecueil,657,600,57
93,13,211300132,13013,Belcodène,1954,1917,37
93,13,211300140,13014,Berre-l'Étang,13903,13834,69
93,13,211300157,13015,Bouc-Bel-Air,15257,14984,273
93,13,211300165,13016,La Bouilladisse,6398,6316,82
93,13,211300173,13017,Boulbon,1534,1516,18
93,13,211300181,13018,Cabannes,4530,4471,59
93,13,211300199,13019,Cabriès,10332,10006,326
93,13,211300207,13020,Cadolive,2223,2179,44
93,13,211300215,13021,Carry-le-Rouet,5831,5705,126
93,13,211300223,13022,Cassis,6889,6782,107
93,13,211300231,13023,Ceyreste,4912,4801,111
93,13,211300249,13024,Charleval,2691,2655,36
93,13,211300256,13025,Châteauneuf-le-Rouge,2433,2358,75
93,13,211300264,13026,Châteauneuf-les-Martigues,17883,17809,74
93,13,211300272,13027,Châteaurenard,16454,16201,253
93,13,211300280,13028,La Ciotat,36812,36441,371
93,13,211300298,13029,Cornillon-Confoux,1518,1494,24
93,13,211300306,13030,Cuges-les-Pins,5434,5380,54
93,13,211300314,13031,La Destrousse,3848,3803,45
93,13,211300322,13032,Éguilles,8222,8076,146
93,13,211300330,13033,Ensuès-la-Redonne,5836,5739,97
93,13,211300348,13034,Eygalières,1760,1730,30
93,13,211300355,13035,Eyguières,7014,6854,160
93,13,211300363,13036,Eyragues,4550,4421,129
93,13,211300371,13037,La Fare-les-Oliviers,8906,8800,106
93,13,211300389,13038,Fontvieille,3599,3531,68
93,13,211300397,13039,Fos-sur-Mer,15685,15512,173
93,13,211300405,13040,Fuveau,10351,10164,187
93,13,211300413,13041,Gardanne,21850,21501,349
93,13,211300421,13042,Gémenos,6827,6698,129
93,13,211300439,13043,Gignac-la-Nerthe,9990,9899,91
93,13,211300447,13044,Grans,5286,5201,85
93,13,211300454,13045,Graveson,4929,4854,75
93,13,211300462,13046,Gréasque,4361,4281,80
93,13,211300470,13047,Istres,45119,44438,681
93,13,211300488,13048,Jouques,4537,4436,101
93,13,211300496,13049,Lamanon,2085,2044,41
93,13,211300504,13050,Lambesc,10273,10018,255
93,13,211300512,13051,Lançon-Provence,9175,9052,123
93,13,211300520,13052,Maillane,2738,2705,33
93,13,211300538,13053,Mallemort,6346,6184,162
93,13,211300546,13054,Marignane,32735,32515,220
93,13,211300553,13055,Marseille,876602,870321,6281
93,13,211300561,13056,Martigues,49037,48506,531
93,13,211300579,13057,Mas-Blanc-des-Alpilles,526,516,10
93,13,211300587,13058,Maussane-les-Alpilles,2445,2396,49
93,13,211300595,13059,Meyrargues,3906,3843,63
93,13,211300603,13060,Meyreuil,5874,5786,88
93,13,211300611,13061,Saint-Pierre-de-Mézoargues,223,219,4
93,13,211300629,13062,Mimet,4232,4158,74
93,13,211300637,13063,Miramas,26807,26433,374
93,13,211300645,13064,Mollégès,2691,2662,29
93,13,211300652,13065,Mouriès,3447,3400,47
93,13,211300660,13066,Noves,5893,5827,66
93,13,211300678,13067,Orgon,2786,2752,34
93,13,211300686,13068,Paradou,2183,2145,38
93,13,211300694,13069,Pélissanne,10827,10561,266
93,13,211300702,13070,La Penne-sur-Huveaune,6574,6521,53
93,13,211300710,13071,Les Pennes-Mirabeau,22174,21897,277
93,13,211300728,13072,Peynier,3641,3567,74
93,13,211300736,13073,Peypin,5681,5604,77
93,13,211300744,13074,Peyrolles-en-Provence,5217,5129,88
93,13,211300751,13075,Plan-de-Cuques,11612,11522,90
93,13,211300769,13076,Plan-d'Orgon,3611,3562,49
93,13,211300777,13077,Port-de-Bouc,16422,16290,132
93,13,211300785,13078,Port-Saint-Louis-du-Rhône,8447,8370,77
93,13,211300793,13079,Puyloubier,1904,1785,119
93,13,211300801,13080,Le Puy-Sainte-Réparade,5980,5866,114
93,13,211300819,13081,Rognac,12239,12136,103
93,13,211300827,13082,Rognes,4740,4616,124
93,13,211300835,13083,Rognonas,4094,4036,58
93,13,211300843,13084,La Roque-d'Anthéron,5534,5411,123
93,13,211300850,13085,Roquefort-la-Bédoule,6004,5937,67
93,13,211300868,13086,Roquevaire,8691,8569,122
93,13,211300876,13087,Rousset,5117,4977,140
93,13,211300884,13088,Le Rove,5240,5193,47
93,13,211300892,13089,Saint-Andiol,3451,3396,55
93,13,211300900,13090,Saint-Antonin-sur-Bayon,129,125,4
93,13,211300918,13091,Saint-Cannat,5761,5648,113
93,13,211300926,13092,Saint-Chamas,8752,8617,135
93,13,211300934,13093,Saint-Estève-Janson,387,379,8
93,13,211300942,13094,Saint-Étienne-du-Grès,2535,2492,43
93,13,211300959,13095,Saint-Marc-Jaumegarde,1297,1229,68
93,13,211300967,13096,Saintes-Maries-de-la-Mer,2145,2123,22
93,13,211300975,13097,Saint-Martin-de-Crau,13661,13364,297
93,13,211300983,13098,Saint-Mitre-les-Remparts,5929,5818,111
93,13,211300991,13099,Saint-Paul-lès-Durance,904,891,13
93,13,211301007,13100,Saint-Rémy-de-Provence,9888,9692,196
93,13,211301015,13101,Saint-Savournin,3540,3481,59
93,13,211301023,13102,Saint-Victoret,6660,6609,51
93,13,211301031,13103,Salon-de-Provence,45595,45009,586
93,13,211301049,13104,Sausset-les-Pins,7688,7570,118
93,13,211301056,13105,Sénas,6966,6878,88
93,13,211301064,13106,Septèmes-les-Vallons,11434,11366,68
93,13,211301072,13107,Simiane-Collongue,6042,5917,125
93,13,211301080,13108,Tarascon,15639,15508,131
93,13,211301098,13109,Le Tholonet,2415,2355,60
93,13,211301106,13110,Trets,10680,10507,173
93,13,211301114,13111,Vauvenargues,1045,1024,21
93,13,211301122,13112,Velaux,8729,8579,150
93,13,211301130,13113,Venelles,8597,8432,165
93,13,211301148,13114,Ventabren,5519,5381,138
93,13,211301155,13115,Vernègues,2105,2062,43
93,13,211301163,13116,Verquières,820,805,15
93,13,211301171,13117,Vitrolles,34814,34418,396
93,13,211301189,13118,Coudoux,3719,3668,51
93,13,211301197,13119,Carnoux-en-Provence,6706,6623,83
28,14,211400015,14001,Ablon,1237,1194,43
28,14,211400031,14003,Agy,317,310,7
28,14,200064939,14005,Valambray,1739,1700,39
28,14,211400064,14006,Amayé-sur-Orne,1088,1067,21
28,14,211400072,14007,Amayé-sur-Seulles,228,224,4
28,14,211400098,14009,Amfreville,1397,1378,19
28,14,200064921,14011,Aurseulles,1921,1899,22
28,14,211400122,14012,Angerville,196,195,1
28,14,200054922,14014,Colomby-Anguerny,1276,1256,20
28,14,211400155,14015,Anisy,764,742,22
28,14,211400163,14016,Annebault,503,490,13
28,14,211400197,14019,Arganchy,219,216,3
28,14,211400205,14020,Argences,3829,3798,31
28,14,211400213,14021,Arromanches-les-Bains,476,465,11
28,14,211400221,14022,Asnelles,612,603,9
28,14,211400239,14023,Asnières-en-Bessin,70,69,1
28,14,211400247,14024,Auberville,603,591,12
28,14,211400254,14025,Aubigny,318,315,3
28,14,211400262,14026,Audrieu,1145,1125,20
28,14,200066454,14027,Les Monts d'Aunay,4659,4595,64
28,14,211400304,14030,Authie,1714,1666,48
28,14,211400320,14032,Les Authieux-sur-Calonne,286,275,11
28,14,211400338,14033,Auvillars,214,212,2
28,14,211400346,14034,Avenay,574,572,2
28,14,200060432,14035,Balleroy-sur-Drôme,1421,1346,75
28,14,211400361,14036,Banneville-la-Campagne,172,171,1
28,14,200060382,14037,Malherbe-sur-Ajon,578,567,11
28,14,211400387,14038,Banville,803,792,11
28,14,211400395,14039,Barbery,820,802,18
28,14,211400403,14040,Barbeville,213,210,3
28,14,211400411,14041,Barneville-la-Bertran,128,123,5
28,14,211400429,14042,Baron-sur-Odon,1026,1005,21
28,14,211400437,14043,Barou-en-Auge,69,69,0
28,14,211400445,14044,Basly,1082,1065,17
28,14,211400452,14045,Basseneville,251,249,2
28,14,211400460,14046,Bavent,1946,1932,14
28,14,211400478,14047,Bayeux,12966,12640,326
28,14,211400494,14049,Bazenville,147,141,6
28,14,211400502,14050,La Bazoque,187,185,2
28,14,211400536,14053,Beaumais,170,167,3
28,14,211400544,14054,Beaumesnil,206,202,4
28,14,211400551,14055,Beaumont-en-Auge,417,409,8
28,14,211400577,14057,Bellengreville,1479,1470,9
28,14,211400593,14059,Benerville-sur-Mer,452,420,32
28,14,211400601,14060,Bénouville,2065,2039,26
28,14,200056869,14061,Souleuvre en Bocage,8995,8848,147
28,14,211400627,14062,Bény-sur-Mer,450,444,6
28,14,211400635,14063,Bernesq,218,213,5
28,14,211400643,14064,Bernières-d'Ailly,228,221,7
28,14,211400668,14066,Bernières-sur-Mer,2364,2330,34
28,14,211400684,14068,Biéville-Beuville,3733,3646,87
28,14,211400692,14069,Beuvillers,1357,1331,26
28,14,211400700,14070,Beuvron-en-Auge,199,197,2
28,14,211400767,14076,Blainville-sur-Orne,5836,5761,75
28,14,211400775,14077,Blangy-le-Château,784,728,56
28,14,211400783,14078,Blay,368,364,4
28,14,211400791,14079,Blonville-sur-Mer,1587,1552,35
28,14,211400809,14080,Le Bô,129,125,4
28,14,211400825,14082,La Boissière,197,189,8
28,14,211400833,14083,Bonnebosq,681,666,15
28,14,211400841,14084,Bonnemaison,406,398,8
28,14,211400858,14085,Bonneville-la-Louvet,833,814,19
28,14,211400866,14086,Bonneville-sur-Touques,333,321,12
28,14,211400874,14087,Bonnoeil,123,122,1
28,14,211400882,14088,Bons-Tassilly,410,401,9
28,14,211400890,14089,Bougy,399,390,9
28,14,211400908,14090,Boulon,785,778,7
28,14,211400916,14091,Bourgeauville,100,100,0
28,14,211400924,14092,Bourguébus,2330,2304,26
28,14,211400932,14093,Branville,203,198,5
28,14,211400965,14096,Brémoy,241,236,5
28,14,211400973,14097,Bretteville-le-Rabet,306,303,3
28,14,200065027,14098,Thue et Mue,6212,6150,62
28,14,211401005,14100,Bretteville-sur-Laize,1937,1912,25
28,14,211401013,14101,Bretteville-sur-Odon,4140,4069,71
28,14,211401021,14102,Le Breuil-en-Auge,1016,994,22
28,14,211401039,14103,Le Breuil-en-Bessin,422,415,7
28,14,211401047,14104,Le Brévedent,183,178,5
28,14,211401062,14106,Bréville-les-Monts,665,659,6
28,14,211401070,14107,Bricqueville,155,155,0
28,14,211401104,14110,Brucourt,127,126,1
28,14,211401112,14111,Bucéels,442,437,5
28,14,211401161,14116,Le Bû-sur-Rouvres,118,113,5
28,14,211401179,14117,Cabourg,3541,3511,30
28,14,211401187,14118,Caen,109401,107250,2151
28,14,211401195,14119,Cagny,2017,2003,14
28,14,211401203,14120,Cahagnes,1421,1400,21
28,14,211401211,14121,Cahagnolles,257,256,1
28,14,211401229,14122,La Caine,159,158,1
28,14,211401237,14123,Cairon,2079,2029,50
28,14,211401245,14124,La Cambe,557,548,9
28,14,211401252,14125,Cambes-en-Plaine,1766,1717,49
28,14,200083194,14126,Cambremer,1358,1322,36
28,14,211401278,14127,Campagnolles,560,555,5
28,14,211401302,14130,Campigny,190,186,4
28,14,211401310,14131,Canapville,230,226,4
28,14,211401328,14132,Canchy,205,205,0
28,14,211401344,14134,Canteloup,194,190,4
28,14,211401351,14135,Carcagny,283,281,2
28,14,211401369,14136,Cardonville,96,96,0
28,14,211401377,14137,Carpiquet,3165,3137,28
28,14,211401385,14138,Cartigny-l'Épinay,300,295,5
28,14,211401401,14140,Castillon,358,352,6
28,14,211401419,14141,Castillon-en-Auge,162,160,2
28,14,200064871,14143,Caumont-sur-Aure,2420,2394,26
28,14,211401450,14145,Cauvicourt,554,550,4
28,14,211401468,14146,Cauville,173,169,4
28,14,211401476,14147,Cernay,140,139,1
28,14,211401492,14149,Cesny-aux-Vignes,429,416,13
28,14,200083160,14150,Cesny-les-Sources,1384,1365,19
28,14,211401591,14159,Chouain,241,229,12
28,14,211401609,14160,Cintheaux,193,187,6
28,14,211401617,14161,Clarbec,345,331,14
28,14,211401625,14162,Clécy,1319,1305,14
28,14,211401633,14163,Cléville,390,387,3
28,14,211401658,14165,Colleville-sur-Mer,185,184,1
28,14,211401666,14166,Colleville-Montgomery,2588,2546,42
28,14,211401674,14167,Colombelles,7064,7029,35
28,14,211401682,14168,Colombières,210,205,5
28,14,211401690,14169,Colombiers-sur-Seulles,157,157,0
28,14,211401716,14171,Combray,145,144,1
28,14,211401724,14172,Commes,453,445,8
28,14,211401732,14173,Condé-sur-Ifs,448,434,14
28,14,200056877,14174,Condé-en-Normandie,6605,6296,309
28,14,211401757,14175,Condé-sur-Seulles,303,298,5
28,14,211401773,14177,Coquainvilliers,860,844,16
28,14,211401799,14179,Cordebugle,168,164,4
28,14,211401807,14180,Cordey,158,155,3
28,14,211401815,14181,Cormelles-le-Royal,5136,5093,43
28,14,211401823,14182,Cormolain,402,397,5
28,14,211401831,14183,Cossesseville,107,107,0
28,14,211401849,14184,Cottun,236,230,6
28,14,211401906,14190,Courcy,131,127,4
28,14,211401914,14191,Courseulles-sur-Mer,4237,4185,52
28,14,211401930,14193,Courtonne-la-Meurdrac,684,665,19
28,14,211401948,14194,Courtonne-les-Deux-Églises,662,642,20
28,14,211401955,14195,Courvaudon,271,270,1
28,14,211401963,14196,Crépon,220,212,8
28,14,211401971,14197,Cresserons,1126,1099,27
28,14,211401989,14198,Cresseveuille,261,252,9
28,14,200065118,14200,Creully sur Seulles,2322,2260,62
28,14,211402029,14202,Cricqueboeuf,272,267,5
28,14,211402037,14203,Cricqueville-en-Auge,191,189,2
28,14,211402045,14204,Cricqueville-en-Bessin,174,172,2
28,14,211402052,14205,Cristot,224,218,6
28,14,211402060,14206,Crocy,291,291,0
28,14,211402078,14207,Croisilles,657,648,9
28,14,211402094,14209,Crouay,515,505,10
28,14,211402110,14211,Culey-le-Patry,367,366,1
28,14,211402144,14214,Cussy,184,183,1
28,14,211402151,14215,Cuverville,2316,2284,32
28,14,211402169,14216,Damblainville,242,239,3
28,14,211402185,14218,Danestal,409,404,5
28,14,211402201,14220,Deauville,3615,3567,48
28,14,211402219,14221,Démouville,3104,3063,41
28,14,211402235,14223,Le Détroit,90,88,2
28,14,211402243,14224,Deux-Jumeaux,49,47,2
28,14,211402250,14225,Dives-sur-Mer,5403,5234,169
28,14,211402268,14226,Donnay,304,302,2
28,14,211402276,14227,Douville-en-Auge,215,214,1
28,14,211402284,14228,Douvres-la-Délivrande,5278,5076,202
28,14,211402292,14229,Dozulé,2335,2314,21
28,14,211402300,14230,Drubec,114,114,0
28,14,211402318,14231,Beaufour-Druval,451,439,12
28,14,211402326,14232,Ducy-Sainte-Marguerite,175,172,3
28,14,211402367,14236,Ellon,615,608,7
28,14,211402375,14237,Émiéville,640,633,7
28,14,211402383,14238,Englesqueville-en-Auge,114,112,2
28,14,211402391,14239,Englesqueville-la-Percée,103,103,0
28,14,211402409,14240,Épaney,520,508,12
28,14,211402417,14241,Épinay-sur-Odon,638,624,14
28,14,211402425,14242,Épron,1679,1655,24
28,14,211402433,14243,Équemauville,1605,1580,25
28,14,211402441,14244,Eraines,304,294,10
28,14,211402458,14245,Ernes,329,319,10
28,14,211402466,14246,Escoville,815,809,6
28,14,211402482,14248,Espins,255,250,5
28,14,211402490,14249,Esquay-Notre-Dame,1458,1436,22
28,14,211402508,14250,Esquay-sur-Seulles,285,279,6
28,14,211402516,14251,Esson,556,550,6
28,14,211402524,14252,Estrées-la-Campagne,268,265,3
28,14,211402540,14254,Éterville,1670,1644,26
28,14,211402565,14256,Étréham,335,330,5
28,14,211402573,14257,Évrecy,2046,2020,26
28,14,211402581,14258,Falaise,8083,7849,234
28,14,211402607,14260,Fauguernon,248,241,7
28,14,211402615,14261,Le Faulq,342,335,7
28,14,211402664,14266,Feuguerolles-Bully,1464,1443,21
28,14,211402698,14269,Fierville-les-Parcs,232,228,4
28,14,211402706,14270,Firfol,396,387,9
28,14,211402714,14271,Fleury-sur-Orne,5051,4981,70
28,14,211402722,14272,La Folie,101,99,2
28,14,211402730,14273,La Folletière-Abenon,141,140,1
28,14,211402748,14274,Fontaine-Étoupefour,2747,2682,65
28,14,211402755,14275,Fontaine-Henry,500,494,6
28,14,211402763,14276,Fontaine-le-Pin,358,355,3
28,14,211402771,14277,Fontenay-le-Marmion,1960,1946,14
28,14,211402789,14278,Fontenay-le-Pesnel,1215,1197,18
28,14,211402805,14280,Formentin,267,259,8
28,14,200064913,14281,Formigny La Bataille,754,744,10
28,14,211402821,14282,Foulognes,219,213,6
28,14,211402839,14283,Fourches,227,220,7
28,14,211402847,14284,Fourneaux-le-Val,158,155,3
28,14,211402854,14285,Le Fournet,78,76,2
28,14,211402862,14286,Fourneville,497,477,20
28,14,211402870,14287,Frénouville,1996,1981,15
28,14,211402888,14288,Le Fresne-Camilly,974,949,25
28,14,211402896,14289,Fresné-la-Mère,593,580,13
28,14,211402904,14290,Fresney-le-Puceux,813,804,9
28,14,211402912,14291,Fresney-le-Vieux,301,297,4
28,14,211402938,14293,Fumichon,274,272,2
28,14,211402979,14297,Gavrus,604,597,7
28,14,211402987,14298,Géfosse-Fontenay,135,132,3
28,14,211402995,14299,Genneville,861,844,17
28,14,211403001,14300,Gerrots,51,51,0
28,14,211403019,14301,Giberville,4929,4881,48
28,14,211403027,14302,Glanville,169,164,5
28,14,211403035,14303,Glos,947,926,21
28,14,211403043,14304,Gonneville-sur-Honfleur,896,873,23
28,14,211403050,14305,Gonneville-sur-Mer,676,670,6
28,14,211403068,14306,Gonneville-en-Auge,394,389,5
28,14,211403084,14308,Goustranville,301,301,0
28,14,211403092,14309,Gouvix,838,834,4
28,14,211403100,14310,Grainville-Langannerie,741,733,8
28,14,211403118,14311,Grainville-sur-Odon,1058,1049,9
28,14,211403126,14312,Grandcamp-Maisy,1555,1533,22
28,14,211403167,14316,Grangues,279,276,3
28,14,211403183,14318,Graye-sur-Mer,738,731,7
28,14,211403191,14319,Grentheville,972,964,8
28,14,211403209,14320,Grimbosq,289,282,7
28,14,211403225,14322,Guéron,251,246,5
28,14,211403258,14325,Hermanville-sur-Mer,3187,3144,43
28,14,211403266,14326,Hermival-les-Vaux,843,825,18
28,14,211403274,14327,Hérouville-Saint-Clair,22388,22150,238
28,14,211403282,14328,Hérouvillette,1356,1349,7
28,14,211403290,14329,Heuland,119,115,4
28,14,211403324,14332,La Hoguette,675,664,11
28,14,211403332,14333,Honfleur,6933,6742,191
28,14,211403340,14334,L'Hôtellerie,324,318,6
28,14,211403357,14335,Hotot-en-Auge,301,298,3
28,14,211403365,14336,Hottot-les-Bagues,478,473,5
28,14,211403373,14337,La Houblonnière,339,329,10
28,14,211403381,14338,Houlgate,1728,1689,39
28,14,211403415,14341,Ifs,12123,11902,221
28,14,200064905,14342,Isigny-sur-Mer,3630,3590,40
28,14,211403431,14343,Les Isles-Bardel,67,67,0
28,14,211403449,14344,Janville,395,386,9
28,14,211403456,14345,Jort,303,301,2
28,14,211403464,14346,Juaye-Mondaye,695,685,10
28,14,200066421,14347,Dialan sur Chaîne,1039,1027,12
28,14,211403480,14348,Juvigny-sur-Seulles,83,82,1
28,14,200065092,14349,Laize-Clinchamps,2161,2130,31
28,14,211403522,14352,Landelles-et-Coupigny,856,839,17
28,14,211403530,14353,Landes-sur-Ajon,456,451,5
28,14,211403548,14354,Langrune-sur-Mer,1995,1948,47
28,14,200065068,14355,Ponts sur Seulles,1238,1217,21
28,14,200069714,14357,Terres de Druance,922,903,19
28,14,211403589,14358,Léaupartie,89,88,1
28,14,211403605,14360,Leffard,221,219,2
28,14,211403621,14362,Lessard-et-le-Chêne,159,159,0
28,14,211403647,14364,Lingèvres,479,466,13
28,14,211403654,14365,Lion-sur-Mer,2539,2499,40
28,14,211403662,14366,Lisieux,20366,19755,611
28,14,211403670,14367,Lison,439,434,5
28,14,211403688,14368,Lisores,274,263,11
28,14,211403696,14369,Litteau,289,286,3
28,14,211403704,14370,Le Molay-Littry,3069,3030,39
28,14,200060515,14371,Livarot-Pays-d'Auge,6294,6183,111
28,14,211403746,14374,Les Loges,146,144,2
28,14,211403753,14375,Les Loges-Saulces,173,170,3
28,14,211403779,14377,Longues-sur-Mer,594,585,9
28,14,211403787,14378,Longueville,278,270,8
28,14,211403795,14379,Longvillers,365,361,4
28,14,211403803,14380,Loucelles,191,186,5
28,14,211403811,14381,Louvagny,61,60,1
28,14,211403837,14383,Louvigny,2703,2666,37
28,14,211403845,14384,Luc-sur-Mer,3301,3241,60
28,14,211403852,14385,Magny-en-Bessin,168,160,8
28,14,211403894,14389,Maisoncelles-Pelvey,272,260,12
28,14,211403902,14390,Maisoncelles-sur-Ajon,192,188,4
28,14,211403910,14391,Maisons,418,405,13
28,14,211403936,14393,Maizet,375,368,7
28,14,211403944,14394,Maizières,445,431,14
28,14,211403969,14396,Maltot,1040,1025,15
28,14,211403977,14397,Mandeville-en-Bessin,334,326,8
28,14,211403985,14398,Manerbe,563,547,16
28,14,211403993,14399,Manneville-la-Pipard,278,268,10
28,14,211404009,14400,Le Manoir,217,211,6
28,14,211404017,14401,Manvieux,145,139,6
28,14,211404025,14402,Le Marais-la-Chapelle,105,104,1
28,14,211404033,14403,Marolles,765,744,21
28,14,211404041,14404,Martainville,122,121,1
28,14,211404058,14405,Martigny-sur-l'Ante,335,328,7
28,14,200065001,14406,Moulins-en-Bessin,1114,1088,26
28,14,211404074,14407,Mathieu,2376,2318,58
28,14,211404082,14408,May-sur-Orne,2035,2016,19
28,14,211404090,14409,Merville-Franceville-Plage,2228,2195,33
28,14,200064889,14410,Méry-Bissières-en-Auge,1091,1078,13
28,14,211404116,14411,Meslay,324,319,5
28,14,211404124,14412,Le Mesnil-au-Grain,80,80,0
28,14,211404199,14419,Le Mesnil-Eudes,261,253,8
28,14,211404215,14421,Le Mesnil-Guillaume,599,591,8
28,14,211404249,14424,Le Mesnil-Robert,191,188,3
28,14,211404256,14425,Le Mesnil-Simon,167,161,6
28,14,211404264,14426,Le Mesnil-sur-Blangy,169,162,7
28,14,211404272,14427,Le Mesnil-Villement,294,291,3
28,14,211404306,14430,Meuvaines,139,136,3
28,14,200064996,14431,Mézidon Vallée d'Auge,9734,9624,110
28,14,211404355,14435,Les Monceaux,205,202,3
28,14,211404363,14436,Monceaux-en-Bessin,561,556,5
28,14,211404371,14437,Mondeville,10285,10054,231
28,14,211404389,14438,Mondrainville,565,558,7
28,14,211404397,14439,Monfréville,93,91,2
28,14,211404454,14445,Montfiquet,92,90,2
28,14,211404462,14446,Montigny,101,99,2
28,14,211404488,14448,Montreuil-en-Auge,66,66,0
28,14,211404496,14449,Monts-en-Bessin,414,408,6
28,14,211404520,14452,Morteaux-Couliboeuf,626,616,10
28,14,211404538,14453,Mosles,358,351,7
28,14,211404546,14454,Mouen,1711,1683,28
28,14,211404553,14455,Moulines,279,276,3
28,14,200065019,14456,Moult-Chicheboville,3390,3344,46
28,14,211404579,14457,Les Moutiers-en-Auge,130,129,1
28,14,211404587,14458,Les Moutiers-en-Cinglais,594,515,79
28,14,211404603,14460,Moyaux,1371,1342,29
28,14,211404611,14461,Mutrécy,511,506,5
28,14,211404652,14465,Nonant,518,505,13
28,14,211404660,14466,Norolles,351,342,9
28,14,211404678,14467,Noron-l'Abbaye,325,318,7
28,14,211404686,14468,Noron-la-Poterie,352,346,6
28,14,211404694,14469,Norrey-en-Auge,93,92,1
28,14,211404736,14473,Notre-Dame-de-Livaye,114,111,3
28,14,200049336,14474,Notre-Dame-d'Estrées-Corbon,204,201,3
28,14,200064954,14475,Val d'Arry,2446,2399,47
28,14,211404769,14476,Olendon,185,182,3
28,14,211404785,14478,Orbec,1992,1943,49
28,14,211404801,14480,Osmanville,519,514,5
28,14,211404827,14482,Ouézy,243,241,2
28,14,211404835,14483,Ouffières,192,190,2
28,14,211404843,14484,Ouilly-du-Houley,252,247,5
28,14,211404868,14486,Ouilly-le-Tesson,581,572,9
28,14,211404876,14487,Ouilly-le-Vicomte,777,756,21
28,14,211404884,14488,Ouistreham,9558,9438,120
28,14,211404918,14491,Parfouru-sur-Odon,206,195,11
28,14,211404926,14492,Pennedepie,320,313,7
28,14,211404942,14494,Périers-en-Auge,131,124,7
28,14,211404959,14495,Périers-sur-le-Dan,577,566,11
28,14,211404967,14496,Périgny,61,57,4
28,14,211404975,14497,Perrières,344,337,7
28,14,211404983,14498,Pertheville-Ners,242,238,4
28,14,211404991,14499,Petiville,553,547,6
28,14,211405006,14500,Pierrefitte-en-Auge,163,157,6
28,14,211405014,14501,Pierrefitte-en-Cinglais,247,242,5
28,14,211405022,14502,Pierrepont,88,87,1
28,14,211405048,14504,Le Pin,834,813,21
28,14,211405063,14506,Planquery,252,249,3
28,14,211405097,14509,Plumetot,215,210,5
28,14,211405105,14510,La Pommeraye,62,59,3
28,14,211405113,14511,Pont-Bellanger,67,67,0
28,14,211405121,14512,Pontécoulant,70,70,0
28,14,200086379,14514,Pont-l'Évêque,4862,4790,72
28,14,211405154,14515,Port-en-Bessin-Huppain,1938,1921,17
28,14,211405162,14516,Potigny,2092,2072,20
28,14,211405196,14519,Préaux-Bocage,126,126,0
28,14,211405204,14520,Le Pré-d'Auge,880,858,22
28,14,211405220,14522,Prêtreville,395,388,7
28,14,211405246,14524,Putot-en-Auge,310,303,7
28,14,200064970,14527,Belle Vie en Auge,551,543,8
28,14,211405287,14528,Quetteville,404,399,5
28,14,211405295,14529,Ranchy,272,269,3
28,14,211405303,14530,Ranville,1990,1962,28
28,14,211405311,14531,Rapilly,49,49,0
28,14,211405337,14533,Repentigny,104,100,4
28,14,211405345,14534,Reux,399,396,3
28,14,211405352,14535,Reviers,562,550,12
28,14,211405360,14536,La Rivière-Saint-Sauveur,2596,2551,45
28,14,200086502,14538,Castine-en-Plaine,1732,1699,33
28,14,211405402,14540,Rocques,300,287,13
28,14,211405410,14541,La Roque-Baignard,116,115,1
28,14,211405428,14542,Rosel,547,536,11
28,14,200060481,14543,Rots,2524,2474,50
28,14,211405469,14546,Rouvres,225,223,2
28,14,211405477,14547,Rubercy,155,152,3
28,14,211405501,14550,Rumesnil,91,90,1
28,14,211405527,14552,Ryes,513,499,14
28,14,200082931,14554,Le Castelet,1737,1716,21
28,14,211405550,14555,Saint-André-d'Hébertot,456,451,5
28,14,211405568,14556,Saint-André-sur-Orne,1836,1814,22
28,14,211405576,14557,Saint-Arnoult,1133,1118,15
28,14,211405584,14558,Saint-Aubin-d'Arquenay,1138,1122,16
28,14,211405592,14559,Saint-Aubin-des-Bois,228,226,2
28,14,211405626,14562,Saint-Aubin-sur-Mer,2198,2162,36
28,14,211405634,14563,Saint-Benoît-d'Hébertot,450,441,9
28,14,211405659,14565,Saint-Côme-de-Fresné,262,259,3
28,14,211405667,14566,Saint-Contest,2564,2515,49
28,14,211405691,14569,Sainte-Croix-sur-Mer,245,239,6
28,14,200058378,14570,Valorbiquet,2559,2517,42
28,14,211405717,14571,Saint-Denis-de-Mailloc,312,306,6
28,14,211405725,14572,Saint-Denis-de-Méré,778,771,7
28,14,211405741,14574,Saint-Désir,1834,1746,88
28,14,211405758,14575,Saint-Étienne-la-Thillaye,402,381,21
28,14,200060408,14576,Val-de-Vie,531,518,13
28,14,211405782,14578,Saint-Gatien-des-Bois,1376,1345,31
28,14,200066447,14579,Seulline,1334,1310,24
28,14,211405824,14582,Saint-Germain-de-Livet,740,718,22
28,14,211405865,14586,Saint-Germain-du-Pert,163,157,6
28,14,211405873,14587,Saint-Germain-la-Blanche-Herbe,2450,2405,45
28,14,211405881,14588,Saint-Germain-Langot,345,343,2
28,14,211405899,14589,Saint-Germain-le-Vasson,966,957,9
28,14,211405907,14590,Sainte-Honorine-de-Ducy,137,136,1
28,14,200073377,14591,Aure sur Mer,731,720,11
28,14,211405923,14592,Sainte-Honorine-du-Fay,1362,1341,21
28,14,211405931,14593,Saint-Hymer,705,692,13
28,14,211405956,14595,Saint-Jean-de-Livet,247,242,5
28,14,211405980,14598,Saint-Jouin,246,241,5
28,14,211406012,14601,Saint-Julien-sur-Calonne,171,167,4
28,14,211406020,14602,Saint-Lambert,272,269,3
28,14,211406038,14603,Saint-Laurent-de-Condel,515,507,8
28,14,211406053,14605,Saint-Laurent-sur-Mer,268,260,8
28,14,211406061,14606,Saint-Léger-Dubosq,226,224,2
28,14,211406079,14607,Saint-Louet-sur-Seulles,142,141,1
28,14,211406095,14609,Saint-Loup-Hors,564,555,9
28,14,211406103,14610,Saint-Manvieu-Norrey,2116,2016,100
28,14,211406137,14613,Saint-Marcouf,91,90,1
28,14,211406145,14614,Sainte-Marguerite-d'Elle,780,771,9
28,14,211406194,14619,Sainte-Marie-Outre-l'Eau,127,125,2
28,14,211406202,14620,Saint-Martin-aux-Chartrains,431,425,6
28,14,211406210,14621,Saint-Martin-de-Bienfaite-la-Cressonnière,478,467,11
28,14,211406228,14622,Saint-Martin-de-Blagny,125,125,0
28,14,211406236,14623,Saint-Martin-de-Fontenay,2564,2519,45
28,14,211406251,14625,Saint-Martin-de-la-Lieue,790,776,14
28,14,211406269,14626,Saint-Martin-de-Mailloc,969,947,22
28,14,211406277,14627,Saint-Martin-de-Mieux,401,393,8
28,14,211406301,14630,Saint-Martin-des-Entrées,734,714,20
28,14,211406350,14635,Saint-Omer,190,189,1
28,14,211406376,14637,Saint-Ouen-du-Mesnil-Oger,212,209,3
28,14,211406392,14639,Saint-Ouen-le-Pin,265,257,8
28,14,211406400,14640,Saint-Pair,245,244,1
28,14,211406434,14643,Saint-Paul-du-Vernay,846,832,14
28,14,211406442,14644,Saint-Philbert-des-Champs,669,655,14
28,14,211406459,14645,Saint-Pierre-Azif,171,162,9
28,14,211406467,14646,Saint-Pierre-Canivet,468,459,9
28,14,211406483,14648,Saint-Pierre-des-Ifs,473,454,19
28,14,211406491,14649,Saint-Pierre-du-Bû,470,464,6
28,14,211406509,14650,Saint-Pierre-du-Fresne,192,188,4
28,14,211406517,14651,Saint-Pierre-du-Jonquet,275,273,2
28,14,211406525,14652,Saint-Pierre-du-Mont,79,77,2
28,14,200064798,14654,Saint-Pierre-en-Auge,7665,7325,340
28,14,211406566,14656,Saint-Rémy,999,985,14
28,14,211406574,14657,Saint-Samson,319,315,4
28,14,200069896,14658,Noues de Sienne,4413,4326,87
28,14,211406590,14659,Saint-Sylvain,1470,1445,25
28,14,211406608,14660,Saint-Vaast-en-Auge,104,101,3
28,14,211406616,14661,Saint-Vaast-sur-Seulles,157,157,0
28,14,211406632,14663,Saint-Vigor-le-Grand,2582,2529,53
28,14,211406640,14664,Sallen,320,316,4
28,14,211406657,14665,Sallenelles,300,296,4
28,14,211406665,14666,Sannerville,1911,1892,19
28,14,211406673,14667,Saon,225,221,4
28,14,211406681,14668,Saonnet,325,323,2
28,14,211406699,14669,Sassy,210,208,2
28,14,200066439,14672,Val de Drôme,895,881,14
28,14,211406749,14674,Soignolles,128,124,4
28,14,211406756,14675,Soliers,2109,2079,30
28,14,211406764,14676,Sommervieu,1010,987,23
28,14,211406772,14677,Soulangy,256,252,4
28,14,211406780,14678,Soumont-Saint-Quentin,598,588,10
28,14,211406798,14679,Subles,682,667,15
28,14,211406806,14680,Sully,166,160,6
28,14,211406814,14681,Surrain,151,147,4
28,14,211406822,14682,Surville,475,463,12
28,14,211406848,14684,Tessel,252,249,3
28,14,211406855,14685,Thaon,1829,1795,34
28,14,211406871,14687,Le Theil-en-Auge,196,193,3
28,14,200060572,14689,Thury-Harcourt-le-Hom,3647,3599,48
28,14,211406921,14692,Tilly-sur-Seulles,1789,1766,23
28,14,211406947,14694,Le Torquesne,561,541,20
28,14,211406988,14698,Touffréville,402,400,2
28,14,211406996,14699,Touques,3807,3744,63
28,14,211407002,14700,Tour-en-Bessin,682,674,8
28,14,211407010,14701,Tourgéville,818,803,15
28,14,211407051,14705,Tournières,150,149,1
28,14,211407069,14706,Tourville-en-Auge,252,246,6
28,14,211407077,14707,Tourville-sur-Odon,1128,1115,13
28,14,211407085,14708,Tracy-Bocage,305,298,7
28,14,211407093,14709,Tracy-sur-Mer,352,345,7
28,14,211407101,14710,Tréprel,103,103,0
28,14,211407119,14711,Trévières,928,918,10
28,14,211407127,14712,Troarn,3526,3435,91
28,14,200083137,14713,Montillières-sur-Orne,583,572,11
28,14,211407143,14714,Le Tronquay,794,783,11
28,14,211407150,14715,Trouville-sur-Mer,4689,4603,86
28,14,211407168,14716,Trungy,214,211,3
28,14,211407192,14719,Urville,731,725,6
28,14,211407200,14720,Ussy,880,852,28
28,14,211407218,14721,Vacognes-Neuilly,666,659,7
28,14,211407234,14723,Valsemé,271,267,4
28,14,211407242,14724,Varaville,1031,1019,12
28,14,200054641,14726,Valdallière,5839,5735,104
28,14,211407283,14728,Vaucelles,587,580,7
28,14,211407317,14731,Vauville,205,193,12
28,14,211407325,14732,Vaux-sur-Aure,310,299,11
28,14,211407333,14733,Vaux-sur-Seulles,326,317,9
28,14,211407341,14734,Vendes,340,332,8
28,14,211407358,14735,Vendeuvre,818,807,11
28,14,211407374,14737,Versainville,508,498,10
28,14,211407382,14738,Verson,3710,3657,53
28,14,211407390,14739,Ver-sur-Mer,1684,1648,36
28,14,200060507,14740,La Vespière-Friardel,1207,1181,26
28,14,211407416,14741,Le Vey,122,119,3
28,14,211407424,14742,Vicques,73,73,0
28,14,211407432,14743,Victot-Pontfol,88,85,3
28,14,211407440,14744,Vienne-en-Bessin,292,288,4
28,14,211407457,14745,Vierville-sur-Mer,235,231,4
28,14,211407473,14747,Vieux,683,675,8
28,14,211407481,14748,Vieux-Bourg,77,76,1
28,14,211407515,14751,Vignats,300,292,8
28,14,211407523,14752,Villers-Bocage,3187,3147,40
28,14,211407531,14753,Villers-Canivet,762,740,22
28,14,211407549,14754,Villers-sur-Mer,2559,2507,52
28,14,211407556,14755,Villerville,603,591,12
28,14,211407564,14756,La Villette,236,233,3
28,14,211407580,14758,Villons-les-Buissons,814,796,18
28,14,211407598,14759,Villy-lez-Falaise,275,265,10
28,14,211407606,14760,Villy-Bocage,739,733,6
28,14,211407614,14761,Vimont,841,826,15
28,14,200060176,14762,Vire Normandie,17784,16935,849
28,14,211407648,14764,Pont-d'Ouilly,974,961,13
84,15,211500012,15001,Allanche,806,796,10
84,15,211500020,15002,Alleuze,227,223,4
84,15,211500038,15003,Ally,610,599,11
84,15,211500046,15004,Andelat,483,474,9
84,15,211500053,15005,Anglards-de-Saint-Flour,381,369,12
84,15,211500061,15006,Anglards-de-Salers,731,708,23
84,15,211500079,15007,Anterrieux,127,122,5
84,15,211500087,15008,Antignac,291,284,7
84,15,211500095,15009,Apchon,190,186,4
84,15,211500103,15010,Arches,199,196,3
84,15,211500111,15011,Arnac,185,182,3
84,15,211500129,15012,Arpajon-sur-Cère,6509,6313,196
84,15,211500137,15013,Auriac-l'Église,146,145,1
84,15,211500145,15014,Aurillac,26973,25703,1270
84,15,211500152,15015,Auzers,169,166,3
84,15,211500160,15016,Ayrens,639,625,14
84,15,211500178,15017,Badailhac,147,140,7
84,15,211500186,15018,Barriac-les-Bosquets,137,136,1
84,15,211500194,15019,Bassignac,229,225,4
84,15,211500202,15020,Beaulieu,93,93,0
84,15,211500210,15021,Boisset,663,644,19
84,15,211500228,15022,Bonnac,167,162,5
84,15,211500244,15024,Brageac,76,76,0
84,15,211500251,15025,Albepierre-Bredons,245,237,8
84,15,211500269,15026,Brezons,184,183,1
84,15,200086494,15027,Puycapel,753,739,14
84,15,211500285,15028,Carlat,373,367,6
84,15,211500293,15029,Cassaniouze,521,505,16
84,15,211500301,15030,Cayrols,308,295,13
84,15,211500327,15032,Celoux,61,58,3
84,15,211500335,15033,Cézens,218,214,4
84,15,211500343,15034,Chaliers,149,143,6
84,15,211500368,15036,Chalvignac,479,471,8
84,15,211500376,15037,Champagnac,1062,1040,22
84,15,211500384,15038,Champs-sur-Tarentaine-Marchal,1030,1015,15
84,15,211500400,15040,Chanterelle,105,99,6
84,15,211500418,15041,La Chapelle-d'Alagnon,258,254,4
84,15,211500426,15042,La Chapelle-Laurent,253,249,4
84,15,211500434,15043,Charmensac,84,82,2
84,15,211500459,15045,Chaudes-Aigues,829,818,11
84,15,211500467,15046,Chaussenac,223,219,4
84,15,211500483,15048,Chazelles,31,30,1
84,15,211500491,15049,Cheylade,228,222,6
84,15,211500509,15050,Le Claux,169,166,3
84,15,211500517,15051,Clavières,215,210,5
84,15,211500525,15052,Collandres,167,157,10
84,15,211500533,15053,Coltines,442,433,9
84,15,211500541,15054,Condat,1014,985,29
84,15,211500558,15055,Coren,458,444,14
84,15,211500566,15056,Crandelles,881,861,20
84,15,211500574,15057,Cros-de-Montvert,191,187,4
84,15,211500582,15058,Cros-de-Ronesque,147,146,1
84,15,211500590,15059,Cussac,129,122,7
84,15,211500608,15060,Deux-Verges,53,52,1
84,15,211500616,15061,Dienne,266,261,5
84,15,211500632,15063,Drugeac,336,323,13
84,15,211500640,15064,Escorailles,85,84,1
84,15,211500657,15065,Espinasse,78,77,1
84,15,211500665,15066,Le Falgoux,120,118,2
84,15,211500673,15067,Le Fau,28,28,0
84,15,211500699,15069,Ferrières-Saint-Mary,250,244,6
84,15,211500707,15070,Fontanges,203,201,2
84,15,211500723,15072,Freix-Anglards,229,220,9
84,15,211500731,15073,Fridefont,95,93,2
84,15,211500749,15074,Giou-de-Mamou,773,752,21
84,15,211500756,15075,Girgols,77,73,4
84,15,211500764,15076,Glénat,174,170,4
84,15,211500772,15077,Gourdièges,63,63,0
84,15,211500780,15078,Jabrun,160,158,2
84,15,211500798,15079,Jaleyrac,378,368,10
84,15,211500806,15080,Joursac,151,146,5
84,15,211500814,15081,Jou-sous-Monjou,98,96,2
84,15,211500822,15082,Junhac,304,293,11
84,15,211500830,15083,Jussac,2092,2027,65
84,15,211500848,15084,Labesserette,300,291,9
84,15,211500855,15085,Labrousse,500,488,12
84,15,211500863,15086,Lacapelle-Barrès,59,58,1
84,15,211500871,15087,Lacapelle-del-Fraisse,379,368,11
84,15,211500889,15088,Lacapelle-Viescamp,522,508,14
84,15,211500897,15089,Ladinhac,457,444,13
84,15,211500905,15090,Lafeuillade-en-Vézie,607,592,15
84,15,211500913,15091,Landeyrat,95,91,4
84,15,211500921,15092,Lanobre,1403,1386,17
84,15,211500939,15093,Lapeyrugue,103,100,3
84,15,211500947,15094,Laroquebrou,820,804,16
84,15,211500954,15095,Laroquevieille,355,352,3
84,15,211500962,15096,Lascelle,286,279,7
84,15,211500970,15097,Lastic,115,110,5
84,15,211500988,15098,Laurie,90,90,0
84,15,211501002,15100,Laveissenet,133,131,2
84,15,211501010,15101,Laveissière,527,517,10
84,15,211501028,15102,Lavigerie,108,108,0
84,15,211501036,15103,Leucamp,245,239,6
84,15,211501044,15104,Leynhac,362,351,11
84,15,211501051,15105,Leyvaux,37,34,3
84,15,211501069,15106,Lieutadès,163,161,2
84,15,211501077,15107,Lorcières,174,170,4
84,15,200054104,15108,Val d'Arcomie,1016,994,22
84,15,211501101,15110,Lugarde,129,122,7
84,15,211501119,15111,Madic,216,209,7
84,15,211501127,15112,Malbo,94,90,4
84,15,211501135,15113,Mandailles-Saint-Julien,184,180,4
84,15,211501143,15114,Marcenat,522,514,8
84,15,211501168,15116,Marchastel,151,147,4
84,15,211501176,15117,Marcolès,655,585,70
84,15,211501184,15118,Marmanhac,753,722,31
84,15,211501192,15119,Massiac,1869,1801,68
84,15,211501200,15120,Mauriac,3701,3489,212
84,15,211501218,15121,Maurines,109,108,1
84,15,211501226,15122,Maurs,2168,2107,61
84,15,211501234,15123,Méallet,161,161,0
84,15,211501242,15124,Menet,555,531,24
84,15,211501259,15125,Mentières,133,130,3
84,15,211501267,15126,Molèdes,83,80,3
84,15,211501275,15127,Molompize,283,278,5
84,15,211501283,15128,La Monselie,123,122,1
84,15,211501291,15129,Montboudif,172,166,6
84,15,211501309,15130,Montchamp,147,143,4
84,15,211501317,15131,Le Monteil,292,284,8
84,15,211501325,15132,Montgreleix,42,41,1
84,15,211501333,15133,Montmurat,136,134,2
84,15,211501341,15134,Montsalvy,823,812,11
84,15,211501358,15135,Montvert,120,114,6
84,15,211501374,15137,Moussages,265,262,3
84,15,200071702,15138,Murat,1913,1815,98
84,15,211501390,15139,Narnhac,68,68,0
84,15,211501408,15140,Naucelles,2178,2116,62
84,15,200065175,15141,Neussargues en Pinatelle,1765,1728,37
84,15,200065191,15142,Neuvéglise-sur-Truyère,1764,1720,44
84,15,211501432,15143,Nieudan,102,101,1
84,15,211501440,15144,Omps,335,325,10
84,15,211501465,15146,Pailherols,129,124,5
84,15,211501473,15147,Parlan,465,457,8
84,15,211501481,15148,Paulhac,442,430,12
84,15,211501499,15149,Paulhenc,261,258,3
84,15,211501515,15151,Peyrusse,148,148,0
84,15,211501523,15152,Pierrefort,924,905,19
84,15,211501531,15153,Pleaux,1488,1454,34
84,15,211501549,15154,Polminhac,1219,1195,24
84,15,211501556,15155,Pradiers,86,85,1
84,15,211501564,15156,Prunet,701,685,16
84,15,211501572,15157,Quézac,397,355,42
84,15,211501580,15158,Rageade,105,103,2
84,15,211501598,15159,Raulhac,278,269,9
84,15,211502919,15160,Reilhac,1111,1089,22
84,15,211501614,15161,Rézentières,111,108,3
84,15,211501622,15162,Riom-ès-Montagnes,2494,2454,40
84,15,211501630,15163,Roannes-Saint-Mary,1143,1109,34
84,15,211501648,15164,Roffiac,629,605,24
84,15,211501655,15165,Rouffiac,207,203,4
84,15,211501663,15166,Roumégoux,326,316,10
84,15,211501671,15167,Rouziers,123,115,8
84,15,211501689,15168,Ruynes-en-Margeride,737,712,25
84,15,211501697,15169,Saignes,835,821,14
84,15,211501705,15170,Saint-Amandin,234,232,2
84,15,211501721,15172,Saint-Antoine,91,91,0
84,15,211501739,15173,Saint-Bonnet-de-Condat,120,115,5
84,15,211501747,15174,Saint-Bonnet-de-Salers,273,270,3
84,15,211501754,15175,Saint-Cernin,1085,1062,23
84,15,211501762,15176,Saint-Chamant,247,239,8
84,15,211501788,15178,Saint-Cirgues-de-Jordanne,150,143,7
84,15,211501796,15179,Saint-Cirgues-de-Malbert,252,249,3
84,15,211501804,15180,Saint-Clément,79,75,4
84,15,200057503,15181,Saint-Constant-Fournoulès,585,574,11
84,15,211501820,15182,Saint-Étienne-Cantalès,132,130,2
84,15,211501838,15183,Saint-Étienne-de-Carlat,135,135,0
84,15,211501846,15184,Saint-Étienne-de-Maurs,801,782,19
84,15,211501853,15185,Saint-Étienne-de-Chomeil,253,246,7
84,15,211501861,15186,Sainte-Eulalie,234,231,3
84,15,211501879,15187,Saint-Flour,6992,6451,541
84,15,211501887,15188,Saint-Georges,1217,1190,27
84,15,211501895,15189,Saint-Gérons,230,224,6
84,15,211501903,15190,Saint-Hippolyte,100,98,2
84,15,211501911,15191,Saint-Illide,646,635,11
84,15,211501929,15192,Saint-Jacques-des-Blats,295,291,4
84,15,211501945,15194,Saint-Julien-de-Toursac,110,103,7
84,15,211501960,15196,Saint-Mamet-la-Salvetat,1601,1546,55
84,15,211501986,15198,Sainte-Marie,111,109,2
84,15,211501994,15199,Saint-Martial,72,72,0
84,15,211502000,15200,Saint-Martin-Cantalès,150,147,3
84,15,211502018,15201,Saint-Martin-sous-Vigouroux,226,223,3
84,15,211502026,15202,Saint-Martin-Valmeroux,723,708,15
84,15,211502034,15203,Saint-Mary-le-Plain,188,182,6
84,15,211502042,15204,Saint-Paul-des-Landes,1581,1536,45
84,15,211502059,15205,Saint-Paul-de-Salers,109,105,4
84,15,211502067,15206,Saint-Pierre,144,143,1
84,15,211502075,15207,Saint-Poncy,360,354,6
84,15,211502083,15208,Saint-Projet-de-Salers,137,133,4
84,15,211502091,15209,Saint-Rémy-de-Chaudes-Aigues,128,123,5
84,15,211502117,15211,Saint-Santin-Cantalès,299,294,5
84,15,211502125,15212,Saint-Santin-de-Maurs,371,361,10
84,15,211502133,15213,Saint-Saturnin,208,202,6
84,15,211502141,15214,Saint-Saury,179,174,5
84,15,211502158,15215,Saint-Simon,1164,1127,37
84,15,211502166,15216,Saint-Urcize,412,398,14
84,15,211502174,15217,Saint-Victor,109,106,3
84,15,211502182,15218,Saint-Vincent-de-Salers,71,69,2
84,15,211502190,15219,Salers,327,321,6
84,15,211502208,15220,Salins,145,143,2
84,15,211502216,15221,Sansac-de-Marmiesse,1394,1352,42
84,15,211502224,15222,Sansac-Veinazès,219,212,7
84,15,211502232,15223,Sauvat,220,214,6
84,15,211502240,15224,La Ségalassière,136,129,7
84,15,211502257,15225,Ségur-les-Villas,221,217,4
84,15,211502265,15226,Sénezergues,213,209,4
84,15,211502281,15228,Siran,471,460,11
84,15,211502299,15229,Soulages,83,81,2
84,15,211502307,15230,Sourniac,206,197,9
84,15,211502315,15231,Talizat,629,602,27
84,15,211502323,15232,Tanavelle,234,225,9
84,15,211502331,15233,Teissières-de-Cornet,309,304,5
84,15,211502349,15234,Teissières-lès-Bouliès,336,330,6
84,15,211502356,15235,Les Ternes,592,568,24
84,15,211502364,15236,Thiézac,617,602,15
84,15,211502372,15237,Tiviers,181,170,11
84,15,211502380,15238,Tournemire,130,127,3
84,15,211502406,15240,Trémouille,179,172,7
84,15,211502414,15241,La Trinitat,51,48,3
84,15,211502422,15242,Le Trioulou,103,101,2
84,15,211502430,15243,Trizac,496,482,14
84,15,211502448,15244,Ussel,478,468,10
84,15,211502455,15245,Vabres,254,250,4
84,15,211502463,15246,Valette,242,239,3
84,15,211502471,15247,Valjouze,23,23,0
84,15,211502489,15248,Valuéjols,574,563,11
84,15,211502497,15249,Le Vaulmier,62,60,2
84,15,211502505,15250,Vebret,529,511,18
84,15,211502513,15251,Védrines-Saint-Loup,140,134,6
84,15,211502521,15252,Velzic,422,404,18
84,15,211502539,15253,Vernols,67,65,2
84,15,211502547,15254,Veyrières,124,120,4
84,15,211502554,15255,Vézac,1304,1269,35
84,15,211502562,15256,Vèze,58,56,2
84,15,211502570,15257,Vezels-Roussy,132,127,5
84,15,211502588,15258,Vic-sur-Cère,1899,1862,37
84,15,211502596,15259,Vieillespesse,244,241,3
84,15,211502604,15260,Vieillevie,111,107,4
84,15,211502612,15261,Le Vigean,846,827,19
84,15,211502620,15262,Villedieu,575,563,12
84,15,211502638,15263,Virargues,122,119,3
84,15,211502646,15264,Vitrac,274,268,6
84,15,211502653,15265,Ydes,1657,1632,25
84,15,211502661,15266,Yolet,575,565,10
84,15,211502679,15267,Ytrac,4436,4329,107
84,15,200057487,15268,Le Rouget-Pers,1293,1268,25
84,15,211502695,15269,Besse,132,129,3
75,16,211600010,16001,Abzac,508,507,1
75,16,211600028,16002,Les Adjots,542,526,16
75,16,211600036,16003,Agris,869,859,10
75,16,200083251,16005,Aigre,1615,1595,20
75,16,211600077,16007,Alloue,480,469,11
75,16,211600085,16008,Ambérac,308,306,2
75,16,211600093,16009,Ambernac,385,379,6
75,16,211600119,16011,Anais,584,563,21
75,16,211600127,16012,Angeac-Champagne,507,498,9
75,16,211600135,16013,Angeac-Charente,321,313,8
75,16,211600143,16014,Angeduc,134,133,1
75,16,211600150,16015,Angoulême,43079,41407,1672
75,16,211600168,16016,Ansac-sur-Vienne,842,825,17
75,16,211600184,16018,Ars,722,704,18
75,16,211600192,16019,Asnières-sur-Nouère,1287,1265,22
75,16,211600200,16020,Aubeterre-sur-Dronne,333,329,4
75,16,200062784,16023,Aunac-sur-Charente,585,574,11
75,16,211600242,16024,Aussac-Vadalle,527,518,9
75,16,211600259,16025,Baignes-Sainte-Radegonde,1266,1235,31
75,16,211600267,16026,Balzac,1397,1371,26
75,16,211600275,16027,Barbezières,132,130,2
75,16,211600283,16028,Barbezieux-Saint-Hilaire,4924,4751,173
75,16,211600291,16029,Bardenac,230,225,5
75,16,211600309,16030,Barret,1085,1063,22
75,16,211600317,16031,Barro,420,409,11
75,16,211600325,16032,Bassac,524,517,7
75,16,211600341,16034,Bazac,147,145,2
75,16,211600358,16035,Beaulieu-sur-Sonnette,202,197,5
75,16,211600366,16036,Bécheresse,300,291,9
75,16,211600374,16037,Bellon,145,140,5
75,16,211600382,16038,Benest,315,307,8
75,16,211600390,16039,Bernac,484,472,12
75,16,211600408,16040,Berneuil,316,310,6
75,16,211600416,16041,Bessac,114,113,1
75,16,211600424,16042,Bessé,113,108,5
75,16,211600440,16044,Bioussac,216,209,7
75,16,211600457,16045,Birac,374,369,5
75,16,200083129,16046,Coteaux-du-Blanzacais,1013,997,16
75,16,211600473,16047,Blanzaguet-Saint-Cybard,294,287,7
75,16,211600481,16048,Boisbreteau,127,127,0
75,16,211600499,16049,Bonnes,376,368,8
75,16,211600507,16050,Bonneuil,255,247,8
75,16,211600523,16052,Bors (Canton de Tude-et-Lavalette),238,235,3
75,16,211600531,16053,Bors (Canton de Charente-Sud),121,120,1
75,16,211600549,16054,Le Bouchage,176,175,1
75,16,211600556,16055,Bouëx,897,884,13
75,16,211600564,16056,Bourg-Charente,900,884,16
75,16,211600572,16057,Bouteville,328,322,6
75,16,211600580,16058,Boutiers-Saint-Trojan,1455,1405,50
75,16,211600598,16059,Brettes,172,166,6
75,16,211600606,16060,Bréville,461,449,12
75,16,211600614,16061,Brie,4302,4222,80
75,16,211600622,16062,Brie-sous-Barbezieux,130,128,2
75,16,211600630,16063,Brie-sous-Chalais,161,161,0
75,16,211600648,16064,Brigueuil,1122,1110,12
75,16,211600655,16065,Brillac,632,626,6
75,16,211600663,16066,Brossac,471,462,9
75,16,211600671,16067,Bunzac,473,464,9
75,16,211600689,16068,Cellefrouin,577,571,6
75,16,211600697,16069,Cellettes,388,385,3
75,16,211600705,16070,Chabanais,1591,1561,30
75,16,211600713,16071,Chabrac,613,598,15
75,16,211600721,16072,Chadurie,523,513,10
75,16,211600739,16073,Chalais,1816,1786,30
75,16,211600747,16074,Challignac,344,336,8
75,16,211600754,16075,Champagne-Vigny,245,241,4
75,16,211600762,16076,Champagne-Mouton,888,879,9
75,16,211600770,16077,Champmillon,491,482,9
75,16,211600788,16078,Champniers,5271,5155,116
75,16,211600796,16079,Chantillac,358,356,2
75,16,211600812,16081,La Chapelle,220,215,5
75,16,200056992,16082,Boisné-La Tude,680,667,13
75,16,211600838,16083,Charmé,344,338,6
75,16,211600846,16084,Charras,342,338,4
75,16,211600853,16085,Chasseneuil-sur-Bonnieure,3381,3100,281
75,16,211600861,16086,Chassenon,874,857,17
75,16,211600879,16087,Chassiecq,148,144,4
75,16,211600887,16088,Chassors,1135,1097,38
75,16,211600895,16089,Châteaubernard,3831,3766,65
75,16,211600903,16090,Châteauneuf-sur-Charente,3603,3546,57
75,16,211600911,16091,Châtignac,174,172,2
75,16,211600937,16093,Chazelles,1600,1575,25
75,16,211600952,16095,Chenon,132,128,4
75,16,211600960,16096,Cherves-Châtelars,423,420,3
75,16,211600978,16097,Cherves-Richemont,2394,2293,101
75,16,211600986,16098,La Chèvrerie,140,139,1
75,16,211600994,16099,Chillac,224,223,1
75,16,211601000,16100,Chirac,789,775,14
75,16,211601018,16101,Claix,1082,1064,18
75,16,211601026,16102,Cognac,19030,18606,424
75,16,211601034,16103,Combiers,126,122,4
75,16,211601042,16104,Condac,477,468,9
75,16,211601059,16105,Condéon,632,616,16
75,16,200054047,16106,Confolens,2873,2720,153
75,16,211601075,16107,Coulgens,547,541,6
75,16,211601083,16108,Coulonges,131,130,1
75,16,211601091,16109,Courbillac,762,751,11
75,16,200086429,16110,Courcôme,797,776,21
75,16,211601117,16111,Courgeac,176,174,2
75,16,211601125,16112,Courlac,59,57,2
75,16,211601133,16113,La Couronne,8000,7742,258
75,16,211601141,16114,Couture,170,167,3
75,16,211601166,16116,Criteuil-la-Magdeleine,391,381,10
75,16,211601174,16117,Curac,123,120,3
75,16,211601182,16118,Deviat,135,135,0
75,16,211601190,16119,Dignac,1371,1356,15
75,16,211601208,16120,Dirac,1543,1521,22
75,16,211601216,16121,Douzat,447,434,13
75,16,211601224,16122,Ébréon,142,138,4
75,16,211601232,16123,Échallat,493,483,10
75,16,211601240,16124,Écuras,568,558,10
75,16,211601257,16125,Édon,271,268,3
75,16,211601273,16127,Empuré,97,94,3
75,16,211601281,16128,Épenède,175,169,6
75,16,211601307,16130,Les Essards,190,183,7
75,16,211601315,16131,Esse,508,501,7
75,16,211601323,16132,Étagnac,1004,996,8
75,16,211601331,16133,Étriac,202,199,3
75,16,211601349,16134,Exideuil-sur-Vienne,1039,1013,26
75,16,211601356,16135,Eymouthiers,313,312,1
75,16,211601364,16136,La Faye,584,572,12
75,16,211601372,16137,Feuillade,305,303,2
75,16,211601380,16138,Fléac,3970,3865,105
75,16,211601398,16139,Fleurac,241,239,2
75,16,211601414,16141,Fontenille,333,322,11
75,16,211601422,16142,La Forêt-de-Tessé,209,205,4
75,16,211601430,16143,Fouquebrune,717,704,13
75,16,211601448,16144,Fouqueure,433,428,5
75,16,211601455,16145,Foussignac,661,641,20
75,16,211601463,16146,Garat,2158,2124,34
75,16,211601471,16147,Gardes-le-Pontaroux,265,259,6
75,16,200058196,16148,Genac-Bignac,1019,999,20
75,16,211601505,16150,Gensac-la-Pallue,1631,1589,42
75,16,211601513,16151,Genté,906,886,20
75,16,211601521,16152,Gimeux,739,719,20
75,16,200083285,16153,Mainxe-Gondeville,1193,1171,22
75,16,211601547,16154,Gond-Pontouvre,6116,6017,99
75,16,211601554,16155,Les Gours,108,105,3
75,16,211601570,16157,Le Grand-Madieu,159,156,3
75,16,211601588,16158,Grassac,310,305,5
75,16,211601604,16160,Guimps,491,485,6
75,16,211601612,16161,Guizengeard,167,163,4
75,16,211601620,16162,Gurat,183,183,0
75,16,211601638,16163,Hiersac,1174,1152,22
75,16,211601646,16164,Hiesse,243,241,2
75,16,211601653,16165,Houlette,382,376,6
75,16,211601661,16166,L'Isle-d'Espagnac,5751,5633,118
75,16,211601679,16167,Jarnac,4580,4447,133
75,16,211601687,16168,Jauldes,823,816,7
75,16,211601695,16169,Javrezac,580,569,11
75,16,211601703,16170,Juignac,397,395,2
75,16,211601711,16171,Juillac-le-Coq,666,652,14
75,16,211601737,16173,Juillé,185,181,4
75,16,211601745,16174,Julienne,527,516,11
75,16,200054187,16175,Val des Vignes,1402,1371,31
75,16,211601760,16176,Lachaise,306,299,7
75,16,211601778,16177,Ladiville,120,118,2
75,16,211601786,16178,Lagarde-sur-le-Né,192,187,5
75,16,211601802,16180,Laprade,253,247,6
75,16,211601810,16181,Lessac,532,521,11
75,16,211601828,16182,Lesterps,457,444,13
75,16,211601836,16183,Lésignac-Durand,177,173,4
75,16,211601844,16184,Lichères,87,86,1
75,16,211601851,16185,Ligné,156,154,2
75,16,200096444,16186,Lignières-Ambleville,733,712,21
75,16,211601877,16187,Linars,2144,2096,48
75,16,211601885,16188,Le Lindois,343,339,4
75,16,211601893,16189,Londigny,260,254,6
75,16,211601901,16190,Longré,192,186,6
75,16,211601919,16191,Lonnes,182,181,1
75,16,200083350,16192,Terres-de-Haute-Charente,3971,3867,104
75,16,211601935,16193,Louzac-Saint-André,1007,991,16
75,16,211601943,16194,Lupsault,111,110,1
75,16,211601950,16195,Lussac,302,294,8
75,16,211601968,16196,Luxé,728,720,8
75,16,211601976,16197,La Magdeleine,121,114,7
75,16,211601984,16198,Magnac-Lavalette-Villars,463,459,4
75,16,211601992,16199,Magnac-sur-Touvre,3286,3223,63
75,16,211602008,16200,Maine-de-Boixe,485,481,4
75,16,211602032,16203,Mainzac,119,119,0
75,16,200062941,16204,Bellevigne,1315,1282,33
75,16,211602057,16205,Manot,540,535,5
75,16,200099455,16206,Mansle-les-Fontaines,2142,2117,25
75,16,211602073,16207,Marcillac-Lanville,495,486,9
75,16,211602081,16208,Mareuil,397,393,4
75,16,211602099,16209,Marillac-le-Franc,843,824,19
75,16,211602107,16210,Marsac,823,815,8
75,16,211602115,16211,Marthon,566,560,6
75,16,211602123,16212,Massignac,395,389,6
75,16,211602131,16213,Mazerolles,302,297,5
75,16,211602156,16215,Médillac,159,154,5
75,16,211602164,16216,Mérignac,847,833,14
75,16,211602172,16217,Merpins,1124,1100,24
75,16,211602180,16218,Mesnac,424,411,13
75,16,211602206,16220,Les Métairies,735,720,15
75,16,211602214,16221,Mons,237,234,3
75,16,211602222,16222,Montboyer,328,323,5
75,16,211602230,16223,Montbron,2031,2001,30
75,16,200058212,16224,Montmérac,735,717,18
75,16,211602255,16225,Montemboeuf,683,653,30
75,16,211602263,16226,Montignac-Charente,721,712,9
75,16,211602271,16227,Montignac-le-Coq,140,140,0
75,16,211602297,16229,Montjean,248,244,4
75,16,200063105,16230,Montmoreau,2604,2517,87
75,16,211602313,16231,Montrollet,326,324,2
75,16,211602321,16232,Mornac,2185,2137,48
75,16,200094738,16233,Mosnac-Saint-Simeux,1019,1002,17
75,16,211602347,16234,Moulidars,720,708,12
75,16,211602362,16236,Mouthiers-sur-Boëme,2450,2377,73
75,16,211602370,16237,Mouton,224,222,2
75,16,211602388,16238,Moutonneau,118,118,0
75,16,211602396,16239,Mouzon,138,136,2
75,16,211602404,16240,Nabinaud,100,100,0
75,16,211602412,16241,Nanclars,211,207,4
75,16,211602420,16242,Nanteuil-en-Vallée,1398,1381,17
75,16,211602438,16243,Nercillac,1068,1047,21
75,16,211602446,16244,Nersac,2367,2314,53
75,16,211602453,16245,Nieuil,932,918,14
75,16,211602461,16246,Nonac,264,256,8
75,16,211602487,16248,Oradour,152,150,2
75,16,211602495,16249,Oradour-Fanais,388,385,3
75,16,211602503,16250,Orgedeuil,218,216,2
75,16,211602511,16251,Oriolles,257,250,7
75,16,211602529,16252,Orival,152,151,1
75,16,211602537,16253,Paizay-Naudouin-Embourie,365,362,3
75,16,211602545,16254,Palluaud,225,217,8
75,16,211602552,16255,Parzac,144,139,5
75,16,211602560,16256,Passirac,248,244,4
75,16,211602586,16258,Pérignac,503,494,9
75,16,211602602,16260,Pillac,280,273,7
75,16,211602610,16261,Les Pins,493,479,14
75,16,211602636,16263,Plassac-Rouffiac,401,396,5
75,16,211602644,16264,Pleuville,326,320,6
75,16,211602677,16267,Poullignac,95,94,1
75,16,211602685,16268,Poursac,216,214,2
75,16,211602693,16269,Pranzac,913,902,11
75,16,211602701,16270,Pressignac,345,340,5
75,16,211602719,16271,Puymoyen,2515,2382,133
75,16,211602727,16272,Puyréaux,564,555,9
75,16,211602735,16273,Raix,127,121,6
75,16,211602750,16275,Ranville-Breuillaud,179,177,2
75,16,211602768,16276,Reignac,752,741,11
75,16,211602776,16277,Réparsac,600,589,11
75,16,211602792,16279,Rioux-Martin,228,225,3
75,16,211602800,16280,Rivières,2036,2007,29
75,16,200083293,16281,La Rochefoucauld-en-Angoumois,4113,3984,129
75,16,211602826,16282,La Rochette,544,533,11
75,16,211602834,16283,Ronsenac,578,570,8
75,16,211602842,16284,Rouffiac,121,120,1
75,16,211602859,16285,Rougnac,411,406,5
75,16,200085249,16286,Rouillac,2983,2940,43
75,16,211602875,16287,Roullet-Saint-Estèphe,4363,4295,68
75,16,211602891,16289,Roussines,302,299,3
75,16,211602909,16290,Rouzède,241,239,2
75,16,211602917,16291,Ruelle-sur-Touvre,7559,7364,195
75,16,211602925,16292,Ruffec,3520,3370,150
75,16,211602933,16293,Saint-Adjutory,497,491,6
75,16,211602958,16295,Saint-Amant-de-Boixe,1346,1322,24
75,16,211604277,16297,Graves-Saint-Amant,336,327,9
75,16,211602982,16298,Saint-Amant-de-Nouère,362,357,5
75,16,200076933,16300,Val-de-Bonnieure,1330,1318,12
75,16,211603014,16301,Saint-Aulais-la-Chapelle,230,226,4
75,16,211603022,16302,Saint-Avit,219,217,2
75,16,211603030,16303,Saint-Bonnet,418,406,12
75,16,211603048,16304,Saint-Brice,984,965,19
75,16,211603063,16306,Saint-Christophe,322,314,8
75,16,211603071,16307,Saint-Ciers-sur-Bonnieure,339,327,12
75,16,211603089,16308,Saint-Claud,1066,1047,19
75,16,211603105,16310,Saint-Coutant,217,215,2
75,16,211603121,16312,Saint-Cybardeaux,833,821,12
75,16,211603154,16315,Saint-Félix,105,105,0
75,16,211603162,16316,Saint-Fort-sur-le-Né,392,386,6
75,16,211603170,16317,Saint-Fraigne,438,436,2
75,16,211603188,16318,Saint-Front,366,364,2
75,16,211603204,16320,Saint-Genis-d'Hiersac,909,895,14
75,16,211603212,16321,Saint-Georges,45,45,0
75,16,211603238,16323,Saint-Germain-de-Montbron,478,468,10
75,16,211603253,16325,Saint-Gourson,131,128,3
75,16,211603261,16326,Saint-Groux,134,134,0
75,16,211603295,16329,Saint-Laurent-de-Céris,774,763,11
75,16,211603303,16330,Saint-Laurent-de-Cognac,852,824,28
75,16,211603311,16331,Saint-Laurent-des-Combes,92,90,2
75,16,211603345,16334,Saint-Martial,126,123,3
75,16,211603352,16335,Saint-Martin-du-Clocher,127,124,3
75,16,211603360,16336,Saint-Mary,345,343,2
75,16,211603378,16337,Saint-Maurice-des-Lions,929,899,30
75,16,211603386,16338,Saint-Médard,320,315,5
75,16,200085611,16339,Val-d'Auge,818,802,16
75,16,211603402,16340,Saint-Même-les-Carrières,1055,1028,27
75,16,211603410,16341,Saint-Michel,3263,3225,38
75,16,211603428,16342,Saint-Palais-du-Né,311,304,7
75,16,211603436,16343,Saint-Preuil,304,295,9
75,16,211603451,16345,Saint-Quentin-sur-Charente,217,212,5
75,16,211603469,16346,Saint-Quentin-de-Chalais,256,247,9
75,16,211603477,16347,Saint-Romain,522,511,11
75,16,211603485,16348,Saint-Saturnin,1321,1288,33
75,16,211603493,16349,Sainte-Sévère,519,508,11
75,16,211603501,16350,Saint-Séverin,813,803,10
75,16,211603527,16352,Saint-Simon,231,223,8
75,16,211603535,16353,Saint-Sornin,813,802,11
75,16,211603543,16354,Sainte-Souline,127,124,3
75,16,211603550,16355,Saint-Sulpice-de-Cognac,1202,1186,16
75,16,211603568,16356,Saint-Sulpice-de-Ruffec,32,32,0
75,16,211603576,16357,Saint-Vallier,140,138,2
75,16,211603584,16358,Saint-Yrieix-sur-Charente,7740,7499,241
75,16,211603592,16359,Salles-d'Angles,1037,1010,27
75,16,211603600,16360,Salles-de-Barbezieux,488,403,85
75,16,211603618,16361,Salles-de-Villefagnan,319,313,6
75,16,211603626,16362,Salles-Lavalette,333,321,12
75,16,211603634,16363,Saulgond,538,529,9
75,16,211603642,16364,Sauvagnac,68,66,2
75,16,211603659,16365,Sauvignac,105,103,2
75,16,211603667,16366,Segonzac,2153,2076,77
75,16,211603683,16368,Sers,915,895,20
75,16,211603691,16369,Sigogne,997,976,21
75,16,211603709,16370,Sireuil,1197,1157,40
75,16,211603725,16372,Souffrignac,136,135,1
75,16,211603733,16373,Souvigné,198,192,6
75,16,211603741,16374,Soyaux,10278,9969,309
75,16,211603758,16375,Suaux,390,384,6
75,16,211603774,16377,La Tâche,114,112,2
75,16,211603782,16378,Taizé-Aizie,588,573,15
75,16,211603790,16379,Taponnat-Fleurignac,1504,1477,27
75,16,211603808,16380,Le Tâtre,420,417,3
75,16,211603816,16381,Theil-Rabier,168,166,2
75,16,211603824,16382,Torsac,748,718,30
75,16,211603832,16383,Tourriers,784,774,10
75,16,211603840,16384,Touvérac,572,565,7
75,16,211603857,16385,Touvre,1178,1151,27
75,16,211603873,16387,Triac-Lautrait,523,463,60
75,16,211603881,16388,Trois-Palis,955,933,22
75,16,211603899,16389,Turgon,88,85,3
75,16,211603907,16390,Tusson,239,228,11
75,16,211603923,16392,Valence,190,185,5
75,16,211603931,16393,Vars,2197,2166,31
75,16,211603949,16394,Vaux-Lavalette,84,82,2
75,16,211603956,16395,Vaux-Rouillac,301,298,3
75,16,211603964,16396,Ventouse,123,123,0
75,16,211603972,16397,Verdille,388,381,7
75,16,211603980,16398,Verneuil,104,99,5
75,16,211603998,16399,Verrières,353,344,9
75,16,211604004,16400,Verteuil-sur-Charente,614,603,11
75,16,211604012,16401,Vervant,148,146,2
75,16,211604020,16402,Vibrac,289,284,5
75,16,211604038,16403,Le Vieux-Cérier,129,129,0
75,16,211604046,16404,Vieux-Ruffec,113,111,2
75,16,211604053,16405,Vignolles,173,163,10
75,16,200085629,16406,Moulins-sur-Tardoire,794,781,13
75,16,211604087,16408,Villebois-Lavalette,733,714,19
75,16,211604095,16409,Villefagnan,1004,993,11
75,16,211604129,16412,Villejoubert,339,338,1
75,16,211604137,16413,Villiers-le-Roux,137,135,2
75,16,211604145,16414,Villognon,321,318,3
75,16,211604152,16415,Vindelle,1104,1081,23
75,16,211604160,16416,Vitrac-Saint-Vincent,507,499,8
75,16,211604186,16418,Voeuil-et-Giget,1585,1555,30
75,16,211604194,16419,Vouharte,328,326,2
75,16,211604202,16420,Voulgézac,242,238,4
75,16,211604210,16421,Vouthon,417,412,5
75,16,211604228,16422,Vouzan,837,829,8
75,16,211604236,16423,Xambes,249,247,2
75,16,211604244,16424,Yviers,541,533,8
75,16,211604251,16425,Yvrac-et-Malleyrand,568,559,9
75,17,211700026,17002,Agudelle,137,133,4
75,17,211700034,17003,Aigrefeuille-d'Aunis,4417,4343,74
75,17,211700042,17004,Île-d'Aix,213,209,4
75,17,211700059,17005,Allas-Bocage,197,196,1
75,17,211700067,17006,Allas-Champagne,254,250,4
75,17,211700075,17007,Anais,323,316,7
75,17,211700083,17008,Andilly,2332,2295,37
75,17,211700091,17009,Angliers,1215,1204,11
75,17,211700109,17010,Angoulins,4163,4063,100
75,17,211700117,17011,Annepont,399,395,4
75,17,211700125,17012,Annezay,160,155,5
75,17,211700133,17013,Antezant-la-Chapelle,352,348,4
75,17,211700158,17015,Arces,755,745,10
75,17,211700166,17016,Archiac,787,775,12
75,17,211700174,17017,Archingeay,707,702,5
75,17,211700182,17018,Ardillières,869,856,13
75,17,211700190,17019,Ars-en-Ré,1326,1302,24
75,17,211700208,17020,Arthenac,354,350,4
75,17,211700216,17021,Arvert,3746,3672,74
75,17,211700224,17022,Asnières-la-Giraud,1009,984,25
75,17,211700232,17023,Aujac,381,374,7
75,17,211700240,17024,Aulnay,1347,1324,23
75,17,211700257,17025,Aumagne,732,703,29
75,17,211700265,17026,Authon-Ébéon,395,390,5
75,17,211700273,17027,Avy,477,470,7
75,17,211700281,17028,Aytré,9545,9397,148
75,17,211700299,17029,Bagnizeau,202,199,3
75,17,211700307,17030,Balanzac,564,559,5
75,17,211700315,17031,Ballans,201,198,3
75,17,211700323,17032,Ballon,826,809,17
75,17,211700331,17033,La Barde,501,496,5
75,17,211700349,17034,Barzan,466,459,7
75,17,211700356,17035,Bazauges,113,109,4
75,17,211700364,17036,Beaugeay,794,780,14
75,17,211700372,17037,Beauvais-sur-Matha,660,651,9
75,17,211700380,17038,Bedenac,699,693,6
75,17,211700398,17039,Belluire,215,214,1
75,17,211700414,17041,Benon,1731,1715,16
75,17,211700422,17042,Bercloux,455,445,10
75,17,211700430,17043,Bernay-Saint-Martin,757,744,13
75,17,211700448,17044,Berneuil,1172,1149,23
75,17,211700455,17045,Beurlay,1039,1022,17
75,17,211700463,17046,Bignay,381,375,6
75,17,211700471,17047,Biron,238,237,1
75,17,211700489,17048,Blanzac-lès-Matha,325,321,4
75,17,211700497,17049,Blanzay-sur-Boutonne,83,78,5
75,17,211700505,17050,Bois,664,519,145
75,17,211700513,17051,Le Bois-Plage-en-Ré,2310,2280,30
75,17,211700521,17052,Boisredon,704,700,4
75,17,211700539,17053,Bords,1343,1317,26
75,17,211700547,17054,Boresse-et-Martron,212,203,9
75,17,211700554,17055,Boscamnant,352,348,4
75,17,211700562,17056,Bougneau,625,612,13
75,17,211700570,17057,Bouhet,927,911,16
75,17,211700588,17058,Bourcefranc-le-Chapus,3644,3515,129
75,17,211700596,17059,Bourgneuf,1419,1394,25
75,17,211700604,17060,Boutenac-Touvent,231,229,2
75,17,211700612,17061,Bran,141,139,2
75,17,211700620,17062,Bresdon,221,220,1
75,17,211700638,17063,Breuil-la-Réorte,471,460,11
75,17,211700646,17064,Breuillet,3095,3031,64
75,17,211700653,17065,Breuil-Magné,1877,1823,54
75,17,211700661,17066,Brie-sous-Archiac,235,232,3
75,17,211700679,17067,Brie-sous-Matha,176,172,4
75,17,211700687,17068,Brie-sous-Mortagne,249,246,3
75,17,211700695,17069,Brives-sur-Charente,238,231,7
75,17,211700703,17070,Brizambourg,955,940,15
75,17,211700711,17071,La Brousse,521,513,8
75,17,211700729,17072,Burie,1350,1324,26
75,17,211700737,17073,Bussac-sur-Charente,1326,1282,44
75,17,211700745,17074,Bussac-Forêt,1085,1069,16
75,17,211700752,17075,Cabariot,1445,1422,23
75,17,211700760,17076,Celles,324,321,3
75,17,211700778,17077,Cercoux,1287,1267,20
75,17,211700786,17078,Chadenac,522,514,8
75,17,211700794,17079,Chaillevette,1661,1628,33
75,17,211700802,17080,Chambon,990,978,12
75,17,211700810,17081,Chamouillac,376,369,7
75,17,211700828,17082,Champagnac,532,516,16
75,17,211700836,17083,Champagne,632,620,12
75,17,211700844,17084,Champagnolles,691,683,8
75,17,211700851,17085,Champdolent,412,407,5
75,17,211700869,17086,Chaniers,3667,3585,82
75,17,211700877,17087,Chantemerle-sur-la-Soie,208,207,1
75,17,211700893,17089,La Chapelle-des-Pots,1030,1005,25
75,17,211700919,17091,Charron,2034,2007,27
75,17,211700927,17092,Chartuzac,168,164,4
75,17,211700935,17093,Le Château-d'Oléron,4391,4312,79
75,17,211700943,17094,Châtelaillon-Plage,6118,6024,94
75,17,211700950,17095,Chatenet,219,213,6
75,17,211700968,17096,Chaunac,79,77,2
75,17,211700976,17097,Le Chay,826,798,28
75,17,211700984,17098,Chenac-Saint-Seurin-d'Uzet,605,592,13
75,17,211700992,17099,Chepniers,662,655,7
75,17,211701008,17100,Chérac,1142,1125,17
75,17,211701016,17101,Cherbonnières,328,327,1
75,17,211701024,17102,Chermignac,1307,1271,36
75,17,211701040,17104,Chevanceaux,1205,1099,106
75,17,211701057,17105,Chives,312,311,1
75,17,211701065,17106,Cierzac,321,316,5
75,17,211701073,17107,Ciré-d'Aunis,1534,1509,25
75,17,211701081,17108,Clam,426,411,15
75,17,211701099,17109,Clavette,1478,1458,20
75,17,211701107,17110,Clérac,990,975,15
75,17,211701115,17111,Clion,840,829,11
75,17,211701123,17112,La Clisse,730,714,16
75,17,211701131,17113,La Clotte,721,713,8
75,17,211701149,17114,Coivert,209,207,2
75,17,211701156,17115,Colombiers,312,305,7
75,17,211701164,17116,Consac,237,232,5
75,17,211701172,17117,Contré,138,138,0
75,17,211701180,17118,Corignac,335,333,2
75,17,211701198,17119,Corme-Écluse,1199,1177,22
75,17,211701206,17120,Corme-Royal,1936,1908,28
75,17,211701214,17121,La Couarde-sur-Mer,1121,1103,18
75,17,211701222,17122,Coulonges,237,233,4
75,17,211701248,17124,Courant,435,431,4
75,17,211701255,17125,Courcelles,467,457,10
75,17,211701263,17126,Courcerac,308,302,6
75,17,211701271,17127,Courçon,1906,1879,27
75,17,211701289,17128,Courcoury,712,700,12
75,17,211701297,17129,Courpignac,424,418,6
75,17,211701305,17130,Coux,489,476,13
75,17,211701313,17131,Cozes,2188,2144,44
75,17,211701321,17132,Cram-Chaban,666,648,18
75,17,211701339,17133,Cravans,954,878,76
75,17,211701347,17134,Crazannes,444,436,8
75,17,211701354,17135,Cressé,224,222,2
75,17,211701362,17136,Croix-Chapeau,1327,1298,29
75,17,211701370,17137,La Croix-Comtesse,226,223,3
75,17,211701388,17138,Dampierre-sur-Boutonne,286,279,7
75,17,211701396,17139,Doeuil-sur-le-Mignon,352,348,4
75,17,211701404,17140,Dolus-d'Oléron,3208,3142,66
75,17,211701412,17141,Dompierre-sur-Charente,483,474,9
75,17,211701420,17142,Dompierre-sur-Mer,5950,5803,147
75,17,211701438,17143,Le Douhet,713,700,13
75,17,211701453,17145,Échebrune,493,485,8
75,17,211701461,17146,Échillais,3616,3548,68
75,17,211701479,17147,Écoyeux,1407,1386,21
75,17,211701487,17148,Écurat,463,453,10
75,17,211701495,17149,Les Éduts,62,60,2
75,17,211701503,17150,Les Églises-d'Argenteuil,532,525,7
75,17,211701511,17151,L'Éguille,903,887,16
75,17,211701529,17152,Épargnes,888,880,8
75,17,211701537,17153,Esnandes,2111,2079,32
75,17,211701545,17154,Les Essards,726,718,8
75,17,211701552,17155,Étaules,2710,2667,43
75,17,211701560,17156,Expiremont,138,135,3
75,17,211701578,17157,Fenioux,164,162,2
75,17,211701586,17158,Ferrières,1191,1183,8
75,17,211701594,17159,Fléac-sur-Seugne,368,361,7
75,17,200076925,17160,Floirac,446,433,13
75,17,211701610,17161,La Flotte,2951,2903,48
75,17,211701628,17162,Fontaine-Chalendray,198,197,1
75,17,211701636,17163,Fontaines-d'Ozillac,521,511,10
75,17,211701644,17164,Fontcouverte,2371,2317,54
75,17,211701651,17165,Fontenet,404,391,13
75,17,211701669,17166,Forges,1334,1321,13
75,17,211701677,17167,Le Fouilloux,781,770,11
75,17,211701685,17168,Fouras,4069,3998,71
75,17,211701719,17171,Geay,783,772,11
75,17,211701727,17172,Gémozac,2982,2945,37
75,17,211701735,17173,La Genétouze,233,229,4
75,17,211701743,17174,Genouillé,932,922,10
75,17,211701750,17175,Germignac,655,647,8
75,17,211701768,17176,Gibourne,108,104,4
75,17,211701776,17177,Le Gicq,117,117,0
75,17,211701784,17178,Givrezac,73,72,1
75,17,211701792,17179,Les Gonds,1881,1793,88
75,17,211701800,17180,Gourvillette,92,88,4
75,17,211701818,17181,Grandjean,321,315,6
75,17,211701826,17182,La Grève-sur-Mignon,560,549,11
75,17,211701834,17183,Grézac,956,943,13
75,17,211701842,17184,La Gripperie-Saint-Symphorien,597,585,12
75,17,211701859,17185,Le Gua,2137,2103,34
75,17,211701867,17186,Le Gué-d'Alleré,979,968,11
75,17,211701875,17187,Guitinières,511,495,16
75,17,211701883,17188,Haimps,464,454,10
75,17,211701909,17190,L'Houmeau,2917,2861,56
75,17,211701917,17191,La Jard,438,429,9
75,17,211701925,17192,Jarnac-Champagne,878,859,19
75,17,211701933,17193,La Jarne,2622,2567,55
75,17,211701941,17194,La Jarrie,3446,3371,75
75,17,211701958,17195,La Jarrie-Audouin,281,278,3
75,17,211701966,17196,Jazennes,561,546,15
75,17,211701974,17197,Jonzac,3766,3542,224
75,17,211701982,17198,Juicq,311,305,6
75,17,211701990,17199,Jussas,156,156,0
75,17,211702006,17200,Lagord,7350,7193,157
75,17,211702014,17201,La Laigne,487,482,5
75,17,211702022,17202,Landes,588,575,13
75,17,211702030,17203,Landrais,769,758,11
75,17,211702048,17204,Léoville,311,303,8
75,17,211702055,17205,Loire-les-Marais,397,390,7
75,17,211702063,17206,Loiré-sur-Nie,286,283,3
75,17,211702071,17207,Loix,754,735,19
75,17,211702089,17208,Longèves,1065,1055,10
75,17,211702097,17209,Lonzac,274,270,4
75,17,211702105,17210,Lorignac,510,506,4
75,17,211702113,17211,Loulay,765,754,11
75,17,211702121,17212,Louzignac,170,168,2
75,17,211702139,17213,Lozay,138,134,4
75,17,211702147,17214,Luchat,540,529,11
75,17,211702154,17215,Lussac,47,47,0
75,17,211702162,17216,Lussant,1032,1019,13
75,17,211702170,17217,Macqueville,298,291,7
75,17,211702188,17218,Marans,4584,4512,72
75,17,200085132,17219,Marennes-Hiers-Brouage,6304,6203,101
75,17,211702204,17220,Marignac,429,412,17
75,17,211702212,17221,Marsais,948,929,19
75,17,211702220,17222,Marsilly,3284,3190,94
75,17,211702238,17223,Massac,184,183,1
75,17,211702246,17224,Matha,2257,2178,79
75,17,211702253,17225,Les Mathes,2210,2178,32
75,17,211702261,17226,Mazeray,1002,988,14
75,17,211702279,17227,Mazerolles,224,221,3
75,17,211702287,17228,Médis,3084,3011,73
75,17,211702295,17229,Mérignac,228,225,3
75,17,211702303,17230,Meschers-sur-Gironde,3201,3131,70
75,17,211702311,17231,Messac,110,105,5
75,17,211702329,17232,Meursac,1557,1536,21
75,17,211702337,17233,Meux,331,330,1
75,17,211702345,17234,Migré,360,356,4
75,17,211702352,17235,Migron,725,714,11
75,17,211702360,17236,Mirambeau,1549,1520,29
75,17,211702378,17237,Moëze,600,596,4
75,17,211702394,17239,Mons,453,446,7
75,17,211702402,17240,Montendre,3274,3222,52
75,17,211702410,17241,Montguyon,1583,1564,19
75,17,211702428,17242,Montils,892,879,13
75,17,211702436,17243,Montlieu-la-Garde,1227,1217,10
75,17,211702444,17244,Montpellier-de-Médillan,697,688,9
75,17,211702451,17245,Montroy,921,908,13
75,17,211702469,17246,Moragne,537,531,6
75,17,211702477,17247,Mornac-sur-Seudre,872,859,13
75,17,211702485,17248,Mortagne-sur-Gironde,939,922,17
75,17,211702493,17249,Mortiers,172,171,1
75,17,211702501,17250,Mosnac,482,477,5
75,17,211702527,17252,Le Mung,313,306,7
75,17,211702535,17253,Muron,1367,1351,16
75,17,211702543,17254,Nachamps,195,193,2
75,17,211702550,17255,Nancras,807,796,11
75,17,211702568,17256,Nantillé,336,323,13
75,17,211702576,17257,Néré,663,658,5
75,17,211702584,17258,Neuillac,306,302,4
75,17,211702592,17259,Neulles,157,155,2
75,17,211702600,17260,Neuvicq,474,469,5
75,17,211702618,17261,Neuvicq-le-Château,312,307,5
75,17,211702626,17262,Nieul-lès-Saintes,1288,1266,22
75,17,211702634,17263,Nieul-le-Virouil,600,588,12
75,17,211702642,17264,Nieul-sur-Mer,5957,5811,146
75,17,211702659,17265,Nieulle-sur-Seudre,1239,1221,18
75,17,211702667,17266,Les Nouillers,731,724,7
75,17,211702675,17267,Nuaillé-d'Aunis,1214,1196,18
75,17,211702683,17268,Nuaillé-sur-Boutonne,198,191,7
75,17,211702691,17269,Orignolles,704,697,7
75,17,211702709,17270,Ozillac,629,616,13
75,17,211702717,17271,Paillé,331,325,6
75,17,211702733,17273,Pérignac,1016,998,18
75,17,211702741,17274,Périgny,8932,8741,191
75,17,211702758,17275,Pessines,812,786,26
75,17,211702766,17276,Le Pin,75,74,1
75,17,200055341,17277,Essouvert,1140,1059,81
75,17,211702782,17278,Pisany,786,777,9
75,17,211702790,17279,Plassac,654,641,13
75,17,211702808,17280,Plassay,771,760,11
75,17,211702816,17281,Polignac,163,160,3
75,17,211702824,17282,Pommiers-Moulons,215,213,2
75,17,211702832,17283,Pons,4456,4206,250
75,17,211702840,17284,Pont-l'Abbé-d'Arnoult,2076,1788,288
75,17,211702857,17285,Port-d'Envaux,1178,1151,27
75,17,211702865,17286,Les Portes-en-Ré,601,593,8
75,17,211702873,17287,Pouillac,268,266,2
75,17,211702881,17288,Poursay-Garnaud,321,315,6
75,17,211702899,17289,Préguillac,455,437,18
75,17,211702907,17290,Prignac,302,293,9
75,17,211702915,17291,Puilboreau,6786,6659,127
75,17,211702923,17292,Puy-du-Lac,518,513,5
75,17,211702931,17293,Puyravault,712,700,12
75,17,211702949,17294,Puyrolland,198,195,3
75,17,200053049,17295,Réaux sur Trèfle,797,781,16
75,17,211702964,17296,Rétaud,1073,1059,14
75,17,211702972,17297,Rivedoux-Plage,2365,2320,45
75,17,211702980,17298,Rioux,1009,987,22
75,17,211702998,17299,Rochefort,24042,23410,632
75,17,211703004,17300,La Rochelle,79323,77210,2113
75,17,211703012,17301,Romazières,71,70,1
75,17,211703020,17302,Romegoux,598,589,9
75,17,211703038,17303,La Ronde,1038,1021,17
75,17,211703046,17304,Rouffiac,499,494,5
75,17,211703053,17305,Rouffignac,416,407,9
75,17,211703061,17306,Royan,19174,18638,536
75,17,211703079,17307,Sablonceaux,1428,1396,32
75,17,211703087,17308,Saint-Agnant,2798,2737,61
75,17,211703095,17309,Saint-Aigulin,1927,1887,40
75,17,211703103,17310,Saint-André-de-Lidon,1161,1147,14
75,17,211703111,17311,Saint-Augustin,1439,1421,18
75,17,211703129,17312,Saint-Bonnet-sur-Gironde,839,825,14
75,17,211703137,17313,Saint-Bris-des-Bois,396,383,13
75,17,211703145,17314,Saint-Césaire,920,903,17
75,17,211703152,17315,Saint-Christophe,1405,1376,29
75,17,211703160,17316,Saint-Ciers-Champagne,399,388,11
75,17,211703178,17317,Saint-Ciers-du-Taillon,569,564,5
75,17,211703186,17318,Saint-Clément-des-Baleines,702,691,11
75,17,211703194,17319,Sainte-Colombe,105,104,1
75,17,211703202,17320,Saint-Coutant-le-Grand,415,409,6
75,17,211703210,17321,Saint-Crépin,362,355,7
75,17,211703228,17322,Saint-Cyr-du-Doret,692,687,5
75,17,211703236,17323,Saint-Denis-d'Oléron,1321,1297,24
75,17,211703244,17324,Saint-Dizant-du-Bois,111,111,0
75,17,211703251,17325,Saint-Dizant-du-Gua,532,526,6
75,17,211703269,17326,Saint-Eugène,289,286,3
75,17,211703277,17327,Saint-Félix,320,317,3
75,17,211703285,17328,Saint-Fort-sur-Gironde,919,908,11
75,17,211703293,17329,Saint-Froult,370,368,2
75,17,211703301,17330,Sainte-Gemme,1367,1348,19
75,17,211703319,17331,Saint-Genis-de-Saintonge,1293,1241,52
75,17,211703327,17332,Saint-Georges-Antignac,397,391,6
75,17,211703335,17333,Saint-Georges-de-Didonne,5356,5246,110
75,17,211703343,17334,Saint-Georges-de-Longuepierre,230,227,3
75,17,211703350,17335,Saint-Georges-des-Agoûts,289,286,3
75,17,211703368,17336,Saint-Georges-des-Coteaux,2849,2779,70
75,17,211703376,17337,Saint-Georges-d'Oléron,3900,3845,55
75,17,211703384,17338,Saint-Georges-du-Bois,1828,1807,21
75,17,211703392,17339,Saint-Germain-de-Lusignan,1418,1295,123
75,17,200080091,17340,Saint-Pierre-La-Noue,1608,1517,91
75,17,211703418,17341,Saint-Germain-de-Vibrac,186,182,4
75,17,211703426,17342,Saint-Germain-du-Seudre,424,413,11
75,17,211703434,17343,Saint-Grégoire-d'Ardennes,148,145,3
75,17,200085074,17344,Saint-Hilaire-de-Villefranche,1354,1328,26
75,17,211703459,17345,Saint-Hilaire-du-Bois,311,297,14
75,17,211703467,17346,Saint-Hippolyte,1500,1475,25
75,17,211703475,17347,Saint-Jean-d'Angély,7172,6744,428
75,17,211703483,17348,Saint-Jean-d'Angle,703,693,10
75,17,211703491,17349,Saint-Jean-de-Liversay,3041,2997,44
75,17,211703509,17350,Saint-Julien-de-l'Escap,880,864,16
75,17,211703517,17351,Saint-Just-Luzac,2080,2046,34
75,17,211703533,17353,Saint-Laurent-de-la-Prée,2326,2264,62
75,17,211703541,17354,Saint-Léger,667,653,14
75,17,211703558,17355,Sainte-Lheurine,519,511,8
75,17,211703566,17356,Saint-Loup,313,309,4
75,17,211703574,17357,Saint-Maigrin,539,531,8
75,17,211703582,17358,Saint-Mandé-sur-Brédoire,313,307,6
75,17,211703590,17359,Saint-Mard,1230,1210,20
75,17,211703608,17360,Sainte-Marie-de-Ré,3464,3356,108
75,17,211703616,17361,Saint-Martial,117,112,5
75,17,211703624,17362,Saint-Martial-de-Mirambeau,306,299,7
75,17,211703632,17363,Saint-Martial-de-Vitaterne,561,547,14
75,17,211703640,17364,Saint-Martial-sur-Né,444,430,14
75,17,211703657,17365,Saint-Martin-d'Ary,478,469,9
75,17,211703665,17366,Saint-Martin-de-Coux,493,489,4
75,17,211703673,17367,Saint-Martin-de-Juillers,160,156,4
75,17,211703699,17369,Saint-Martin-de-Ré,2240,2220,20
75,17,211703723,17372,Saint-Médard,83,82,1
75,17,211703731,17373,Saint-Médard-d'Aunis,2376,2333,43
75,17,211703749,17374,Sainte-Même,243,237,6
75,17,211703756,17375,Saint-Nazaire-sur-Charente,1225,1205,20
75,17,211703764,17376,Saint-Ouen-d'Aunis,2014,1983,31
75,17,211703772,17377,Saint-Ouen-la-Thène,133,128,5
75,17,211703780,17378,Saint-Palais-de-Négrignac,438,432,6
75,17,211703798,17379,Saint-Palais-de-Phiolin,212,209,3
75,17,211703806,17380,Saint-Palais-sur-Mer,4002,3920,82
75,17,211703814,17381,Saint-Pardoult,225,222,3
75,17,211703822,17382,Saint-Pierre-d'Amilly,556,550,6
75,17,211703830,17383,Saint-Pierre-de-Juillers,351,347,4
75,17,211703848,17384,Saint-Pierre-de-l'Isle,263,261,2
75,17,211703855,17385,Saint-Pierre-d'Oléron,6682,6585,97
75,17,211703863,17386,Saint-Pierre-du-Palais,358,348,10
75,17,211703871,17387,Saint-Porchaire,1947,1920,27
75,17,211703889,17388,Saint-Quantin-de-Rançanne,260,254,6
75,17,211703897,17389,Sainte-Radegonde,587,579,8
75,17,211703905,17390,Sainte-Ramée,115,114,1
75,17,211703913,17391,Saint-Rogatien,2475,2425,50
75,17,211703939,17393,Saint-Romain-de-Benet,1787,1760,27
75,17,211703947,17394,Saint-Saturnin-du-Bois,920,902,18
75,17,211703954,17395,Saint-Sauvant,502,494,8
75,17,211703962,17396,Saint-Sauveur-d'Aunis,1756,1727,29
75,17,211703970,17397,Saint-Savinien,2553,2452,101
75,17,211703988,17398,Saint-Seurin-de-Palenne,174,167,7
75,17,211704002,17400,Saint-Sever-de-Saintonge,651,638,13
75,17,211704010,17401,Saint-Séverin-sur-Boutonne,97,94,3
75,17,211704028,17402,Saint-Sigismond-de-Clermont,160,158,2
75,17,211704036,17403,Saint-Simon-de-Bordes,776,763,13
75,17,211704044,17404,Saint-Simon-de-Pellouaille,681,662,19
75,17,211704051,17405,Saint-Sorlin-de-Conac,200,198,2
75,17,211704069,17406,Saint-Sornin,420,417,3
75,17,211704077,17407,Sainte-Soulle,5001,4906,95
75,17,211704085,17408,Saint-Sulpice-d'Arnoult,919,910,9
75,17,211704093,17409,Saint-Sulpice-de-Royan,3393,3328,65
75,17,211704101,17410,Saint-Thomas-de-Conac,584,575,9
75,17,211704119,17411,Saint-Trojan-les-Bains,1154,1133,21
75,17,211704127,17412,Saint-Vaize,673,660,13
75,17,211704135,17413,Saint-Vivien,1406,1385,21
75,17,211704143,17414,Saint-Xandre,5399,5231,168
75,17,211704150,17415,Saintes,26814,25412,1402
75,17,211704168,17416,Saleignes,60,58,2
75,17,211704176,17417,Salignac-de-Mirambeau,168,167,1
75,17,211704184,17418,Salignac-sur-Charente,623,606,17
75,17,211704200,17420,Salles-sur-Mer,2387,2324,63
75,17,211704218,17421,Saujon,7320,7200,120
75,17,211704226,17422,Seigné,79,78,1
75,17,211704234,17423,Semillac,76,75,1
75,17,211704242,17424,Semoussac,397,394,3
75,17,211704259,17425,Semussac,2475,2429,46
75,17,211704267,17426,Le Seure,262,260,2
75,17,211704275,17427,Siecq,222,217,5
75,17,211704283,17428,Sonnac,495,486,9
75,17,211704291,17429,Soubise,3389,3347,42
75,17,211704309,17430,Soubran,415,408,7
75,17,211704317,17431,Soulignonne,727,721,6
75,17,211704325,17432,Souméras,371,365,6
75,17,211704333,17433,Sousmoulins,215,208,7
75,17,211704341,17434,Surgères,6970,6801,169
75,17,211704358,17435,Taillant,175,174,1
75,17,211704366,17436,Taillebourg,792,768,24
75,17,211704374,17437,Talmont-sur-Gironde,97,96,1
75,17,211704382,17438,Tanzac,306,299,7
75,17,211704390,17439,Taugon,793,779,14
75,17,211704408,17440,Ternant,379,371,8
75,17,211704416,17441,Tesson,1156,1130,26
75,17,211704424,17442,Thaims,384,381,3
75,17,211704432,17443,Thairé,1823,1778,45
75,17,211704440,17444,Thénac,1954,1696,258
75,17,211704457,17445,Thézac,342,334,8
75,17,211704465,17446,Thors,469,463,6
75,17,211704473,17447,Le Thou,2045,2020,25
75,17,211704481,17448,Tonnay-Boutonne,1194,1180,14
75,17,211704499,17449,Tonnay-Charente,8248,8142,106
75,17,211704507,17450,Torxé,246,244,2
75,17,211704515,17451,Les Touches-de-Périgny,558,548,10
75,17,211704523,17452,La Tremblade,4391,4326,65
75,17,211704531,17453,Trizay,1500,1468,32
75,17,211704549,17454,Tugéras-Saint-Maurice,385,378,7
75,17,211704556,17455,La Vallée,676,665,11
75,17,200076586,17457,La Devise,1210,1193,17
75,17,211704580,17458,Vanzac,181,181,0
75,17,211704598,17459,Varaize,570,560,10
75,17,211704606,17460,Varzay,859,841,18
75,17,211704614,17461,Vaux-sur-Mer,4070,3990,80
75,17,211704622,17462,Vénérand,781,766,15
75,17,211704630,17463,Vergeroux,1303,1282,21
75,17,211704648,17464,Vergné,164,158,6
75,17,211704655,17465,La Vergne,611,601,10
75,17,211704663,17466,Vérines,2360,2326,34
75,17,211704671,17467,Vervant,238,236,2
75,17,211704689,17468,Vibrac,156,153,3
75,17,211704697,17469,Villars-en-Pons,590,576,14
75,17,211704705,17470,Villars-les-Bois,237,228,9
75,17,211704713,17471,La Villedieu,211,208,3
75,17,211704721,17472,Villedoux,2316,2297,19
75,17,211704739,17473,Villemorin,119,119,0
75,17,211704747,17474,Villeneuve-la-Comtesse,755,742,13
75,17,211704762,17476,Villexavier,276,271,5
75,17,211704770,17477,Villiers-Couture,110,109,1
75,17,211704788,17478,Vinax,61,61,0
75,17,211704796,17479,Virollet,303,300,3
75,17,211704804,17480,Virson,774,757,17
75,17,211704812,17481,Voissay,171,168,3
75,17,211704820,17482,Vouhé,654,643,11
75,17,211704838,17483,Yves,1523,1497,26
75,17,211704846,17484,Port-des-Barques,1777,1764,13
75,17,211704853,17485,Le Grand-Village-Plage,1087,1074,13
75,17,211704861,17486,La Brée-les-Bains,694,688,6
24,18,211800016,18001,Achères,371,364,7
24,18,211800024,18002,Ainay-le-Vieil,195,191,4
24,18,211800032,18003,Les Aix-d'Angillon,1909,1881,28
24,18,211800040,18004,Allogny,1115,1097,18
24,18,211800057,18005,Allouis,1097,1074,23
24,18,211800065,18006,Annoix,242,240,2
24,18,211800073,18007,Apremont-sur-Allier,70,69,1
24,18,211800081,18008,Arçay,503,493,10
24,18,211800099,18009,Arcomps,289,278,11
24,18,211800107,18010,Ardenais,206,199,7
24,18,211800115,18011,Argent-sur-Sauldre,2108,2070,38
24,18,211800123,18012,Argenvières,443,438,5
24,18,211800131,18013,Arpheuilles,306,301,5
24,18,211800149,18014,Assigny,155,148,7
24,18,211800156,18015,Aubigny-sur-Nère,5623,5499,124
24,18,211800164,18016,Aubinges,408,405,3
24,18,211800172,18017,Augy-sur-Aubois,289,286,3
24,18,211800180,18018,Avord,2841,2804,37
24,18,211800198,18019,Azy,455,448,7
24,18,211800206,18020,Bannay,861,848,13
24,18,211800214,18021,Bannegon,276,272,4
24,18,211800222,18022,Barlieu,350,342,8
24,18,200083798,18023,Baugy,1691,1637,54
24,18,211800248,18024,Beddes,105,102,3
24,18,211800255,18025,Beffes,622,610,12
24,18,211800263,18026,Belleville-sur-Loire,1013,986,27
24,18,211800271,18027,Bengy-sur-Craon,720,653,67
24,18,211800289,18028,Berry-Bouy,1209,1172,37
24,18,211800297,18029,Bessais-le-Fromental,303,299,4
24,18,211800305,18030,Blancafort,1029,1008,21
24,18,211800313,18031,Blet,568,563,5
24,18,211800321,18032,Boulleret,1410,1375,35
24,18,211800339,18033,Bourges,66385,64362,2023
24,18,211800347,18034,Bouzais,317,308,9
24,18,211800354,18035,Brécy,1075,1053,22
24,18,211800362,18036,Brinay,530,524,6
24,18,211800370,18037,Brinon-sur-Sauldre,987,971,16
24,18,211800388,18038,Bruère-Allichamps,571,567,4
24,18,211800396,18039,Bué,330,322,8
24,18,211800404,18040,Bussy,356,353,3
24,18,211800412,18041,La Celette,198,196,2
24,18,211800420,18042,La Celle,350,345,5
24,18,211800438,18043,La Celle-Condé,194,194,0
24,18,211800446,18044,Cerbois,411,407,4
24,18,211800453,18045,Chalivoy-Milon,412,404,8
24,18,211800461,18046,Chambon,164,162,2
24,18,211800479,18047,La Chapelle-d'Angillon,620,612,8
24,18,211800487,18048,La Chapelle-Hugon,384,380,4
24,18,211800495,18049,La Chapelle-Montlinard,476,467,9
24,18,211800503,18050,La Chapelle-Saint-Ursin,3753,3674,79
24,18,211800511,18051,La Chapelotte,137,134,3
24,18,211800529,18052,Charenton-du-Cher,1039,1017,22
24,18,211800537,18053,Charentonnay,298,290,8
24,18,211800545,18054,Charly,249,246,3
24,18,211800552,18055,Chârost,944,922,22
24,18,211800560,18056,Chassy,242,236,6
24,18,211800578,18057,Châteaumeillant,1758,1740,18
24,18,211800586,18058,Châteauneuf-sur-Cher,1438,1425,13
24,18,211800594,18059,Le Châtelet,947,936,11
24,18,211800602,18060,Chaumont,50,48,2
24,18,211800610,18061,Chaumoux-Marcilly,88,88,0
24,18,211800628,18062,Le Chautay,267,266,1
24,18,211800636,18063,Chavannes,159,156,3
24,18,211800644,18064,Chéry,224,218,6
24,18,211800651,18065,Chezal-Benoît,814,802,12
24,18,211800669,18066,Civray,916,901,15
24,18,211800677,18067,Clémont,718,708,10
24,18,211800685,18068,Cogny,36,34,2
24,18,211800693,18069,Colombiers,428,412,16
24,18,211800701,18070,Concressault,203,201,2
24,18,211800719,18071,Contres,33,33,0
24,18,211800727,18072,Cornusse,254,253,1
24,18,200082998,18073,Corquoy,206,200,6
24,18,211800743,18074,Couargues,203,199,4
24,18,211800750,18075,Cours-les-Barres,1050,1023,27
24,18,211800768,18076,Coust,451,443,8
24,18,211800776,18077,Couy,375,366,9
24,18,211800784,18078,Crézançay-sur-Cher,62,61,1
24,18,211800792,18079,Crézancy-en-Sancerre,444,438,6
24,18,211800800,18080,Croisy,148,146,2
24,18,211800818,18081,Crosses,408,405,3
24,18,211800826,18082,Cuffy,1055,1026,29
24,18,211800834,18083,Culan,774,767,7
24,18,211800842,18084,Dampierre-en-Crot,206,203,3
24,18,211800859,18085,Dampierre-en-Graçay,245,240,5
24,18,211800867,18086,Drevant,562,546,16
24,18,211800875,18087,Dun-sur-Auron,3687,3616,71
24,18,211800883,18088,Ennordres,217,210,7
24,18,211800891,18089,Épineuil-le-Fleuriel,446,436,10
24,18,211800909,18090,Étréchy,423,413,10
24,18,211800917,18091,Farges-Allichamps,259,253,6
24,18,211800925,18092,Farges-en-Septaine,1019,995,24
24,18,211800933,18093,Faverdines,137,137,0
24,18,211800941,18094,Feux,342,334,8
24,18,211800958,18095,Flavigny,172,168,4
24,18,211800966,18096,Foëcy,2120,2086,34
24,18,211800974,18097,Fussy,1984,1952,32
24,18,211800982,18098,Gardefort,130,127,3
24,18,211800990,18099,Garigny,225,221,4
24,18,211801006,18100,Genouilly,693,676,17
24,18,211801014,18101,Germigny-l'Exempt,300,290,10
24,18,211801022,18102,Givardon,306,303,3
24,18,211801030,18103,Graçay,1383,1369,14
24,18,211801048,18104,Groises,136,134,2
24,18,211801055,18105,Gron,476,459,17
24,18,211801063,18106,Grossouvre,266,263,3
24,18,211801071,18107,La Groutte,131,123,8
24,18,211801089,18108,La Guerche-sur-l'Aubois,3201,3168,33
24,18,211801097,18109,Henrichemont,1740,1720,20
24,18,211801105,18110,Herry,983,965,18
24,18,211801113,18111,Humbligny,188,187,1
24,18,211801121,18112,Ids-Saint-Roch,283,282,1
24,18,211801139,18113,Ignol,184,179,5
24,18,211801147,18114,Ineuil,227,223,4
24,18,211801154,18115,Ivoy-le-Pré,793,786,7
24,18,211801162,18116,Jalognes,275,273,2
24,18,211801170,18117,Jars,508,503,5
24,18,211801188,18118,Jouet-sur-l'Aubois,1349,1317,32
24,18,211801196,18119,Jussy-Champagne,209,204,5
24,18,211801204,18120,Jussy-le-Chaudrier,601,588,13
24,18,211801212,18121,Lantan,97,93,4
24,18,211801220,18122,Lapan,222,220,2
24,18,211801246,18124,Lazenay,300,297,3
24,18,211801253,18125,Léré,1100,1075,25
24,18,211801261,18126,Levet,1417,1373,44
24,18,211801279,18127,Lignières,1386,1358,28
24,18,211801287,18128,Limeux,168,168,0
24,18,211801295,18129,Lissay-Lochy,233,228,5
24,18,211801303,18130,Loye-sur-Arnon,304,298,6
24,18,211801311,18131,Lugny-Bourbonnais,34,34,0
24,18,211801329,18132,Lugny-Champagne,137,136,1
24,18,211801337,18133,Lunery,1606,1593,13
24,18,211801345,18134,Lury-sur-Arnon,677,661,16
24,18,211801352,18135,Maisonnais,242,236,6
24,18,211801360,18136,Marçais,309,304,5
24,18,211801378,18137,Mareuil-sur-Arnon,504,495,9
24,18,211801386,18138,Marmagne,1969,1916,53
24,18,211801394,18139,Marseilles-lès-Aubigny,664,652,12
24,18,211801402,18140,Massay,1377,1353,24
24,18,211801410,18141,Mehun-sur-Yèvre,6590,6502,88
24,18,211801428,18142,Meillant,688,673,15
24,18,211801436,18143,Menetou-Couture,393,386,7
24,18,211801444,18144,Menetou-Râtel,476,466,10
24,18,211801451,18145,Menetou-Salon,1653,1614,39
24,18,211801469,18146,Ménétréol-sous-Sancerre,323,310,13
24,18,211801477,18147,Ménétréol-sur-Sauldre,204,201,3
24,18,211801485,18148,Méreau,2683,2620,63
24,18,211801493,18149,Méry-ès-Bois,570,562,8
24,18,211801501,18150,Méry-sur-Cher,717,703,14
24,18,211801519,18151,Montigny,347,335,12
24,18,211801527,18152,Montlouis,111,109,2
24,18,211801535,18153,Morlac,317,312,5
24,18,211801543,18154,Mornay-Berry,177,173,4
24,18,211801550,18155,Mornay-sur-Allier,429,426,3
24,18,211801568,18156,Morogues,436,432,4
24,18,211801576,18157,Morthomiers,788,765,23
24,18,211801584,18158,Moulins-sur-Yèvre,871,848,23
24,18,211801592,18159,Nançay,841,813,28
24,18,211801600,18160,Nérondes,1467,1448,19
24,18,211801618,18161,Neuilly-en-Dun,218,216,2
24,18,211801626,18162,Neuilly-en-Sancerre,253,252,1
24,18,211801634,18163,Neuvy-Deux-Clochers,274,269,5
24,18,211801642,18164,Neuvy-le-Barrois,139,137,2
24,18,211801659,18165,Neuvy-sur-Barangeon,1137,1106,31
24,18,211801667,18166,Nohant-en-Goût,571,561,10
24,18,211801675,18167,Nohant-en-Graçay,299,297,2
24,18,211801683,18168,Le Noyer,216,215,1
24,18,211801691,18169,Nozières,223,220,3
24,18,211801709,18170,Oizon,675,668,7
24,18,211801717,18171,Orcenais,256,249,7
24,18,211801725,18172,Orval,1780,1745,35
24,18,211801733,18173,Osmery,244,242,2
24,18,211801741,18174,Osmoy,267,264,3
24,18,211801758,18175,Ourouer-les-Bourdelins,620,611,9
24,18,211801766,18176,Parassy,415,410,5
24,18,211801774,18177,Parnay,54,54,0
24,18,211801782,18178,La Perche,197,194,3
24,18,211801790,18179,Pigny,1010,994,16
24,18,211801808,18180,Plaimpied-Givaudins,2158,2091,67
24,18,211801816,18181,Plou,555,545,10
24,18,211801824,18182,Poisieux,220,216,4
24,18,211801832,18183,Le Pondy,152,149,3
24,18,211801840,18184,Précy,350,349,1
24,18,211801857,18185,Presly,236,235,1
24,18,211801865,18186,Preuilly,445,439,6
24,18,211801873,18187,Préveranges,523,513,10
24,18,211801881,18188,Primelles,225,222,3
24,18,211801899,18189,Quantilly,485,481,4
24,18,211801907,18190,Quincy,849,828,21
24,18,211801915,18191,Raymond,180,177,3
24,18,211801923,18192,Reigny,236,233,3
24,18,211801931,18193,Rezay,207,202,5
24,18,211801949,18194,Rians,991,973,18
24,18,211801956,18195,Sagonne,194,189,5
24,18,211801964,18196,Saint-Aignan-des-Noyers,81,79,2
24,18,211801972,18197,Saint-Amand-Montrond,9785,9490,295
24,18,211801980,18198,Saint-Ambroix,390,374,16
24,18,211801998,18199,Saint-Baudel,254,251,3
24,18,211802004,18200,Saint-Bouize,300,293,7
24,18,211802012,18201,Saint-Caprais,793,778,15
24,18,211802020,18202,Saint-Céols,13,13,0
24,18,211802038,18203,Saint-Christophe-le-Chaudry,95,94,1
24,18,211802046,18204,Saint-Denis-de-Palin,294,286,8
24,18,211802053,18205,Saint-Doulchard,9890,9664,226
24,18,211802061,18206,Saint-Éloy-de-Gy,1607,1553,54
24,18,211802079,18207,Saint-Florent-sur-Cher,6527,6432,95
24,18,211802087,18208,Sainte-Gemme-en-Sancerrois,415,408,7
24,18,211802095,18209,Saint-Georges-de-Poisieux,457,442,15
24,18,211802103,18210,Saint-Georges-sur-la-Prée,615,603,12
24,18,211802111,18211,Saint-Georges-sur-Moulon,711,695,16
24,18,211802129,18212,Saint-Germain-des-Bois,651,637,14
24,18,211802137,18213,Saint-Germain-du-Puy,5106,4995,111
24,18,211802145,18214,Saint-Hilaire-de-Court,596,593,3
24,18,211802152,18215,Saint-Hilaire-de-Gondilly,144,142,2
24,18,211802160,18216,Saint-Hilaire-en-Lignières,497,484,13
24,18,211802178,18217,Saint-Jeanvrin,157,153,4
24,18,211802186,18218,Saint-Just,666,653,13
24,18,211802194,18219,Saint-Laurent,521,510,11
24,18,211802202,18220,Saint-Léger-le-Petit,350,346,4
24,18,211802210,18221,Saint-Loup-des-Chaumes,300,298,2
24,18,211802236,18223,Saint-Martin-d'Auxigny,2519,2484,35
24,18,211802244,18224,Saint-Martin-des-Champs,304,295,9
24,18,211802251,18225,Saint-Maur,276,268,8
24,18,211802269,18226,Saint-Michel-de-Volangis,478,463,15
24,18,211802277,18227,Sainte-Montaine,172,168,4
24,18,211802285,18228,Saint-Outrille,222,218,4
24,18,211802293,18229,Saint-Palais,634,615,19
24,18,211802301,18230,Saint-Pierre-les-Bois,294,283,11
24,18,211802319,18231,Saint-Pierre-les-Étieux,761,742,19
24,18,211802327,18232,Saint-Priest-la-Marche,246,244,2
24,18,211802335,18233,Saint-Satur,1422,1396,26
24,18,211802343,18234,Saint-Saturnin,437,429,8
24,18,211802350,18235,Sainte-Solange,1141,1122,19
24,18,211802368,18236,Saint-Symphorien,135,133,2
24,18,211802376,18237,Sainte-Thorette,486,476,10
24,18,211802384,18238,Saint-Vitte,131,127,4
24,18,211802400,18240,Sancergues,649,641,8
24,18,211802418,18241,Sancerre,1370,1340,30
24,18,211802426,18242,Sancoins,2976,2943,33
24,18,211802434,18243,Santranges,415,413,2
24,18,211802442,18244,Saugy,79,79,0
24,18,211802459,18245,Saulzais-le-Potier,493,484,9
24,18,211802467,18246,Savigny-en-Sancerre,1133,1112,21
24,18,211802475,18247,Savigny-en-Septaine,744,729,15
24,18,211802483,18248,Senneçay,474,468,6
24,18,211802491,18249,Sens-Beaujeu,415,402,13
24,18,211802509,18250,Serruelles,70,68,2
24,18,211802517,18251,Sévry,58,56,2
24,18,211802525,18252,Sidiailles,302,295,7
24,18,211802533,18253,Soulangis,478,466,12
24,18,211802541,18254,Soye-en-Septaine,610,595,15
24,18,211802558,18255,Le Subdray,1194,990,204
24,18,211802566,18256,Subligny,344,337,7
24,18,211802574,18257,Sury-près-Léré,676,662,14
24,18,211802582,18258,Sury-en-Vaux,707,690,17
24,18,211802590,18259,Sury-ès-Bois,282,279,3
24,18,211802608,18260,Tendron,89,88,1
24,18,211802616,18261,Thaumiers,409,403,6
24,18,211802624,18262,Thauvenay,333,325,8
24,18,211802632,18263,Thénioux,665,662,3
24,18,211802640,18264,Thou,83,81,2
24,18,211802657,18265,Torteron,804,792,12
24,18,211802665,18266,Touchay,239,232,7
24,18,211802673,18267,Trouy,4068,3977,91
24,18,211802681,18268,Uzay-le-Venon,415,405,10
24,18,211802699,18269,Vailly-sur-Sauldre,665,651,14
24,18,211802707,18270,Vallenay,729,708,21
24,18,211802715,18271,Vasselay,1561,1528,33
24,18,211802723,18272,Veaugues,652,630,22
24,18,211802731,18273,Venesmes,826,809,17
24,18,211802749,18274,Verdigny,315,312,3
24,18,211802756,18275,Vereaux,148,141,7
24,18,211802764,18276,Vernais,189,187,2
24,18,211802772,18277,Verneuil,35,35,0
24,18,211802780,18278,Vesdun,561,549,12
24,18,211802798,18279,Vierzon,25542,25045,497
24,18,211802806,18280,Vignoux-sous-les-Aix,736,715,21
24,18,211802814,18281,Vignoux-sur-Barangeon,2175,2138,37
24,18,211802822,18282,Villabon,589,575,14
24,18,211802830,18283,Villecelin,82,82,0
24,18,211802848,18284,Villegenon,216,212,4
24,18,211802855,18285,Villeneuve-sur-Cher,416,411,5
24,18,211802863,18286,Villequiers,467,460,7
24,18,211802871,18287,Vinon,301,294,7
24,18,211802889,18288,Vorly,255,249,6
24,18,211802897,18289,Vornay,606,590,16
24,18,211802905,18290,Vouzeron,603,593,10
75,19,211900105,19001,Affieux,371,357,14
75,19,211900204,19002,Aix,405,397,8
75,19,211900303,19003,Albignac,240,231,9
75,19,211900402,19004,Albussac,750,740,10
75,19,211900501,19005,Allassac,4096,3996,100
75,19,211900600,19006,Alleyrat,105,105,0
75,19,211900709,19007,Altillac,850,829,21
75,19,211900808,19008,Ambrugeat,211,207,4
75,19,211900907,19009,Les Angles-sur-Corrèze,125,123,2
75,19,200063022,19010,Argentat-sur-Dordogne,3000,2887,113
75,19,211901103,19011,Arnac-Pompadour,1156,1145,11
75,19,211901202,19012,Astaillac,217,213,4
75,19,211901301,19013,Aubazines,894,873,21
75,19,211901400,19014,Auriac,230,224,6
75,19,211901509,19015,Ayen,710,703,7
75,19,211901608,19016,Bar,312,303,9
75,19,211901707,19017,Bassignac-le-Bas,86,85,1
75,19,211901806,19018,Bassignac-le-Haut,160,156,4
75,19,200081487,19019,Beaulieu-sur-Dordogne,1305,1290,15
75,19,211902002,19020,Beaumont,120,112,8
75,19,211902101,19021,Bellechassagne,96,94,2
75,19,211902200,19022,Benayes,226,221,5
75,19,211902309,19023,Beynat,1269,1250,19
75,19,211902408,19024,Beyssac,615,592,23
75,19,211902507,19025,Beyssenac,361,357,4
75,19,211902606,19026,Bilhac,257,253,4
75,19,211902705,19027,Bonnefond,115,115,0
75,19,211902804,19028,Bort-les-Orgues,2696,2595,101
75,19,211902903,19029,Branceilles,284,278,6
75,19,211903000,19030,Brignac-la-Plaine,981,966,15
75,19,211903109,19031,Brive-la-Gaillarde,47175,45910,1265
75,19,211903307,19033,Bugeat,797,785,12
75,19,211903406,19034,Camps-Saint-Mathurin-Léobazel,223,212,11
75,19,211903505,19035,Chabrignac,560,540,20
75,19,211903604,19036,Chamberet,1414,1399,15
75,19,211903703,19037,Chamboulive,1196,1168,28
75,19,211903802,19038,Chameyrat,1568,1515,53
75,19,211903901,19039,Champagnac-la-Noaille,234,226,8
75,19,211904008,19040,Champagnac-la-Prune,156,151,5
75,19,211904107,19041,Chanac-les-Mines,451,433,18
75,19,211904206,19042,Chanteix,642,629,13
75,19,211904305,19043,La Chapelle-aux-Brocs,451,442,9
75,19,211904404,19044,La Chapelle-aux-Saints,276,273,3
75,19,211904503,19045,La Chapelle-Saint-Géraud,202,197,5
75,19,211904602,19046,Chapelle-Spinasse,113,112,1
75,19,211904701,19047,Chartrier-Ferrière,368,361,7
75,19,211904800,19048,Le Chastang,363,351,12
75,19,211904909,19049,Chasteaux,772,751,21
75,19,211905005,19050,Chauffour-sur-Vell,422,414,8
75,19,211905104,19051,Chaumeil,168,164,4
75,19,211905203,19052,Chavanac,51,50,1
75,19,211905302,19053,Chaveroche,276,271,5
75,19,211905401,19054,Chenailler-Mascheix,215,211,4
75,19,211905500,19055,Chirac-Bellevue,295,287,8
75,19,211905609,19056,Clergoux,416,405,11
75,19,211905708,19057,Collonges-la-Rouge,503,483,20
75,19,211905807,19058,Combressol,365,355,10
75,19,211905906,19059,Concèze,398,389,9
75,19,211906003,19060,Condat-sur-Ganaveix,692,677,15
75,19,211906102,19061,Cornil,1320,1308,12
75,19,211906201,19062,Corrèze,1189,1151,38
75,19,211906300,19063,Cosnac,3108,3010,98
75,19,211906409,19064,Couffy-sur-Sarsonne,73,71,2
75,19,211906508,19065,Courteix,70,69,1
75,19,211906607,19066,Cublac,1764,1727,37
75,19,211906706,19067,Curemonte,217,208,9
75,19,211906805,19068,Dampniat,715,708,7
75,19,211906904,19069,Darazac,144,141,3
75,19,211907001,19070,Darnets,335,323,12
75,19,211907100,19071,Davignac,215,211,4
75,19,211907209,19072,Donzenac,2762,2691,71
75,19,211907308,19073,Égletons,5008,4274,734
75,19,211907407,19074,L'Église-aux-Bois,53,53,0
75,19,211907506,19075,Espagnac,397,383,14
75,19,211907605,19076,Espartignac,420,411,9
75,19,211907704,19077,Estivals,139,132,7
75,19,211907803,19078,Estivaux,420,412,8
75,19,211907902,19079,Eyburie,501,491,10
75,19,211908009,19080,Eygurande,702,691,11
75,19,211908108,19081,Eyrein,521,506,15
75,19,211908207,19082,Favars,1136,1114,22
75,19,211908306,19083,Feyt,128,127,1
75,19,211908405,19084,Forgès,272,260,12
75,19,211908504,19085,Gimel-les-Cascades,798,782,16
75,19,211908603,19086,Goulles,340,334,6
75,19,211908702,19087,Gourdon-Murat,89,87,2
75,19,211908801,19088,Grandsaigne,53,52,1
75,19,211908900,19089,Gros-Chastang,194,190,4
75,19,211909007,19090,Gumond,97,95,2
75,19,211909106,19091,Hautefage,328,316,12
75,19,211909304,19093,Jugeals-Nazareth,994,960,34
75,19,211909403,19094,Juillac,1151,1125,26
75,19,211909502,19095,Lacelle,132,131,1
75,19,211909601,19096,Ladignac-sur-Rondelles,419,408,11
75,19,211909700,19097,Lafage-sur-Sombre,136,135,1
75,19,200085520,19098,Lagarde-Marc-la-Tour,981,958,23
75,19,211909908,19099,Lagleygeolle,232,222,10
75,19,211910005,19100,Lagraulière,1153,1128,25
75,19,200084333,19101,Laguenne-sur-Avalouze,1588,1541,47
75,19,211910203,19102,Lamazière-Basse,297,291,6
75,19,211910302,19103,Lamazière-Haute,70,68,2
75,19,211910401,19104,Lamongerie,120,118,2
75,19,211910500,19105,Lanteuil,492,479,13
75,19,211910609,19106,Lapleau,375,373,2
75,19,211910708,19107,Larche,1669,1629,40
75,19,211910807,19108,Laroche-près-Feyt,67,66,1
75,19,211910906,19109,Lascaux,231,224,7
75,19,211911003,19110,Latronche,127,126,1
75,19,211911102,19111,Laval-sur-Luzège,104,102,2
75,19,211911201,19112,Lestards,110,110,0
75,19,211911300,19113,Liginiac,685,648,37
75,19,211911409,19114,Lignareix,174,164,10
75,19,211911508,19115,Ligneyrac,308,300,8
75,19,211911607,19116,Liourdres,260,256,4
75,19,211911706,19117,Lissac-sur-Couze,705,682,23
75,19,211911805,19118,Le Lonzac,823,813,10
75,19,211911904,19119,Lostanges,150,150,0
75,19,211912001,19120,Louignac,247,241,6
75,19,211912100,19121,Lubersac,2288,2246,42
75,19,211912209,19122,Madranges,191,184,7
75,19,200055200,19123,Malemort,8216,8050,166
75,19,211912407,19124,Mansac,1500,1479,21
75,19,211912506,19125,Marcillac-la-Croisille,821,807,14
75,19,211912605,19126,Marcillac-la-Croze,172,172,0
75,19,211912803,19128,Margerides,315,309,6
75,19,211912902,19129,Masseret,668,660,8
75,19,211913009,19130,Maussac,452,441,11
75,19,211913108,19131,Meilhards,560,537,23
75,19,211913207,19132,Ménoire,134,133,1
75,19,211913306,19133,Mercoeur,242,241,1
75,19,211913405,19134,Merlines,715,697,18
75,19,211913504,19135,Mestes,351,345,6
75,19,211913603,19136,Meymac,2494,2291,203
75,19,211913702,19137,Meyrignac-l'Église,63,63,0
75,19,211913801,19138,Meyssac,1314,1261,53
75,19,211913900,19139,Millevaches,74,73,1
75,19,211914007,19140,Monceaux-sur-Dordogne,652,633,19
75,19,211914106,19141,Monestier-Merlines,288,282,6
75,19,211914205,19142,Monestier-Port-Dieu,112,111,1
75,19,200096402,19143,Montaignac-sur-Doustre,667,655,12
75,19,211914403,19144,Montgibaud,244,239,5
75,19,211914502,19145,Moustier-Ventadour,519,442,77
75,19,211914601,19146,Naves,2552,2339,213
75,19,211914700,19147,Nespouls,649,637,12
75,19,211914809,19148,Neuvic,1916,1664,252
75,19,211914908,19149,Neuville,209,205,4
75,19,211915004,19150,Noailhac,371,355,16
75,19,211915103,19151,Noailles,955,936,19
75,19,211915202,19152,Nonards,456,449,7
75,19,211915301,19153,Objat,3743,3662,81
75,19,211915400,19154,Orgnac-sur-Vézère,330,321,9
75,19,211915509,19155,Orliac-de-Bar,267,262,5
75,19,211915608,19156,Palazinges,167,165,2
75,19,211915707,19157,Palisse,223,221,2
75,19,211915806,19158,Pandrignes,170,166,4
75,19,211915905,19159,Péret-Bel-Air,88,87,1
75,19,211916002,19160,Pérols-sur-Vézère,196,194,2
75,19,211916101,19161,Perpezac-le-Blanc,461,453,8
75,19,211916200,19162,Perpezac-le-Noir,1240,1223,17
75,19,211916309,19163,Le Pescher,316,313,3
75,19,211916408,19164,Peyrelevade,841,830,11
75,19,211916507,19165,Peyrissac,122,119,3
75,19,211916606,19166,Pierrefitte,92,92,0
75,19,211916705,19167,Confolent-Port-Dieu,42,42,0
75,19,211916804,19168,Pradines,85,81,4
75,19,211916903,19169,Puy-d'Arnac,293,291,2
75,19,211917000,19170,Queyssac-les-Vignes,232,222,10
75,19,211917109,19171,Reygade,190,187,3
75,19,211917208,19172,Rilhac-Treignac,119,114,5
75,19,211917307,19173,Rilhac-Xaintrie,317,307,10
75,19,211917406,19174,La Roche-Canillac,128,127,1
75,19,211917505,19175,Roche-le-Peyroux,97,97,0
75,19,211917604,19176,Rosiers-d'Égletons,1129,1095,34
75,19,211917703,19177,Rosiers-de-Juillac,179,175,4
75,19,211917802,19178,Sadroc,1004,981,23
75,19,211917901,19179,Saillac,207,201,6
75,19,211918008,19180,Saint-Angel,720,702,18
75,19,211918107,19181,Saint-Augustin,426,419,7
75,19,211918206,19182,Saint-Aulaire,784,760,24
75,19,211918404,19184,Saint-Bazile-de-Meyssac,131,127,4
75,19,211918602,19186,Saint-Bonnet-Elvert,217,213,4
75,19,211918701,19187,Saint-Bonnet-la-Rivière,417,412,5
75,19,211918800,19188,Saint-Bonnet-l'Enfantier,425,419,6
75,19,211918909,19189,Saint-Bonnet-les-Tours-de-Merle,42,41,1
75,19,211919006,19190,Saint-Bonnet-près-Bort,194,189,5
75,19,211919105,19191,Saint-Cernin-de-Larche,657,644,13
75,19,211919204,19192,Saint-Chamant,509,503,6
75,19,211919303,19193,Saint-Cirgues-la-Loutre,177,172,5
75,19,211919402,19194,Saint-Clément,1384,1342,42
75,19,211919501,19195,Saint-Cyprien,392,386,6
75,19,211919600,19196,Saint-Cyr-la-Roche,490,469,21
75,19,211919808,19198,Saint-Éloy-les-Tuileries,106,106,0
75,19,211919907,19199,Saint-Étienne-aux-Clos,249,245,4
75,19,211920004,19200,Saint-Étienne-la-Geneste,96,88,8
75,19,211920103,19201,Saint-Exupéry-les-Roches,605,593,12
75,19,211920202,19202,Sainte-Féréole,2064,2019,45
75,19,211920301,19203,Sainte-Fortunade,1865,1773,92
75,19,211920400,19204,Saint-Fréjoux,269,266,3
75,19,211920509,19205,Saint-Geniez-ô-Merle,91,89,2
75,19,211920608,19206,Saint-Germain-Lavolps,93,92,1
75,19,211920707,19207,Saint-Germain-les-Vergnes,1169,1136,33
75,19,211920806,19208,Saint-Hilaire-Foissac,185,182,3
75,19,211920905,19209,Saint-Hilaire-les-Courbes,168,166,2
75,19,211921002,19210,Saint-Hilaire-Luc,65,65,0
75,19,211921101,19211,Saint-Hilaire-Peyroux,1030,1009,21
75,19,211921200,19212,Saint-Hilaire-Taurieux,110,104,6
75,19,211921309,19213,Saint-Jal,629,616,13
75,19,211921408,19214,Saint-Julien-aux-Bois,448,445,3
75,19,211921507,19215,Saint-Julien-le-Pèlerin,121,119,2
75,19,211921606,19216,Saint-Julien-le-Vendômois,249,244,5
75,19,211921705,19217,Saint-Julien-Maumont,156,151,5
75,19,211921903,19219,Sainte-Marie-Lapanouze,55,55,0
75,19,211922000,19220,Saint-Martial-de-Gimel,488,478,10
75,19,211922109,19221,Saint-Martial-Entraygues,95,93,2
75,19,211922208,19222,Saint-Martin-la-Méanne,350,338,12
75,19,211922307,19223,Saint-Martin-Sepert,266,264,2
75,19,211922505,19225,Saint-Merd-de-Lapleau,171,168,3
75,19,211922604,19226,Saint-Merd-les-Oussines,123,122,1
75,19,211922703,19227,Saint-Mexant,1355,1319,36
75,19,211922802,19228,Saint-Pantaléon-de-Lapleau,66,66,0
75,19,211922901,19229,Saint-Pantaléon-de-Larche,4906,4808,98
75,19,211923008,19230,Saint-Pardoux-Corbier,398,390,8
75,19,211923107,19231,Saint-Pardoux-la-Croisille,178,176,2
75,19,211923206,19232,Saint-Pardoux-le-Neuf,80,78,2
75,19,211923305,19233,Saint-Pardoux-le-Vieux,307,294,13
75,19,211923404,19234,Saint-Pardoux-l'Ortigier,488,482,6
75,19,211923503,19235,Saint-Paul,241,235,6
75,19,211923602,19236,Saint-Priest-de-Gimel,485,475,10
75,19,211923701,19237,Saint-Privat,1068,1047,21
75,19,211923800,19238,Saint-Rémy,229,221,8
75,19,211923909,19239,Saint-Robert,302,294,8
75,19,211924006,19240,Saint-Salvadour,302,288,14
75,19,211924105,19241,Saint-Setiers,286,282,4
75,19,211924204,19242,Saint-Solve,473,455,18
75,19,211924303,19243,Saint-Sornin-Lavolps,865,848,17
75,19,211924402,19244,Saint-Sulpice-les-Bois,83,82,1
75,19,211924501,19245,Saint-Sylvain,138,133,5
75,19,211924600,19246,Saint-Viance,1926,1883,43
75,19,211924709,19247,Saint-Victour,202,194,8
75,19,211924808,19248,Saint-Ybard,707,694,13
75,19,211924907,19249,Saint-Yrieix-le-Déjalat,342,338,4
75,19,211925003,19250,Salon-la-Tour,681,675,6
75,19,211925102,19251,Sarran,282,274,8
75,19,200062933,19252,Sarroux - Saint Julien,869,853,16
75,19,211925300,19253,Segonzac,224,222,2
75,19,211925409,19254,Ségur-le-Château,203,202,1
75,19,211925508,19255,Seilhac,1826,1789,37
75,19,211925607,19256,Sérandon,351,345,6
75,19,211925706,19257,Sérilhac,276,272,4
75,19,211925805,19258,Servières-le-Château,604,595,9
75,19,211925904,19259,Sexcles,236,232,4
75,19,211926001,19260,Sioniac,225,218,7
75,19,211926118,19261,Sornac,763,755,8
75,19,211926209,19262,Soudaine-Lavinadière,161,145,16
75,19,211926308,19263,Soudeilles,304,293,11
75,19,211926407,19264,Soursac,512,508,4
75,19,211926506,19265,Tarnac,356,348,8
75,19,211926605,19266,Thalamy,107,103,4
75,19,211926803,19268,Toy-Viam,37,37,0
75,19,211926902,19269,Treignac,1352,1268,84
75,19,211927009,19270,Troche,551,545,6
75,19,211927108,19271,Tudeils,255,250,5
75,19,211927207,19272,Tulle,14973,14314,659
75,19,211927306,19273,Turenne,829,809,20
75,19,211927405,19274,Ussac,4354,4234,120
75,19,211927504,19275,Ussel,9530,9162,368
75,19,211927603,19276,Uzerche,2846,2787,59
75,19,211927702,19277,Valiergues,151,146,5
75,19,211927801,19278,Varetz,2538,2495,43
75,19,211927900,19279,Vars-sur-Roseix,406,396,10
75,19,211928007,19280,Végennes,183,179,4
75,19,211928106,19281,Veix,78,71,7
75,19,211928304,19283,Veyrières,78,77,1
75,19,211928403,19284,Viam,87,84,3
75,19,211928502,19285,Vigeois,1317,1285,32
75,19,211928601,19286,Vignols,542,533,9
75,19,211928700,19287,Vitrac-sur-Montane,278,272,6
75,19,211928809,19288,Voutezac,1404,1235,169
75,19,211928908,19289,Yssandon,699,678,21
27,21,212100010,21001,Agencourt,509,457,52
27,21,212100028,21002,Agey,267,264,3
27,21,212100036,21003,Ahuy,1620,1591,29
27,21,212100044,21004,Aignay-le-Duc,272,266,6
27,21,212100051,21005,Aiserey,1483,1467,16
27,21,212100069,21006,Aisey-sur-Seine,173,172,1
27,21,212100077,21007,Aisy-sous-Thil,237,219,18
27,21,212100085,21008,Alise-Sainte-Reine,579,572,7
27,21,212100093,21009,Allerey,179,178,1
27,21,212100101,21010,Aloxe-Corton,140,134,6
27,21,212100119,21011,Ampilly-les-Bordes,83,83,0
27,21,212100127,21012,Ampilly-le-Sec,356,343,13
27,21,212100135,21013,Ancey,457,449,8
27,21,212100143,21014,Antheuil,62,62,0
27,21,212100150,21015,Antigny-la-Ville,90,90,0
27,21,212100168,21016,Arceau,1004,987,17
27,21,212100176,21017,Arcenant,523,505,18
27,21,212100184,21018,Arcey,54,53,1
27,21,212100200,21020,Arconcey,230,222,8
27,21,212100218,21021,Arc-sur-Tille,2656,2608,48
27,21,212100226,21022,Argilly,549,538,11
27,21,212100234,21023,Arnay-le-Duc,1407,1377,30
27,21,212100242,21024,Arnay-sous-Vitteaux,113,113,0
27,21,212100259,21025,Arrans,68,66,2
27,21,212100267,21026,Asnières-en-Montagne,198,190,8
27,21,212100275,21027,Asnières-lès-Dijon,1338,1315,23
27,21,212100283,21028,Athée,792,782,10
27,21,212100291,21029,Athie,78,77,1
27,21,212100309,21030,Aubaine,89,88,1
27,21,212100317,21031,Aubigny-en-Plaine,540,535,5
27,21,212100325,21032,Aubigny-la-Ronce,172,167,5
27,21,212100333,21033,Aubigny-lès-Sombernon,159,157,2
27,21,212100341,21034,Autricourt,134,133,1
27,21,212100358,21035,Auvillars-sur-Saône,340,336,4
27,21,212100366,21036,Auxant,82,79,3
27,21,212100374,21037,Auxey-Duresses,307,295,12
27,21,212100382,21038,Auxonne,7709,7621,88
27,21,212100390,21039,Avelanges,37,37,0
27,21,212100408,21040,Avosnes,100,98,2
27,21,212100416,21041,Avot,191,188,3
27,21,212100424,21042,Bagnot,163,159,4
27,21,212100432,21043,Baigneux-les-Juifs,219,210,9
27,21,212100440,21044,Balot,101,100,1
27,21,212100457,21045,Barbirey-sur-Ouche,216,208,8
27,21,212100465,21046,Bard-le-Régulier,72,71,1
27,21,212100473,21047,Bard-lès-Époisses,70,69,1
27,21,212100481,21048,Barges,665,655,10
27,21,212100499,21049,Barjon,45,43,2
27,21,212100507,21050,Baubigny,215,209,6
27,21,212100515,21051,Baulme-la-Roche,90,87,3
27,21,212100523,21052,Beaulieu,28,24,4
27,21,212100531,21053,Beaumont-sur-Vingeanne,203,200,3
27,21,212100549,21054,Beaune,20808,20122,686
27,21,212100556,21055,Beaunotte,14,14,0
27,21,212100564,21056,Beire-le-Châtel,899,886,13
27,21,212100572,21057,Beire-le-Fort,356,352,4
27,21,212100580,21058,Belan-sur-Ource,250,245,5
27,21,212100598,21059,Bellefond,921,895,26
27,21,212100606,21060,Belleneuve,1629,1604,25
27,21,212100614,21061,Bellenod-sur-Seine,69,67,2
27,21,212100622,21062,Bellenot-sous-Pouilly,224,215,9
27,21,212100630,21063,Beneuvre,95,89,6
27,21,212100648,21064,Benoisey,110,107,3
27,21,212100655,21065,Bessey-en-Chaume,128,124,4
27,21,212100663,21066,Bessey-la-Cour,52,51,1
27,21,212100671,21067,Bessey-lès-Cîteaux,695,686,9
27,21,212100689,21068,Beurey-Bauguay,106,101,5
27,21,212100697,21069,Beurizot,123,122,1
27,21,212100705,21070,Bévy,140,136,4
27,21,212100713,21071,Bèze,729,711,18
27,21,212100721,21072,Bézouotte,192,188,4
27,21,212100747,21074,Billey,255,251,4
27,21,212100754,21075,Billy-lès-Chanceaux,70,69,1
27,21,212100762,21076,Binges,853,845,8
27,21,212100770,21077,Bissey-la-Côte,132,130,2
27,21,212100788,21078,Bissey-la-Pierre,78,73,5
27,21,212100796,21079,Blagny-sur-Vingeanne,130,128,2
27,21,212100804,21080,Blaisy-Bas,653,639,14
27,21,212100812,21081,Blaisy-Haut,128,127,1
27,21,212100820,21082,Blancey,60,58,2
27,21,212100838,21083,Blanot,124,123,1
27,21,200018695,21084,Source-Seine,63,62,1
27,21,212100853,21085,Bligny-le-Sec,147,141,6
27,21,212100861,21086,Bligny-lès-Beaune,1271,1243,28
27,21,212100879,21087,Bligny-sur-Ouche,826,815,11
27,21,212100887,21088,Boncourt-le-Bois,285,278,7
27,21,212100895,21089,Bonnencontre,442,435,7
27,21,212100903,21090,Boudreville,64,61,3
27,21,212100911,21091,Bouhey,47,47,0
27,21,212100929,21092,Bouilland,233,228,5
27,21,212100937,21093,Bouix,154,150,4
27,21,212100945,21094,Bourberain,408,403,5
27,21,212100952,21095,Bousselange,49,47,2
27,21,212100960,21096,Boussenois,107,106,1
27,21,212100978,21097,Boussey,41,39,2
27,21,212100986,21098,Boux-sous-Salmaise,128,126,2
27,21,212100994,21099,Bouze-lès-Beaune,311,305,6
27,21,212101000,21100,Brain,34,34,0
27,21,212101018,21101,Braux,169,165,4
27,21,212101026,21102,Brazey-en-Morvan,143,140,3
27,21,212101034,21103,Brazey-en-Plaine,2406,2378,28
27,21,212101042,21104,Brémur-et-Vaurois,42,42,0
27,21,212101059,21105,Bressey-sur-Tille,1147,1134,13
27,21,212101067,21106,Bretenière,937,925,12
27,21,212101075,21107,Bretigny,929,905,24
27,21,212101083,21108,Brianny,112,111,1
27,21,212101091,21109,Brion-sur-Ource,223,216,7
27,21,212101109,21110,Brochon,790,660,130
27,21,212101117,21111,Brognon,322,319,3
27,21,212101125,21112,Broin,416,407,9
27,21,212101133,21113,Broindon,195,194,1
27,21,212101141,21114,Buffon,158,157,1
27,21,212101158,21115,Buncey,371,365,6
27,21,212101166,21116,Bure-les-Templiers,134,134,0
27,21,212101174,21117,Busseaut,50,48,2
27,21,212101182,21118,Busserotte-et-Montenaille,25,25,0
27,21,212101190,21119,Bussières,44,44,0
27,21,212101208,21120,La Bussière-sur-Ouche,162,160,2
27,21,212101216,21121,Bussy-la-Pesle,78,77,1
27,21,212101224,21122,Bussy-le-Grand,316,308,8
27,21,212101232,21123,Buxerolles,38,33,5
27,21,212101240,21124,Censerey,183,177,6
27,21,212101257,21125,Cérilly,226,218,8
27,21,212101265,21126,Cessey-sur-Tille,618,611,7
27,21,212101273,21127,Chaignay,524,517,7
27,21,212101281,21128,Chailly-sur-Armançon,261,253,8
27,21,212101299,21129,Chambain,21,21,0
27,21,212101307,21130,Chambeire,402,398,4
27,21,212101315,21131,Chamblanc,530,467,63
27,21,212101323,21132,Chamboeuf,399,393,6
27,21,212101331,21133,Chambolle-Musigny,287,285,2
27,21,212101349,21134,Chamesson,249,241,8
27,21,212101356,21135,Champagne-sur-Vingeanne,318,309,9
27,21,212101364,21136,Champagny,26,26,0
27,21,212101372,21137,Champ-d'Oiseau,103,102,1
27,21,212101380,21138,Champdôtre,601,593,8
27,21,212101398,21139,Champeau-en-Morvan,227,222,5
27,21,212101406,21140,Champignolles,77,76,1
27,21,212101414,21141,Champrenault,37,36,1
27,21,212101422,21142,Chanceaux,217,214,3
27,21,212101430,21143,Channay,64,61,3
27,21,212101448,21144,Charencey,39,38,1
27,21,212101455,21145,Charigny,38,37,1
27,21,212101463,21146,Charmes,126,123,3
27,21,212101471,21147,Charny,36,35,1
27,21,212101489,21148,Charrey-sur-Saône,345,341,4
27,21,212101497,21149,Charrey-sur-Seine,140,137,3
27,21,212101505,21150,Chassagne-Montrachet,292,288,4
27,21,212101513,21151,Chassey,97,92,5
27,21,212101521,21152,Châteauneuf,82,80,2
27,21,212101539,21153,Châtellenot,161,155,6
27,21,212101547,21154,Châtillon-sur-Seine,5690,5352,338
27,21,212101554,21155,Chaudenay-la-Ville,44,39,5
27,21,212101562,21156,Chaudenay-le-Château,49,49,0
27,21,212101570,21157,Chaugey,19,18,1
27,21,212101588,21158,Chaume-et-Courchamp,185,180,5
27,21,212101596,21159,La Chaume,101,98,3
27,21,212101604,21160,Chaume-lès-Baigneux,102,101,1
27,21,212101612,21161,Chaumont-le-Bois,83,78,5
27,21,212101620,21162,Chaux,490,482,8
27,21,212101638,21163,Chazeuil,194,189,5
27,21,212101646,21164,Chazilly,146,143,3
27,21,212101653,21165,Chemin-d'Aisey,71,70,1
27,21,212101661,21166,Chenôve,14491,14323,168
27,21,212101679,21167,Cheuge,128,124,4
27,21,212101687,21168,Chevannay,37,37,0
27,21,212101695,21169,Chevannes,171,166,5
27,21,212101703,21170,Chevigny-en-Valière,395,391,4
27,21,212101711,21171,Chevigny-Saint-Sauveur,11261,11055,206
27,21,212101729,21172,Chivres,298,294,4
27,21,212101737,21173,Chorey-les-Beaune,648,625,23
27,21,212101752,21175,Cirey-lès-Pontailler,187,186,1
27,21,212101760,21176,Civry-en-Montagne,126,124,2
27,21,212101778,21177,Clamerey,178,177,1
27,21,200085447,21178,Valforêt,323,313,10
27,21,212101794,21179,Clénay,916,905,11
27,21,212101802,21180,Cléry,159,155,4
27,21,212101810,21181,Clomot,136,134,2
27,21,212101828,21182,Collonges-lès-Bévy,96,95,1
27,21,200088508,21183,Collonges-et-Premières,1077,1064,13
27,21,212101844,21184,Colombier,69,68,1
27,21,212101851,21185,Combertault,540,520,20
27,21,212101869,21186,Comblanchien,624,607,17
27,21,212101877,21187,Commarin,125,120,5
27,21,212101893,21189,Corberon,442,433,9
27,21,212101901,21190,Corcelles-les-Arts,460,441,19
27,21,212101919,21191,Corcelles-lès-Cîteaux,837,811,26
27,21,212101927,21192,Corcelles-les-Monts,642,632,10
27,21,212101935,21193,Corgengoux,381,365,16
27,21,212101943,21194,Corgoloin,964,951,13
27,21,200069367,21195,Cormot-Vauchignon,220,216,4
27,21,212101968,21196,Corpeau,991,975,16
27,21,212101976,21197,Corpoyer-la-Chapelle,34,34,0
27,21,212101984,21198,Corrombles,261,251,10
27,21,212101992,21199,Corsaint,151,150,1
27,21,212102008,21200,Couchey,1129,1104,25
27,21,212102016,21201,Coulmier-le-Sec,245,240,5
27,21,212102024,21202,Courban,146,145,1
27,21,212102032,21203,Courcelles-Frémoy,131,130,1
27,21,212102040,21204,Courcelles-lès-Montbard,88,87,1
27,21,212102057,21205,Courcelles-lès-Semur,246,240,6
27,21,212102073,21207,Courlon,80,76,4
27,21,212102081,21208,Courtivron,166,162,4
27,21,212102099,21209,Couternon,1961,1920,41
27,21,212102107,21210,Créancey,543,528,15
27,21,212102115,21211,Crécey-sur-Tille,130,128,2
27,21,212102123,21212,Crépand,325,320,5
27,21,212102149,21214,Crugey,172,168,4
27,21,212102156,21215,Cuiserey,187,182,5
27,21,212102164,21216,Culètre,109,107,2
27,21,212102172,21217,Curley,136,132,4
27,21,212102180,21218,Curtil-Saint-Seine,116,116,0
27,21,212102198,21219,Curtil-Vergy,141,141,0
27,21,212102206,21220,Cussey-les-Forges,146,143,3
27,21,212102214,21221,Cussy-la-Colonne,41,39,2
27,21,212102222,21222,Cussy-le-Châtel,122,119,3
27,21,212102230,21223,Daix,1575,1541,34
27,21,212102248,21224,Dampierre-en-Montagne,65,61,4
27,21,212102255,21225,Dampierre-et-Flée,132,130,2
27,21,212102263,21226,Darcey,349,338,11
27,21,212102271,21227,Darois,508,500,8
27,21,212102289,21228,Détain-et-Bruant,142,142,0
27,21,212102297,21229,Diancey,97,95,2
27,21,212102305,21230,Diénay,386,378,8
27,21,212102313,21231,Dijon,162454,159106,3348
27,21,212102321,21232,Dompierre-en-Morvan,206,201,5
27,21,212102339,21233,Drambon,201,200,1
27,21,212102347,21234,Drée,63,63,0
27,21,212102354,21235,Duesme,54,51,3
27,21,212102362,21236,Ébaty,258,252,6
27,21,212102370,21237,Échalot,98,95,3
27,21,212102388,21238,Échannay,143,141,2
27,21,212102396,21239,Échenon,785,776,9
27,21,212102404,21240,Échevannes,324,322,2
27,21,212102412,21241,Échevronne,312,296,16
27,21,212102420,21242,Échigey,307,300,7
27,21,212102438,21243,Écutigny,77,75,2
27,21,212102446,21244,Éguilly,69,69,0
27,21,212102453,21245,Épagny,323,320,3
27,21,212102461,21246,Épernay-sous-Gevrey,178,174,4
27,21,212102479,21247,Époisses,776,769,7
27,21,212102487,21248,Éringes,60,59,1
27,21,212102495,21249,Esbarres,688,666,22
27,21,212102503,21250,Essarois,85,83,2
27,21,212102511,21251,Essey,311,284,27
27,21,212102529,21252,Étais,80,76,4
27,21,212102537,21253,Étalante,133,129,4
27,21,212102545,21254,L'Étang-Vergy,215,205,10
27,21,212102552,21255,Étaules,352,348,4
27,21,212102560,21256,Étevaux,321,314,7
27,21,212102578,21257,Étormay,70,68,2
27,21,212102586,21258,Étrochey,223,219,4
27,21,212102594,21259,Fain-lès-Montbard,290,280,10
27,21,212102602,21260,Fain-lès-Moutiers,154,150,4
27,21,212102610,21261,Fauverney,630,619,11
27,21,212102628,21262,Faverolles-lès-Lucey,30,30,0
27,21,212102636,21263,Fénay,1713,1673,40
27,21,212102644,21264,Le Fête,41,41,0
27,21,212102651,21265,Fixin,769,748,21
27,21,212102669,21266,Flacey,200,198,2
27,21,212102677,21267,Flagey-Echézeaux,514,501,13
27,21,212102685,21268,Flagey-lès-Auxonne,194,191,3
27,21,212102693,21269,Flammerans,459,450,9
27,21,212102701,21270,Flavignerot,219,215,4
27,21,212102719,21271,Flavigny-sur-Ozerain,277,274,3
27,21,200085413,21272,Le Val-Larrey,272,267,5
27,21,212102735,21273,Fleurey-sur-Ouche,1460,1442,18
27,21,212102743,21274,Foissy,167,164,3
27,21,212102750,21275,Foncegrive,135,132,3
27,21,212102768,21276,Fontaines-en-Duesmois,121,117,4
27,21,212102776,21277,Fontaine-Française,902,883,19
27,21,212102784,21278,Fontaine-lès-Dijon,8957,8756,201
27,21,212102792,21279,Fontaines-les-Sèches,25,25,0
27,21,212102800,21280,Fontangy,144,142,2
27,21,212102818,21281,Fontenelle,171,170,1
27,21,212102826,21282,Forléans,107,105,2
27,21,212102834,21283,Fraignot-et-Vesvrotte,67,66,1
27,21,212102842,21284,Francheville,288,280,8
27,21,212102859,21285,Franxault,507,501,6
27,21,212102867,21286,Frénois,89,88,1
27,21,212102875,21287,Fresnes,162,155,7
27,21,212102883,21288,Frôlois,163,162,1
27,21,212102891,21289,Fussey,124,116,8
27,21,212102909,21290,Gemeaux,938,923,15
27,21,212102917,21291,Genay,377,367,10
27,21,212102925,21292,Genlis,5234,5190,44
27,21,212102933,21293,Gergueil,119,119,0
27,21,212102941,21294,Gerland,444,435,9
27,21,212102958,21295,Gevrey-Chambertin,3159,3115,44
27,21,212102966,21296,Gevrolles,176,176,0
27,21,212102974,21297,Gilly-lès-Cîteaux,734,729,5
27,21,212102982,21298,Gissey-le-Vieil,108,105,3
27,21,212102990,21299,Gissey-sous-Flavigny,89,88,1
27,21,212103006,21300,Gissey-sur-Ouche,363,354,9
27,21,212103014,21301,Glanon,273,270,3
27,21,212103022,21302,Gomméville,124,122,2
27,21,212103030,21303,Les Goulles,12,12,0
27,21,212103048,21304,Grancey-le-Château-Neuvelle,266,257,9
27,21,212103055,21305,Grancey-sur-Ource,194,193,1
27,21,212103063,21306,Grenant-lès-Sombernon,216,212,4
27,21,212103071,21307,Grésigny-Sainte-Reine,148,144,4
27,21,212103089,21308,Grignon,212,200,12
27,21,212103097,21309,Griselles,90,86,4
27,21,212103105,21310,Grosbois-en-Montagne,115,113,2
27,21,212103113,21311,Grosbois-lès-Tichey,73,71,2
27,21,212103121,21312,Gurgy-la-Ville,29,26,3
27,21,212103139,21313,Gurgy-le-Château,46,46,0
27,21,212103147,21314,Hauteroche,81,79,2
27,21,212103154,21315,Hauteville-lès-Dijon,1245,1228,17
27,21,212103162,21316,Heuilley-sur-Saône,329,325,4
27,21,212103170,21317,Is-sur-Tille,4436,4360,76
27,21,212103196,21319,Izeure,919,905,14
27,21,212103204,21320,Izier,803,790,13
27,21,212103212,21321,Jailly-les-Moulins,77,75,2
27,21,212103220,21322,Jallanges,321,308,13
27,21,212103238,21323,Jancigny,145,143,2
27,21,212103246,21324,Jeux-lès-Bard,53,52,1
27,21,212103253,21325,Jouey,186,184,2
27,21,212103261,21326,Jours-lès-Baigneux,76,72,4
27,21,200059905,21327,Val-Mont,256,252,4
27,21,212103287,21328,Juillenay,49,49,0
27,21,212103295,21329,Juilly,41,39,2
27,21,212103303,21330,Labergement-Foigney,379,376,3
27,21,212103311,21331,Labergement-lès-Auxonne,337,333,4
27,21,212103329,21332,Labergement-lès-Seurre,1014,1002,12
27,21,212103337,21333,Labruyère,230,225,5
27,21,212103345,21334,Lacanche,500,488,12
27,21,212103352,21335,Lacour-d'Arcenay,115,112,3
27,21,212103360,21336,Laignes,675,664,11
27,21,212103378,21337,Lamarche-sur-Saône,1376,1359,17
27,21,212103386,21338,Lamargelle,165,157,8
27,21,212103394,21339,Lantenay,530,511,19
27,21,212103402,21340,Lanthes,256,251,5
27,21,212103410,21341,Lantilly,107,103,4
27,21,212103428,21342,Laperrière-sur-Saône,441,433,8
27,21,212103436,21343,Larrey,97,95,2
27,21,212103444,21344,Lechâtelet,227,222,5
27,21,212103451,21345,Léry,194,193,1
27,21,212103469,21346,Leuglay,301,298,3
27,21,212103477,21347,Levernois,359,342,17
27,21,212103485,21348,Licey-sur-Vingeanne,104,103,1
27,21,212103493,21349,Liernais,485,480,5
27,21,212103501,21350,Lignerolles,56,55,1
27,21,212103519,21351,Longchamp,1284,1163,121
27,21,200083046,21352,Longeault-Pluvault,1166,1143,23
27,21,212103535,21353,Longecourt-en-Plaine,1244,1220,24
27,21,212103543,21354,Longecourt-lès-Culêtre,55,55,0
27,21,212103550,21355,Longvic,8762,8631,131
27,21,212103568,21356,Losne,1653,1635,18
27,21,212103576,21357,Louesme,118,116,2
27,21,212103584,21358,Lucenay-le-Duc,191,187,4
27,21,212103592,21359,Lucey,60,57,3
27,21,212103600,21360,Lusigny-sur-Ouche,122,119,3
27,21,212103618,21361,Lux,523,512,11
27,21,212103626,21362,Maconge,135,132,3
27,21,212103634,21363,Magnien,322,318,4
27,21,212103642,21364,Magny-Lambert,84,81,3
27,21,212103659,21365,Magny-la-Ville,78,78,0
27,21,212103667,21366,Magny-lès-Aubigny,224,218,6
27,21,212103675,21367,Magny-Montarlot,265,260,5
27,21,212103683,21368,Magny-lès-Villers,254,242,12
27,21,212103691,21369,Magny-Saint-Médard,319,315,4
27,21,212103709,21370,Magny-sur-Tille,913,894,19
27,21,212103717,21371,Les Maillys,824,804,20
27,21,212103725,21372,Maisey-le-Duc,87,82,5
27,21,212103733,21373,Mâlain,799,784,15
27,21,212103741,21374,Maligny,186,180,6
27,21,212103758,21375,Manlay,200,195,5
27,21,212103766,21376,Marandeuil,103,102,1
27,21,212103774,21377,Marcellois,46,46,0
27,21,212103782,21378,Marcenay,92,90,2
27,21,212103790,21379,Marcheseuil,156,155,1
27,21,212103808,21380,Marcigny-sous-Thil,57,55,2
27,21,212103816,21381,Marcilly-et-Dracy,94,90,4
27,21,212103824,21382,Marcilly-Ogny,191,188,3
27,21,212103832,21383,Marcilly-sur-Tille,1732,1713,19
27,21,212103840,21384,Marey-lès-Fussey,66,65,1
27,21,212103857,21385,Marey-sur-Tille,333,326,7
27,21,212103865,21386,Marigny-le-Cahouët,338,326,12
27,21,212103873,21387,Marigny-lès-Reullée,223,218,5
27,21,212103881,21388,Marliens,608,597,11
27,21,212103899,21389,Marmagne,204,203,1
27,21,212103907,21390,Marsannay-la-Côte,5385,5311,74
27,21,212103915,21391,Marsannay-le-Bois,851,841,10
27,21,212103923,21392,Martrois,62,60,2
27,21,212103931,21393,Massingy,163,159,4
27,21,212103949,21394,Massingy-lès-Semur,161,156,5
27,21,212103956,21395,Massingy-lès-Vitteaux,93,92,1
27,21,212103964,21396,Mauvilly,70,68,2
27,21,212103972,21397,Mavilly-Mandelot,180,177,3
27,21,212103980,21398,Maxilly-sur-Saône,370,362,8
27,21,212103998,21399,Meilly-sur-Rouvres,222,220,2
27,21,212104004,21400,Le Meix,46,46,0
27,21,212104012,21401,Meloisey,330,320,10
27,21,212104020,21402,Menesble,12,12,0
27,21,212104038,21403,Ménessaire,87,86,1
27,21,212104046,21404,Ménétreux-le-Pitois,418,409,9
27,21,212104053,21405,Merceuil,826,804,22
27,21,212104061,21406,Mesmont,256,254,2
27,21,212104079,21407,Messanges,249,240,9
27,21,212104087,21408,Messigny-et-Vantoux,1734,1705,29
27,21,212104095,21409,Meuilley,455,448,7
27,21,212104103,21410,Meulson,31,29,2
27,21,212104111,21411,Meursanges,588,570,18
27,21,212104129,21412,Meursault,1449,1404,45
27,21,212104137,21413,Millery,420,405,15
27,21,212104145,21414,Mimeure,328,319,9
27,21,212104152,21415,Minot,188,181,7
27,21,212104160,21416,Mirebeau-sur-Bèze,2008,1972,36
27,21,212104178,21417,Missery,107,107,0
27,21,212104186,21418,Moitron,62,58,4
27,21,212104194,21419,Molesme,269,264,5
27,21,212104202,21420,Molinot,164,160,4
27,21,212104210,21421,Moloy,240,237,3
27,21,212104228,21422,Molphey,134,130,4
27,21,212104236,21423,Montagny-lès-Beaune,775,756,19
27,21,212104244,21424,Montagny-lès-Seurre,114,112,2
27,21,212104251,21425,Montbard,4965,4831,134
27,21,212104269,21426,Montberthault,212,208,4
27,21,212104277,21427,Montceau-et-Écharnant,197,192,5
27,21,212104285,21428,Monthelie,161,159,2
27,21,212104293,21429,Montigny-Montfort,301,295,6
27,21,212104301,21430,Montigny-Saint-Barthélemy,90,85,5
27,21,212104319,21431,Montigny-sur-Armançon,154,150,4
27,21,212104327,21432,Montigny-sur-Aube,254,250,4
27,21,212104335,21433,Montigny-Mornay-Villeneuve-sur-Vingeanne,390,383,7
27,21,212104343,21434,Montlay-en-Auxois,195,193,2
27,21,212104350,21435,Montliot-et-Courcelles,304,298,6
27,21,212104368,21436,Montmain,151,150,1
27,21,212104376,21437,Montmançon,249,244,5
27,21,212104384,21438,Montmoyen,75,73,2
27,21,212104392,21439,Montoillot,91,91,0
27,21,212104400,21440,Montot,203,198,5
27,21,212104418,21441,Mont-Saint-Jean,243,236,7
27,21,212104426,21442,Morey-Saint-Denis,679,669,10
27,21,212104442,21444,Mosson,68,68,0
27,21,212104459,21445,La Motte-Ternant,149,147,2
27,21,212104467,21446,Moutiers-Saint-Jean,265,260,5
27,21,212104475,21447,Musigny,84,84,0
27,21,212104483,21448,Mussy-la-Fosse,92,90,2
27,21,212104491,21449,Nan-sous-Thil,184,178,6
27,21,212104509,21450,Nantoux,170,166,4
27,21,212104517,21451,Nesle-et-Massoult,78,77,1
27,21,200088029,21452,Neuilly-Crimolois,3141,3104,37
27,21,212104541,21454,Nicey,109,109,0
27,21,212104558,21455,Nod-sur-Seine,205,202,3
27,21,212104566,21456,Nogent-lès-Montbard,161,153,8
27,21,212104574,21457,Noidan,78,73,5
27,21,212104582,21458,Noiron-sous-Gevrey,1178,1150,28
27,21,212104590,21459,Noiron-sur-Bèze,236,231,5
27,21,212104608,21460,Noiron-sur-Seine,64,63,1
27,21,212104616,21461,Nolay,1448,1426,22
27,21,212104624,21462,Norges-la-Ville,966,948,18
27,21,212104632,21463,Normier,59,58,1
27,21,212104640,21464,Nuits-Saint-Georges,5421,5332,89
27,21,212104657,21465,Obtrée,79,78,1
27,21,212104665,21466,Oigny,46,42,4
27,21,212104673,21467,Oisilly,130,126,4
27,21,212104681,21468,Orain,87,86,1
27,21,212104699,21469,Orgeux,468,455,13
27,21,212104707,21470,Origny,56,52,4
27,21,212104715,21471,Orret,14,14,0
27,21,212104723,21472,Orville,173,172,1
27,21,212104731,21473,Ouges,1627,1616,11
27,21,212104749,21474,Pagny-la-Ville,425,414,11
27,21,212104756,21475,Pagny-le-Château,510,500,10
27,21,212104764,21476,Painblanc,169,164,5
27,21,212104772,21477,Panges,84,82,2
27,21,212104780,21478,Pasques,287,282,5
27,21,212104798,21479,Pellerey,84,83,1
27,21,212104806,21480,Pernand-Vergelesses,246,237,9
27,21,212104814,21481,Perrigny-lès-Dijon,2201,2178,23
27,21,212104822,21482,Perrigny-sur-l'Ognon,641,626,15
27,21,212104830,21483,Pichanges,304,299,5
27,21,212104848,21484,Planay,69,64,5
27,21,212104855,21485,Plombières-lès-Dijon,2581,2535,46
27,21,212104871,21487,Pluvet,424,418,6
27,21,212104889,21488,Poinçon-lès-Larrey,194,192,2
27,21,212104897,21489,Poiseul-la-Grange,57,53,4
27,21,212104905,21490,Poiseul-la-Ville-et-Laperrière,162,156,6
27,21,212104913,21491,Poiseul-lès-Saulx,71,70,1
27,21,212104921,21492,Pommard,461,449,12
27,21,212104939,21493,Poncey-lès-Athée,576,568,8
27,21,212104947,21494,Poncey-sur-l'Ignon,84,84,0
27,21,212104954,21495,Pont,160,159,1
27,21,212104962,21496,Pontailler-sur-Saône,1313,1297,16
27,21,212104970,21497,Pont-et-Massène,187,172,15
27,21,212104988,21498,Posanges,51,49,2
27,21,212104996,21499,Pothières,206,201,5
27,21,212105001,21500,Pouillenay,567,558,9
27,21,212105019,21501,Pouilly-en-Auxois,1656,1537,119
27,21,212105027,21502,Pouilly-sur-Saône,614,607,7
27,21,212105035,21503,Pouilly-sur-Vingeanne,139,135,4
27,21,212105043,21504,Prâlon,93,90,3
27,21,212105050,21505,Précy-sous-Thil,719,709,10
27,21,212105068,21506,Premeaux-Prissey,367,362,5
27,21,212105084,21508,Prenois,471,462,9
27,21,212105100,21510,Prusly-sur-Ource,154,153,1
27,21,212105118,21511,Puits,135,131,4
27,21,212105126,21512,Puligny-Montrachet,388,378,10
27,21,212105142,21514,Quemigny-sur-Seine,105,102,3
27,21,212105159,21515,Quetigny,9287,8936,351
27,21,212105167,21516,Quincerot,83,79,4
27,21,212105175,21517,Quincey,519,505,14
27,21,212105183,21518,Quincy-le-Vicomte,202,200,2
27,21,212105191,21519,Recey-sur-Ource,350,345,5
27,21,212105209,21520,Remilly-en-Montagne,152,152,0
27,21,212105217,21521,Remilly-sur-Tille,910,899,11
27,21,212105225,21522,Renève,468,459,9
27,21,212105233,21523,Reulle-Vergy,160,158,2
27,21,212105241,21524,Riel-les-Eaux,91,91,0
27,21,212105258,21525,La Roche-en-Brenil,912,899,13
27,21,212105266,21526,Rochefort-sur-Brévon,42,42,0
27,21,212105274,21527,La Rochepot,290,281,9
27,21,212105282,21528,La Roche-Vanneau,140,138,2
27,21,212105290,21529,Roilly,51,50,1
27,21,212105308,21530,Rougemont,146,145,1
27,21,212105316,21531,Rouvray,494,490,4
27,21,212105324,21532,Rouvres-en-Plaine,1167,1155,12
27,21,212105332,21533,Rouvres-sous-Meilly,90,87,3
27,21,212105340,21534,Ruffey-lès-Beaune,782,739,43
27,21,212105357,21535,Ruffey-lès-Echirey,1351,1340,11
27,21,212105365,21536,Sacquenay,299,289,10
27,21,212105373,21537,Saffres,119,117,2
27,21,212105381,21538,Saint-Andeux,120,117,3
27,21,212105399,21539,Saint-Anthot,56,55,1
27,21,212105407,21540,Saint-Apollinaire,7617,7518,99
27,21,212105415,21541,Saint-Aubin,222,213,9
27,21,212105423,21542,Saint-Bernard,459,453,6
27,21,212105431,21543,Saint-Broing-les-Moines,200,192,8
27,21,212105449,21544,Sainte-Colombe-en-Auxois,57,56,1
27,21,212105456,21545,Sainte-Colombe-sur-Seine,939,923,16
27,21,212105464,21546,Saint-Didier,212,205,7
27,21,212105472,21547,Saint-Euphrône,212,209,3
27,21,212105480,21548,Saint-Germain-de-Modéon,182,179,3
27,21,212105498,21549,Saint-Germain-le-Rocheux,86,82,4
27,21,212105506,21550,Saint-Germain-lès-Senailly,129,125,4
27,21,212105522,21552,Saint-Hélier,37,36,1
27,21,212105530,21553,Saint-Jean-de-Boeuf,111,107,4
27,21,212105548,21554,Saint-Jean-de-Losne,1049,1039,10
27,21,212105555,21555,Saint-Julien,1533,1513,20
27,21,212105563,21556,Saint-Léger-Triey,248,245,3
27,21,212105571,21557,Saint-Marc-sur-Seine,112,109,3
27,21,212105589,21558,Sainte-Marie-la-Blanche,928,897,31
27,21,212105597,21559,Sainte-Marie-sur-Ouche,709,695,14
27,21,212105605,21560,Saint-Martin-de-la-Mer,305,303,2
27,21,212105613,21561,Saint-Martin-du-Mont,463,462,1
27,21,212105621,21562,Saint-Maurice-sur-Vingeanne,205,199,6
27,21,212105639,21563,Saint-Mesmin,119,117,2
27,21,212105647,21564,Saint-Nicolas-lès-Cîteaux,407,398,9
27,21,212105654,21565,Saint-Philibert,527,519,8
27,21,212105662,21566,Saint-Pierre-en-Vaux,142,139,3
27,21,212105670,21567,Saint-Prix-lès-Arnay,214,209,5
27,21,212105688,21568,Saint-Rémy,699,688,11
27,21,212105696,21569,Saint-Romain,223,212,11
27,21,212105704,21570,Sainte-Sabine,188,172,16
27,21,212105712,21571,Saint-Sauveur,233,231,2
27,21,212105720,21572,Saint-Seine-en-Bâche,400,395,5
27,21,212105738,21573,Saint-Seine-l'Abbaye,373,368,5
27,21,212105746,21574,Saint-Seine-sur-Vingeanne,392,383,9
27,21,212105753,21575,Saint-Symphorien-sur-Saône,338,334,4
27,21,212105761,21576,Saint-Thibault,163,159,4
27,21,212105779,21577,Saint-Usage,1362,1332,30
27,21,212105787,21578,Saint-Victor-sur-Ouche,332,328,4
27,21,212105795,21579,Salives,213,207,6
27,21,212105803,21580,Salmaise,135,133,2
27,21,212105811,21581,Samerey,145,141,4
27,21,212105829,21582,Santenay,924,913,11
27,21,212105837,21583,Santosse,59,57,2
27,21,212105845,21584,Saulieu,2454,2346,108
27,21,212105852,21585,Saulon-la-Chapelle,1010,988,22
27,21,212105860,21586,Saulon-la-Rue,723,713,10
27,21,212105878,21587,Saulx-le-Duc,254,250,4
27,21,212105886,21588,Saussey,68,67,1
27,21,212105894,21589,Saussy,102,101,1
27,21,212105902,21590,Savigny-lès-Beaune,1329,1288,41
27,21,212105910,21591,Savigny-le-Sec,876,862,14
27,21,212105928,21592,Savigny-sous-Mâlain,242,231,11
27,21,212105936,21593,Savilly,79,79,0
27,21,212105944,21594,Savoisy,197,194,3
27,21,212105951,21595,Savolles,159,157,2
27,21,212105969,21596,Savouges,388,382,6
27,21,212105977,21597,Segrois,55,54,1
27,21,212105985,21598,Seigny,168,167,1
27,21,212105993,21599,Selongey,2425,2392,33
27,21,212106009,21600,Semarey,129,125,4
27,21,212106017,21601,Semezanges,98,94,4
27,21,212106025,21602,Semond,28,28,0
27,21,212106033,21603,Semur-en-Auxois,4466,4114,352
27,21,212106041,21604,Senailly,140,137,3
27,21,212106058,21605,Sennecey-lès-Dijon,2122,2068,54
27,21,212106066,21606,Ladoix-Serrigny,1843,1796,47
27,21,212106074,21607,Seurre,2335,2313,22
27,21,212106082,21608,Sincey-lès-Rouvray,100,99,1
27,21,212106090,21609,Soirans,509,502,7
27,21,212106108,21610,Soissons-sur-Nacey,369,361,8
27,21,212106116,21611,Sombernon,928,915,13
27,21,212106124,21612,Souhey,86,85,1
27,21,212106132,21613,Soussey-sur-Brionne,166,158,8
27,21,212106140,21614,Spoy,405,401,4
27,21,212106157,21615,Sussey,247,239,8
27,21,212106165,21616,Tailly,203,196,7
27,21,212106173,21617,Talant,12004,11788,216
27,21,212106181,21618,Talmay,574,564,10
27,21,212106199,21619,Tanay,222,216,6
27,21,212106207,21620,Tarsul,162,157,5
27,21,212106223,21622,Tart-le-Bas,256,251,5
27,21,200086981,21623,Tart,1594,1563,31
27,21,212106249,21624,Tellecey,142,141,1
27,21,212106256,21625,Ternant,87,84,3
27,21,212106264,21626,Terrefondrée,64,62,2
27,21,212106272,21627,Thenissey,101,92,9
27,21,212106280,21628,Thoires,65,65,0
27,21,212106298,21629,Thoisy-la-Berchère,312,307,5
27,21,212106306,21630,Thoisy-le-Désert,224,216,8
27,21,212106314,21631,Thomirey,55,55,0
27,21,212106322,21632,Thorey-en-Plaine,1081,1050,31
27,21,212106330,21633,Thorey-sous-Charny,192,191,1
27,21,212106348,21634,Thorey-sur-Ouche,137,137,0
27,21,212106355,21635,Thoste,108,102,6
27,21,212106363,21636,Thury,262,254,8
27,21,212106371,21637,Tichey,219,214,5
27,21,212106389,21638,Til-Châtel,1152,1144,8
27,21,212106397,21639,Tillenay,753,738,15
27,21,212106405,21640,Torcy-et-Pouligny,222,217,5
27,21,212106413,21641,Touillon,467,461,6
27,21,212106421,21642,Toutry,421,413,8
27,21,212106439,21643,Tréclun,441,433,8
27,21,212106447,21644,Trochères,173,169,4
27,21,212106454,21645,Trouhans,607,594,13
27,21,212106462,21646,Trouhaut,129,126,3
27,21,212106470,21647,Trugny,121,119,2
27,21,212106488,21648,Turcey,176,175,1
27,21,212106496,21649,Uncey-le-Franc,53,53,0
27,21,212106504,21650,Urcy,151,147,4
27,21,212106512,21651,Val-Suzon,203,199,4
27,21,212106520,21652,Vandenesse-en-Auxois,302,295,7
27,21,212106538,21653,Vannaire,51,50,1
27,21,212106553,21655,Vanvey,240,231,9
27,21,212106561,21656,Varanges,704,691,13
27,21,212106579,21657,Varois-et-Chaignot,2024,1990,34
27,21,212106595,21659,Vaux-Saules,179,167,12
27,21,212106603,21660,Veilly,54,53,1
27,21,212106611,21661,Velars-sur-Ouche,1806,1777,29
27,21,212106629,21662,Velogny,32,32,0
27,21,212106637,21663,Venarey-les-Laumes,2853,2811,42
27,21,212106645,21664,Verdonnet,86,82,4
27,21,212106652,21665,Vernois-lès-Vesvres,167,165,2
27,21,212106660,21666,Vernot,97,94,3
27,21,212106678,21667,Véronnes,403,396,7
27,21,212106694,21669,Verrey-sous-Drée,84,84,0
27,21,212106702,21670,Verrey-sous-Salmaise,293,288,5
27,21,212106710,21671,Vertault,51,50,1
27,21,212106728,21672,Vesvres,29,28,1
27,21,212106736,21673,Veuvey-sur-Ouche,217,214,3
27,21,212106744,21674,Veuxhaulles-sur-Aube,201,199,2
27,21,212106751,21675,Vianges,39,38,1
27,21,212106769,21676,Vic-de-Chassenay,216,211,5
27,21,212106777,21677,Vic-des-Prés,116,115,1
27,21,212106785,21678,Vic-sous-Thil,187,184,3
27,21,212106793,21679,Vieilmoulin,136,134,2
27,21,212106801,21680,Vielverge,511,504,7
27,21,212106819,21681,Vieux-Château,87,86,1
27,21,212106827,21682,Viévigne,272,271,1
27,21,212106835,21683,Viévy,360,357,3
27,21,212106843,21684,Vignoles,986,938,48
27,21,212106850,21685,Villaines-en-Duesmois,259,253,6
27,21,212106868,21686,Villaines-les-Prévôtes,148,146,2
27,21,212106876,21687,Villargoix,142,137,5
27,21,212106884,21688,Villars-Fontaine,118,114,4
27,21,212106892,21689,Villars-et-Villenotte,174,167,7
27,21,212106900,21690,Villeberny,93,91,2
27,21,212106918,21691,Villebichot,405,398,7
27,21,212106926,21692,Villecomte,252,248,4
27,21,212106934,21693,Villedieu,70,69,1
27,21,212106942,21694,Villeferry,24,24,0
27,21,212106959,21695,La Villeneuve-les-Convers,63,62,1
27,21,212106967,21696,Villeneuve-sous-Charigny,98,96,2
27,21,212106983,21698,Villers-la-Faye,398,389,9
27,21,212106991,21699,Villers-les-Pots,1190,1177,13
27,21,212107007,21700,Villers-Patras,85,82,3
27,21,212107015,21701,Villers-Rotin,130,125,5
27,21,212107023,21702,Villey-sur-Tille,270,263,7
27,21,212107031,21703,Villiers-en-Morvan,49,49,0
27,21,212107049,21704,Villiers-le-Duc,103,103,0
27,21,212107056,21705,Villotte-Saint-Seine,74,74,0
27,21,212107064,21706,Villotte-sur-Ource,116,114,2
27,21,212107072,21707,Villy-en-Auxois,220,216,4
27,21,212107080,21708,Villy-le-Moutier,338,326,12
27,21,212107098,21709,Viserny,183,179,4
27,21,212107106,21710,Vitteaux,1077,1059,18
27,21,212107114,21711,Vix,103,100,3
27,21,212107122,21712,Volnay,244,229,15
27,21,212107130,21713,Vonges,352,348,4
27,21,212107148,21714,Vosne-Romanée,347,338,9
27,21,212107155,21715,Voudenay,193,192,1
27,21,212107163,21716,Vougeot,167,162,5
27,21,212107171,21717,Voulaines-les-Templiers,281,270,11
53,22,212200018,22001,Allineuc,616,596,20
53,22,212200026,22002,Andel,1184,1148,36
53,22,212200034,22003,Aucaleuc,997,920,77
53,22,212200042,22004,Bégard,4901,4810,91
53,22,212200059,22005,Belle-Isle-en-Terre,1048,1029,19
53,22,212200067,22006,Berhet,282,273,9
53,22,212200083,22008,Bobital,1178,1137,41
53,22,212200091,22009,Le Bodéo,163,162,1
53,22,212200117,22011,Boqueho,1080,1054,26
53,22,212200125,22012,La Bouillie,904,886,18
53,22,212200133,22013,Bourbriac,2169,2125,44
53,22,212200141,22014,Bourseul,1212,1182,30
53,22,212200158,22015,Bréhand,1725,1696,29
53,22,212200166,22016,Île-de-Bréhat,386,377,9
53,22,212200182,22018,Brélidy,296,291,5
53,22,212200190,22019,Bringolo,506,495,11
53,22,212200208,22020,Broons,2977,2910,67
53,22,212200216,22021,Brusvily,1191,1166,25
53,22,212200232,22023,Bulat-Pestivien,416,415,1
53,22,212200240,22024,Calanhel,228,227,1
53,22,212200257,22025,Callac,2263,2233,30
53,22,212200265,22026,Calorguen,751,737,14
53,22,212200273,22027,Le Cambout,425,414,11
53,22,212200281,22028,Camlez,868,842,26
53,22,212200299,22029,Canihuel,358,345,13
53,22,212200307,22030,Caouënnec-Lanvézéac,921,899,22
53,22,212200315,22031,Carnoët,659,653,6
53,22,212200323,22032,Caulnes,2637,2503,134
53,22,212200331,22033,Caurel,370,361,9
53,22,212200349,22034,Cavan,1573,1516,57
53,22,212200356,22035,Les Champs-Géraux,1065,1042,23
53,22,212200364,22036,La Chapelle-Blanche,217,210,7
53,22,212200372,22037,La Chapelle-Neuve,388,384,4
53,22,212200398,22039,La Chèze,570,561,9
53,22,212200406,22040,Coadout,581,567,14
53,22,212200414,22041,Coatascorn,264,261,3
53,22,212200422,22042,Coatréven,514,500,14
53,22,212200430,22043,Coëtlogon,215,209,6
53,22,212200448,22044,Coëtmieux,1842,1792,50
53,22,212200455,22045,Cohiniac,367,363,4
53,22,200054294,22046,Le Mené,6527,6412,115
53,22,212200471,22047,Corlay,938,922,16
53,22,212200489,22048,Corseul,2270,2223,47
53,22,212200497,22049,Créhen,1678,1643,35
53,22,200076578,22050,Dinan,15256,14682,574
53,22,212200521,22052,Duault,382,376,6
53,22,212200539,22053,Éréac,694,682,12
53,22,212200547,22054,Erquy,4007,3916,91
53,22,200061463,22055,Binic-Étables-sur-Mer,7075,6862,213
53,22,212200562,22056,Évran,1809,1783,26
53,22,212200570,22057,Le Faouët,412,400,12
53,22,212200596,22059,Le Foeil,1443,1403,40
53,22,212200604,22060,Gausson,628,619,9
53,22,212200612,22061,Glomel,1390,1350,40
53,22,212200620,22062,Gomené,554,543,11
53,22,212200638,22063,Gommenec'h,563,554,9
53,22,212200646,22064,Gouarec,983,952,31
53,22,212200653,22065,Goudelin,1762,1725,37
53,22,212200679,22067,Grâces,2607,2548,59
53,22,212200687,22068,Grâce-Uzel,438,430,8
53,22,212200695,22069,Guenroc,221,216,5
53,22,212200703,22070,Guingamp,7682,7115,567
53,22,212200711,22071,Guitté,726,718,8
53,22,212200729,22072,Gurunhuel,413,405,8
53,22,212200737,22073,La Harmoye,390,373,17
53,22,212200745,22074,Le Haut-Corlay,662,645,17
53,22,212200752,22075,Hémonstoir,731,724,7
53,22,212200760,22076,Hénanbihen,1365,1328,37
53,22,212200778,22077,Hénansal,1216,1201,15
53,22,212200794,22079,Hénon,2334,2298,36
53,22,212200810,22081,Hillion,4345,4246,99
53,22,212200828,22082,Le Hinglé,939,907,32
53,22,212200836,22083,Illifaut,686,674,12
53,22,200056711,22084,Jugon-les-Lacs - Commune nouvelle,2583,2533,50
53,22,212200851,22085,Kerbors,296,288,8
53,22,212200869,22086,Kerfot,667,655,12
53,22,212200877,22087,Kergrist-Moëlou,680,654,26
53,22,212200885,22088,Kerien,253,250,3
53,22,212200901,22090,Kermaria-Sulard,1095,1074,21
53,22,212200919,22091,Kermoroc'h,445,436,9
53,22,212200927,22092,Kerpert,272,269,3
53,22,200084176,22093,Lamballe-Armor,17169,16689,480
53,22,212200943,22094,Lancieux,1645,1582,63
53,22,212200950,22095,Landebaëron,185,175,10
53,22,212200968,22096,Landébia,456,454,2
53,22,212200976,22097,La Landec,744,726,18
53,22,212200984,22098,Landéhen,1458,1424,34
53,22,212200992,22099,Lanfains,1117,1099,18
53,22,212201016,22101,Langoat,1164,1139,25
53,22,212201032,22103,Langrolay-sur-Rance,1014,974,40
53,22,212201040,22104,Languédias,568,540,28
53,22,212201057,22105,Languenan,1172,1149,23
53,22,212201065,22106,Langueux,8074,7824,250
53,22,200065571,22107,Bon Repos sur Blavet,1285,1249,36
53,22,212201081,22108,Lanleff,124,122,2
53,22,212201099,22109,Lanloup,230,224,6
53,22,212201107,22110,Lanmérin,606,592,14
53,22,212201115,22111,Lanmodez,408,402,6
53,22,212201123,22112,Lannebert,443,439,4
53,22,212201131,22113,Lannion,21356,20451,905
53,22,212201149,22114,Lanrelas,869,852,17
53,22,212201156,22115,Lanrivain,461,449,12
53,22,212201164,22116,Lanrodec,1387,1364,23
53,22,212201172,22117,Lantic,1777,1744,33
53,22,212201180,22118,Lanvallay,4310,4209,101
53,22,212201198,22119,Lanvellec,605,595,10
53,22,212201214,22121,Lanvollon,1809,1781,28
53,22,212201222,22122,Laurenan,750,737,13
53,22,212201248,22124,Lescouët-Gouarec,223,215,8
53,22,212201263,22126,Le Leslay,160,157,3
53,22,212201271,22127,Lézardrieux,1566,1532,34
53,22,212201289,22128,Locarn,423,410,13
53,22,212201297,22129,Loc-Envel,71,69,2
53,22,212201313,22131,Loguivy-Plougras,815,802,13
53,22,212201321,22132,Lohuec,250,247,3
53,22,212201339,22133,Loscouët-sur-Meu,643,628,15
53,22,212201347,22134,Louannec,3203,3086,117
53,22,212201354,22135,Louargat,2367,2328,39
53,22,212201362,22136,Loudéac,10031,9652,379
53,22,212201370,22137,Maël-Carhaix,1496,1466,30
53,22,212201388,22138,Maël-Pestivien,359,354,5
53,22,212201396,22139,Magoar,86,84,2
53,22,212201404,22140,La Malhoure,627,611,16
53,22,212201412,22141,Mantallot,242,236,6
53,22,212201438,22143,Matignon,1726,1704,22
53,22,212201446,22144,La Méaugon,1366,1331,35
53,22,212201453,22145,Mégrit,848,827,21
53,22,212201461,22146,Mellionnec,412,395,17
53,22,212201479,22147,Merdrignac,3186,2954,232
53,22,212201487,22148,Mérillac,238,234,4
53,22,212201495,22149,Merléac,444,428,16
53,22,212201503,22150,Le Merzer,973,946,27
53,22,212201529,22152,Minihy-Tréguier,1295,1254,41
53,22,212201537,22153,Moncontour,768,752,16
53,22,212201552,22155,La Motte,2179,2146,33
53,22,212201560,22156,Moustéru,659,644,15
53,22,212201578,22157,Le Moustoir,691,667,24
53,22,200065548,22158,Guerlédan,2530,2467,63
53,22,212201602,22160,Noyal,975,956,19
53,22,212201610,22161,Pabu,2861,2753,108
53,22,212201628,22162,Paimpol,7471,7142,329
53,22,212201636,22163,Paule,703,682,21
53,22,212201644,22164,Pédernec,1898,1856,42
53,22,212201651,22165,Penguily,625,606,19
53,22,212201669,22166,Penvénan,2537,2473,64
53,22,212201685,22168,Perros-Guirec,7342,7149,193
53,22,212201693,22169,Peumerit-Quintin,176,172,4
53,22,212201701,22170,Plaine-Haute,1681,1647,34
53,22,212201719,22171,Plaintel,4592,4501,91
53,22,212201727,22172,Plancoët,3071,3018,53
53,22,212201743,22174,Pléboulle,831,819,12
53,22,212201750,22175,Plédéliac,1494,1478,16
53,22,212201768,22176,Plédran,7030,6920,110
53,22,212201776,22177,Pléguien,1414,1383,31
53,22,212201784,22178,Pléhédel,1370,1335,35
53,22,212201792,22179,Fréhel,1628,1602,26
53,22,212201800,22180,Plélan-le-Petit,1947,1917,30
53,22,212201818,22181,Plélauff,656,628,28
53,22,212201826,22182,Plélo,3316,3239,77
53,22,200057826,22183,Plémet,3818,3728,90
53,22,212201842,22184,Plémy,1622,1591,31
53,22,212201859,22185,Plénée-Jugon,2507,2434,73
53,22,212201867,22186,Pléneuf-Val-André,4197,4069,128
53,22,212201875,22187,Plérin,14916,14459,457
53,22,212201883,22188,Plerneuf,1123,1112,11
53,22,212201891,22189,Plésidy,572,562,10
53,22,212201909,22190,Pleslin-Trigavou,3947,3867,80
53,22,212201933,22193,Plestan,1660,1635,25
53,22,212201941,22194,Plestin-les-Grèves,3734,3635,99
53,22,212201958,22195,Pleubian,2324,2283,41
53,22,212201966,22196,Pleudaniel,951,934,17
53,22,212201974,22197,Pleudihen-sur-Rance,3092,3009,83
53,22,212201982,22198,Pleumeur-Bodou,4000,3837,163
53,22,212201990,22199,Pleumeur-Gautier,1207,1189,18
53,22,212202006,22200,Pléven,609,599,10
53,22,212203921,22201,Plévenon,769,756,13
53,22,212202022,22202,Plévin,761,750,11
53,22,200054252,22203,Ploeuc-L'Hermitage,4178,4108,70
53,22,212202048,22204,Ploëzal,1243,1222,21
53,22,212202055,22205,Plorec-sur-Arguenon,423,420,3
53,22,200082857,22206,Châtelaudren-Plouagat,4010,3955,55
53,22,212202071,22207,Plouaret,2239,2195,44
53,22,212202089,22208,Plouasne,1755,1721,34
53,22,200064699,22209,Beaussais-sur-Mer,4019,3956,63
53,22,212202105,22210,Ploubazlanec,3164,3040,124
53,22,212202113,22211,Ploubezre,3854,3736,118
53,22,212202121,22212,Plouëc-du-Trieux,1176,1143,33
53,22,212202139,22213,Plouër-sur-Rance,3621,3515,106
53,22,212202147,22214,Plouézec,3183,3126,57
53,22,212202154,22215,Ploufragan,11837,11487,350
53,22,212202162,22216,Plougonver,759,743,16
53,22,212202170,22217,Plougras,424,415,9
53,22,212202188,22218,Plougrescant,1194,1160,34
53,22,200083707,22219,Plouguenast-Langast,2486,2429,57
53,22,212202204,22220,Plouguernével,1660,1610,50
53,22,212202212,22221,Plouguiel,1781,1744,37
53,22,212202220,22222,Plouha,4646,4560,86
53,22,212202238,22223,Plouisy,2277,2002,275
53,22,212202246,22224,Ploulec'h,1638,1581,57
53,22,212202253,22225,Ploumagoar,5514,5405,109
53,22,212202261,22226,Ploumilliau,2508,2452,56
53,22,212202279,22227,Plounérin,799,787,12
53,22,212202287,22228,Plounévez-Moëdec,1489,1463,26
53,22,212202295,22229,Plounévez-Quintin,1092,1065,27
53,22,212202311,22231,Plourac'h,332,328,4
53,22,212202329,22232,Plourhan,2073,2040,33
53,22,212202337,22233,Plourivo,2317,2262,55
53,22,212202345,22234,Plouvara,1169,1158,11
53,22,212202352,22235,Plouzélambre,230,225,5
53,22,212202360,22236,Pludual,732,723,9
53,22,212202378,22237,Pluduno,2281,2216,65
53,22,212202386,22238,Plufur,545,533,12
53,22,212202394,22239,Plumaudan,1405,1367,38
53,22,212202402,22240,Plumaugat,1119,1103,16
53,22,212202410,22241,Plumieux,1058,1028,30
53,22,212202428,22242,Plurien,1572,1543,29
53,22,212202436,22243,Plusquellec,562,546,16
53,22,212202444,22244,Plussulien,499,480,19
53,22,212202451,22245,Pluzunet,973,959,14
53,22,212202469,22246,Pommeret,2158,2124,34
53,22,212202485,22248,Pommerit-le-Vicomte,1868,1830,38
53,22,212202493,22249,Pont-Melvez,625,615,10
53,22,212202501,22250,Pontrieux,1025,1000,25
53,22,200056703,22251,Pordic,7523,7315,208
53,22,212202543,22254,Prat,1139,1117,22
53,22,212202550,22255,La Prénessaye,894,876,18
53,22,212202568,22256,Quemper-Guézennec,1087,1061,26
53,22,212202576,22257,Quemperven,402,393,9
53,22,212202584,22258,Quessoy,4092,3868,224
53,22,212202592,22259,Quévert,4057,3970,87
53,22,212202600,22260,Le Quillio,577,567,10
53,22,212202618,22261,Quintenic,371,360,11
53,22,212202626,22262,Quintin,3029,2822,207
53,22,212202634,22263,Le Quiou,350,347,3
53,22,200084168,22264,La Roche-Jaudy,3282,2671,611
53,22,212202659,22265,Rospez,1834,1778,56
53,22,212202667,22266,Rostrenen,3428,3132,296
53,22,212202675,22267,Rouillac,392,389,3
53,22,212202683,22268,Ruca,606,596,10
53,22,212202691,22269,Runan,259,253,6
53,22,212202717,22271,Saint-Adrien,356,350,6
53,22,212202725,22272,Saint-Agathon,2339,2286,53
53,22,212202733,22273,Saint-Alban,2280,2241,39
53,22,212202741,22274,Saint-André-des-Eaux,393,387,6
53,22,212202758,22275,Saint-Barnabé,1250,1225,25
53,22,212202766,22276,Saint-Bihy,273,266,7
53,22,212202774,22277,Saint-Brandan,2347,2298,49
53,22,212202782,22278,Saint-Brieuc,45602,44166,1436
53,22,212202790,22279,Saint-Caradec,1158,1119,39
53,22,212202808,22280,Saint-Carné,1114,1077,37
53,22,212202816,22281,Saint-Carreuc,1546,1522,24
53,22,212202824,22282,Saint-Cast-le-Guildo,3388,3313,75
53,22,212202832,22283,Saint-Clet,896,870,26
53,22,212202840,22284,Saint-Connan,301,293,8
53,22,212202857,22285,Saint-Connec,268,260,8
53,22,212202865,22286,Saint-Denoual,493,479,14
53,22,212202873,22287,Saint-Donan,1483,1447,36
53,22,212202881,22288,Saint-Étienne-du-Gué-de-l'Isle,363,358,5
53,22,212202899,22289,Saint-Fiacre,215,214,1
53,22,212202915,22291,Saint-Gildas,255,247,8
53,22,212202931,22293,Saint-Gilles-les-Bois,409,396,13
53,22,212202949,22294,Saint-Gilles-Pligeaux,310,304,6
53,22,212202956,22295,Saint-Gilles-Vieux-Marché,357,342,15
53,22,212202964,22296,Saint-Glen,664,654,10
53,22,212202998,22299,Saint-Hélen,1572,1528,44
53,22,212203004,22300,Saint-Hervé,397,388,9
53,22,212203020,22302,Saint-Jacut-de-la-Mer,928,910,18
53,22,212203046,22304,Saint-Jean-Kerdaniel,677,668,9
53,22,212203053,22305,Saint-Jouan-de-l'Isle,491,482,9
53,22,212203061,22306,Saint-Judoce,575,565,10
53,22,212203079,22307,Saint-Julien,2096,2046,50
53,22,212203087,22308,Saint-Juvat,666,648,18
53,22,212203095,22309,Saint-Launeuc,196,192,4
53,22,212203103,22310,Saint-Laurent,498,491,7
53,22,212203111,22311,Saint-Lormel,917,881,36
53,22,212203129,22312,Saint-Maden,232,223,9
53,22,212203137,22313,Saint-Martin-des-Prés,319,311,8
53,22,212203145,22314,Saint-Maudan,405,398,7
53,22,212203152,22315,Saint-Maudez,294,283,11
53,22,212203160,22316,Saint-Mayeux,473,466,7
53,22,212203178,22317,Saint-Méloir-des-Bois,272,267,5
53,22,212203186,22318,Saint-Michel-de-Plélan,316,308,8
53,22,212203194,22319,Saint-Michel-en-Grève,466,453,13
53,22,212203202,22320,Saint-Nicodème,185,180,5
53,22,212203210,22321,Saint-Nicolas-du-Pélem,1599,1555,44
53,22,212203228,22322,Saint-Péver,391,383,8
53,22,212203236,22323,Saint-Pôtan,835,821,14
53,22,212203244,22324,Saint-Quay-Perros,1344,1289,55
53,22,212203251,22325,Saint-Quay-Portrieux,3382,3159,223
53,22,212203269,22326,Saint-Rieul,549,544,5
53,22,212203277,22327,Saint-Samson-sur-Rance,1666,1639,27
53,22,212203285,22328,Saint-Servais,415,410,5
53,22,212203301,22330,Saint-Thélo,394,383,11
53,22,212203319,22331,Sainte-Tréphine,186,184,2
53,22,212203327,22332,Saint-Trimoël,519,510,9
53,22,212203335,22333,Saint-Vran,791,762,29
53,22,212203343,22334,Saint-Igeaux,131,123,8
53,22,212203350,22335,Senven-Léhart,237,237,0
53,22,212203376,22337,Sévignac,1141,1116,25
53,22,212203384,22338,Squiffiec,787,762,25
53,22,212203392,22339,Taden,2596,2521,75
53,22,212203400,22340,Tonquédec,1228,1201,27
53,22,212203418,22341,Tramain,710,695,15
53,22,212203426,22342,Trébédan,437,430,7
53,22,212203434,22343,Trébeurden,3823,3701,122
53,22,212203442,22344,Trébrivan,773,756,17
53,22,212203459,22345,Trébry,794,779,15
53,22,212203467,22346,Trédaniel,920,897,23
53,22,212203475,22347,Trédarzec,1072,1054,18
53,22,212203483,22348,Trédias,508,499,9
53,22,212203491,22349,Trédrez-Locquémeau,1496,1457,39
53,22,212203509,22350,Tréduder,197,193,4
53,22,212203517,22351,Treffrin,554,540,14
53,22,212203525,22352,Tréfumel,276,274,2
53,22,212203533,22353,Trégastel,2622,2549,73
53,22,212203541,22354,Tréglamus,1116,1094,22
53,22,212203566,22356,Trégomeur,969,945,24
53,22,212203582,22358,Trégonneau,566,559,7
53,22,212203590,22359,Trégrom,417,412,5
53,22,212203608,22360,Trégueux,8639,8470,169
53,22,212203616,22361,Tréguidel,645,633,12
53,22,212203624,22362,Tréguier,2678,2411,267
53,22,212203632,22363,Trélévern,1268,1242,26
53,22,212203640,22364,Trélivan,2979,2899,80
53,22,212203657,22365,Trémargat,193,181,12
53,22,212203665,22366,Trémel,408,403,5
53,22,212203681,22368,Tréméreuc,753,724,29
53,22,212203699,22369,Trémeur,799,787,12
53,22,212203707,22370,Tréméven,359,351,8
53,22,212203715,22371,Trémorel,1167,1147,20
53,22,212203723,22372,Trémuson,2224,2187,37
53,22,212203731,22373,Tréogan,107,104,3
53,22,212203756,22375,Tressignaux,717,706,11
53,22,212203764,22376,Trévé,1730,1688,42
53,22,212203772,22377,Tréveneuc,819,798,21
53,22,212203780,22378,Trévérec,222,215,7
53,22,212203798,22379,Trévou-Tréguignec,1563,1522,41
53,22,212203806,22380,Trévron,699,685,14
53,22,212203814,22381,Trézény,363,353,10
53,22,212203830,22383,Troguéry,222,217,5
53,22,212203848,22384,Uzel,1107,1080,27
53,22,212203855,22385,La Vicomté-sur-Rance,1138,1113,25
53,22,212203863,22386,Le Vieux-Bourg,797,777,20
53,22,212203871,22387,Le Vieux-Marché,1310,1280,30
53,22,212203889,22388,Vildé-Guingalan,1285,1257,28
53,22,212203897,22389,Yffiniac,5080,4977,103
53,22,212203905,22390,Yvias,795,779,16
53,22,212203913,22391,Yvignac-la-Tour,1139,1123,16
75,23,212300107,23001,Ahun,1651,1421,230
75,23,212300206,23002,Ajain,1055,1043,12
75,23,212300305,23003,Alleyrat,138,138,0
75,23,212300404,23004,Anzême,552,543,9
75,23,212300503,23005,Arfeuille-Châtain,203,199,4
75,23,212300602,23006,Arrènes,214,210,4
75,23,212300701,23007,Ars,244,234,10
75,23,212300800,23008,Aubusson,3335,3181,154
75,23,212300909,23009,Auge,91,91,0
75,23,212301006,23010,Augères,121,119,2
75,23,212301105,23011,Aulon,167,163,4
75,23,212301204,23012,Auriat,111,109,2
75,23,212301303,23013,Auzances,1226,1201,25
75,23,212301402,23014,Azat-Châtenet,125,122,3
75,23,212301501,23015,Azerables,826,811,15
75,23,212301600,23016,Banize,184,181,3
75,23,212301709,23017,Basville,169,167,2
75,23,212301808,23018,Bazelat,255,244,11
75,23,212301907,23019,Beissat,27,27,0
75,23,212302004,23020,Bellegarde-en-Marche,395,392,3
75,23,212302103,23021,Bénévent-l'Abbaye,770,761,9
75,23,212302202,23022,Bétête,384,378,6
75,23,212302301,23023,Blaudeix,107,106,1
75,23,212302400,23024,Blessac,554,539,15
75,23,212302509,23025,Bonnat,1372,1348,24
75,23,212302608,23026,Bord-Saint-Georges,362,358,4
75,23,212302707,23027,Bosmoreau-les-Mines,239,232,7
75,23,212302806,23028,Bosroger,113,110,3
75,23,212302905,23029,Le Bourg-d'Hem,224,222,2
75,23,212303002,23030,Bourganeuf,2674,2462,212
75,23,212303101,23031,Boussac,1263,1246,17
75,23,212303200,23032,Boussac-Bourg,703,692,11
75,23,212303309,23033,La Brionne,459,451,8
75,23,212303408,23034,Brousse,30,29,1
75,23,212303507,23035,Budelière,712,702,10
75,23,212303606,23036,Bussière-Dunoise,1050,1035,15
75,23,212303705,23037,Bussière-Nouvelle,81,78,3
75,23,212303804,23038,Bussière-Saint-Georges,255,252,3
75,23,212303903,23039,La Celle-Dunoise,561,537,24
75,23,212304000,23040,La Celle-sous-Gouzon,156,155,1
75,23,212304109,23041,La Cellette,244,239,5
75,23,212304208,23042,Ceyroux,127,126,1
75,23,212304307,23043,Chamberaud,96,96,0
75,23,212304406,23044,Chambon-Sainte-Croix,83,82,1
75,23,212304505,23045,Chambon-sur-Voueize,875,863,12
75,23,212304604,23046,Chambonchard,84,80,4
75,23,212304703,23047,Chamborand,245,242,3
75,23,212304802,23048,Champagnat,484,474,10
75,23,212304901,23049,Champsanglard,259,251,8
75,23,212305007,23050,La Chapelle-Baloue,126,125,1
75,23,212305106,23051,La Chapelle-Saint-Martial,78,77,1
75,23,212305205,23052,La Chapelle-Taillefert,445,435,10
75,23,212305304,23053,Chard,204,202,2
75,23,212305403,23054,Charron,220,218,2
75,23,212305502,23055,Châtelard,30,30,0
75,23,212305601,23056,Châtelus-le-Marcheix,294,289,5
75,23,212305700,23057,Châtelus-Malvaleix,557,546,11
75,23,212305809,23058,Le Chauchet,102,101,1
75,23,212305908,23059,La Chaussade,105,99,6
75,23,212306005,23060,Chavanat,146,141,5
75,23,212306104,23061,Chénérailles,766,752,14
75,23,212306203,23062,Chéniers,566,557,9
75,23,212306302,23063,Clairavaux,155,154,1
75,23,212306401,23064,Clugnat,656,653,3
75,23,212306500,23065,Colondannes,286,277,9
75,23,212306609,23066,Le Compas,206,194,12
75,23,212306708,23067,La Courtine,806,798,8
75,23,212306807,23068,Cressat,523,516,7
75,23,212306906,23069,Crocq,407,404,3
75,23,212307003,23070,Crozant,451,437,14
75,23,212307102,23071,Croze,196,190,6
75,23,212307201,23072,Domeyrot,236,234,2
75,23,212307300,23073,Dontreix,428,418,10
75,23,212307409,23074,Le Donzeil,189,186,3
75,23,212307508,23075,Dun-le-Palestel,1114,1090,24
75,23,212307607,23076,Évaux-les-Bains,1322,1297,25
75,23,212307706,23077,Faux-la-Montagne,456,446,10
75,23,212307805,23078,Faux-Mazuras,193,189,4
75,23,212307904,23079,Felletin,1730,1547,183
75,23,212308001,23080,Féniers,101,99,2
75,23,212308100,23081,Flayat,306,300,6
75,23,212308209,23082,Fleurat,319,313,6
75,23,212308308,23083,Fontanières,247,245,2
75,23,212308407,23084,La Forêt-du-Temple,147,145,2
75,23,212308605,23086,Fransèches,246,243,3
75,23,212308704,23087,Fresselines,494,484,10
75,23,212308803,23088,Gartempe,120,119,1
75,23,212308902,23089,Genouillac,737,727,10
75,23,212309009,23090,Gentioux-Pigerolles,382,376,6
75,23,212309108,23091,Gioux,164,161,3
75,23,212309207,23092,Glénic,698,685,13
75,23,212309306,23093,Gouzon,1590,1568,22
75,23,212309504,23095,Le Grand-Bourg,1250,1208,42
75,23,212309603,23096,Guéret,13327,12698,629
75,23,212309702,23097,Issoudun-Létrieix,298,295,3
75,23,212309801,23098,Jalesches,94,91,3
75,23,212309900,23099,Janaillat,322,317,5
75,23,212310007,23100,Jarnages,445,435,10
75,23,212310106,23101,Jouillat,396,383,13
75,23,212310205,23102,Ladapeyre,350,347,3
75,23,212310304,23103,Lafat,336,322,14
75,23,212310403,23104,Lavaufranche,240,239,1
75,23,212310510,23105,Lavaveix-les-Mines,641,638,3
75,23,212310601,23106,Lépaud,370,366,4
75,23,212310700,23107,Lépinas,133,128,5
75,23,212310809,23108,Leyrat,144,143,1
75,23,200082972,23109,Linard-Malval,213,209,4
75,23,212311005,23110,Lioux-les-Monges,63,62,1
75,23,212311104,23111,Lizières,241,240,1
75,23,212311203,23112,Lourdoueix-Saint-Pierre,746,733,13
75,23,212311302,23113,Lupersat,304,298,6
75,23,212311401,23114,Lussat,412,404,8
75,23,212311500,23115,Magnat-l'Étrange,251,249,2
75,23,212311609,23116,Mainsat,548,539,9
75,23,212311708,23117,Maison-Feyne,305,296,9
75,23,212311807,23118,Maisonnisses,183,177,6
75,23,212311906,23119,Malleret,42,42,0
75,23,212312003,23120,Malleret-Boussac,185,182,3
75,23,212312201,23122,Mansat-la-Courrière,71,67,4
75,23,212312300,23123,Les Mars,185,183,2
75,23,212312409,23124,Marsac,657,640,17
75,23,212312508,23125,Le Mas-d'Artige,99,98,1
75,23,212312706,23127,Mautes,203,197,6
75,23,212312805,23128,Mazeirat,130,125,5
75,23,212312904,23129,La Mazière-aux-Bons-Hommes,65,64,1
75,23,212313001,23130,Méasnes,533,527,6
75,23,212313100,23131,Mérinchal,696,682,14
75,23,212313209,23132,Montaigut-le-Blanc,404,398,6
75,23,212313308,23133,Montboucher,364,354,10
75,23,212313407,23134,Le Monteil-au-Vicomte,237,213,24
75,23,212313605,23136,Mortroux,283,273,10
75,23,212313704,23137,Mourioux-Vieilleville,530,518,12
75,23,212313803,23138,Moutier-d'Ahun,162,161,1
75,23,212313902,23139,Moutier-Malcard,546,541,5
75,23,212314009,23140,Moutier-Rozeille,432,424,8
75,23,212314108,23141,Naillat,644,628,16
75,23,212314207,23142,Néoux,292,284,8
75,23,212314306,23143,Noth,502,489,13
75,23,212314405,23144,La Nouaille,238,235,3
75,23,212314504,23145,Nouhant,285,277,8
75,23,212314603,23146,Nouzerines,244,237,7
75,23,212314702,23147,Nouzerolles,98,96,2
75,23,212314801,23148,Nouziers,248,246,2
75,23,200053502,23149,Parsac-Rimondeix,726,712,14
75,23,212315006,23150,Peyrabout,158,155,3
75,23,212315105,23151,Peyrat-la-Nonière,436,427,9
75,23,212315204,23152,Pierrefitte,70,70,0
75,23,212315402,23154,Pionnat,741,730,11
75,23,212315501,23155,Pontarion,370,364,6
75,23,212315600,23156,Pontcharraud,83,83,0
75,23,212315741,23157,La Pouge,96,96,0
75,23,212315808,23158,Poussanges,158,156,2
75,23,212315907,23159,Puy-Malsignat,152,149,3
75,23,212316004,23160,Reterre,270,269,1
75,23,212316202,23162,Roches,375,372,3
75,23,212316400,23164,Rougnat,489,479,10
75,23,212316509,23165,Royère-de-Vassivière,585,578,7
75,23,212316608,23166,Sagnat,199,192,7
75,23,212316707,23167,Sannat,341,339,2
75,23,212316806,23168,Sardent,778,760,18
75,23,212316905,23169,La Saunière,658,645,13
75,23,212317002,23170,Savennes,223,212,11
75,23,212317101,23171,Sermur,109,108,1
75,23,212317200,23172,La Serre-Bussière-Vieille,123,122,1
75,23,212317309,23173,Soubrebost,142,139,3
75,23,212317408,23174,Soumans,585,578,7
75,23,212317507,23175,Sous-Parsat,114,114,0
75,23,212317606,23176,La Souterraine,5182,4953,229
75,23,212317705,23177,Saint-Agnant-de-Versillat,1115,1085,30
75,23,212317804,23178,Saint-Agnant-près-Crocq,171,171,0
75,23,212317903,23179,Saint-Alpinien,286,282,4
75,23,212318000,23180,Saint-Amand,484,475,9
75,23,212318109,23181,Saint-Amand-Jartoudeix,158,156,2
75,23,212318208,23182,Saint-Avit-de-Tardes,171,169,2
75,23,212318307,23183,Saint-Avit-le-Pauvre,79,77,2
75,23,212318406,23184,Saint-Bard,100,97,3
75,23,212318505,23185,Saint-Chabrais,297,295,2
75,23,212318604,23186,Saint-Christophe,160,154,6
75,23,212318703,23187,Saint-Dizier-la-Tour,188,186,2
75,23,212318802,23188,Saint-Dizier-les-Domaines,198,196,2
75,23,200085314,23189,Saint-Dizier-Masbaraud,1156,1131,25
75,23,212319008,23190,Saint-Domet,164,163,1
75,23,212319107,23191,Saint-Éloi,187,180,7
75,23,200065480,23192,Fursac,1467,1445,22
75,23,212319305,23193,Sainte-Feyre,2552,2493,59
75,23,212319404,23194,Sainte-Feyre-la-Montagne,125,122,3
75,23,212319503,23195,Saint-Fiel,1075,1049,26
75,23,212319602,23196,Saint-Frion,260,255,5
75,23,212319701,23197,Saint-Georges-la-Pouge,373,370,3
75,23,212319800,23198,Saint-Georges-Nigremont,145,143,2
75,23,212319909,23199,Saint-Germain-Beaupré,369,361,8
75,23,212320006,23200,Saint-Goussaud,174,166,8
75,23,212320105,23201,Saint-Hilaire-la-Plaine,218,213,5
75,23,212320204,23202,Saint-Hilaire-le-Château,234,226,8
75,23,212320303,23203,Saint-Julien-la-Genête,226,219,7
75,23,212320402,23204,Saint-Julien-le-Châtel,144,141,3
75,23,212320501,23205,Saint-Junien-la-Bregère,146,143,3
75,23,212320600,23206,Saint-Laurent,708,693,15
75,23,212320709,23207,Saint-Léger-Bridereix,191,185,6
75,23,212320808,23208,Saint-Léger-le-Guérétois,418,409,9
75,23,212320907,23209,Saint-Loup,184,183,1
75,23,212321004,23210,Saint-Maixant,259,256,3
75,23,212321103,23211,Saint-Marc-à-Frongier,435,426,9
75,23,212321202,23212,Saint-Marc-à-Loubaud,126,125,1
75,23,212321301,23213,Saint-Marien,190,187,3
75,23,212321400,23214,Saint-Martial-le-Mont,272,269,3
75,23,212321509,23215,Saint-Martial-le-Vieux,149,143,6
75,23,212321608,23216,Saint-Martin-Château,152,147,5
75,23,212321707,23217,Saint-Martin-Sainte-Catherine,342,338,4
75,23,212321806,23218,Saint-Maurice-près-Crocq,99,97,2
75,23,212321905,23219,Saint-Maurice-la-Souterraine,1209,1190,19
75,23,212322002,23220,Saint-Médard-la-Rochette,571,559,12
75,23,212322101,23221,Saint-Merd-la-Breuille,197,192,5
75,23,212322200,23222,Saint-Michel-de-Veisse,167,163,4
75,23,212322309,23223,Saint-Moreil,216,215,1
75,23,212322408,23224,Saint-Oradoux-de-Chirouze,72,72,0
75,23,212322507,23225,Saint-Oradoux-près-Crocq,108,107,1
75,23,212322606,23226,Saint-Pardoux-d'Arnet,173,167,6
75,23,212322705,23227,Saint-Pardoux-Morterolles,210,205,5
75,23,212322804,23228,Saint-Pardoux-le-Neuf,210,201,9
75,23,212322903,23229,Saint-Pardoux-les-Cards,287,285,2
75,23,212323000,23230,Saint-Pierre-Chérignat,170,165,5
75,23,212323208,23232,Saint-Pierre-Bellevue,209,208,1
75,23,212323307,23233,Saint-Pierre-le-Bost,125,124,1
75,23,212323406,23234,Saint-Priest,152,150,2
75,23,212323505,23235,Saint-Priest-la-Feuille,772,757,15
75,23,212323604,23236,Saint-Priest-la-Plaine,263,255,8
75,23,212323703,23237,Saint-Priest-Palus,55,55,0
75,23,212323802,23238,Saint-Quentin-la-Chabanne,383,376,7
75,23,212323901,23239,Saint-Sébastien,644,633,11
75,23,212324008,23240,Saint-Silvain-Bas-le-Roc,414,409,5
75,23,212324107,23241,Saint-Silvain-Bellegarde,220,217,3
75,23,212324206,23242,Saint-Silvain-Montaigut,219,215,4
75,23,212324305,23243,Saint-Silvain-sous-Toulx,150,148,2
75,23,212324404,23244,Saint-Sulpice-le-Dunois,591,577,14
75,23,212324503,23245,Saint-Sulpice-le-Guérétois,1983,1926,57
75,23,212324602,23246,Saint-Sulpice-les-Champs,356,348,8
75,23,212324701,23247,Saint-Vaury,1857,1735,122
75,23,212324800,23248,Saint-Victor-en-Marche,363,355,8
75,23,212324909,23249,Saint-Yrieix-la-Montagne,224,221,3
75,23,212325005,23250,Saint-Yrieix-les-Bois,295,291,4
75,23,212325104,23251,Tardes,122,120,2
75,23,212325203,23252,Tercillat,156,153,3
75,23,212325302,23253,Thauron,183,177,6
75,23,212325401,23254,Toulx-Sainte-Croix,252,250,2
75,23,212325500,23255,Trois-Fonds,123,123,0
75,23,212325708,23257,Vallière,728,715,13
75,23,212325807,23258,Vareilles,314,305,9
75,23,212325906,23259,Verneiges,121,120,1
75,23,212326003,23260,Vidaillat,192,191,1
75,23,212326102,23261,Viersat,284,280,4
75,23,212326201,23262,Vigeville,166,164,2
75,23,212326300,23263,Villard,383,378,5
75,23,212326409,23264,La Villedieu,49,48,1
75,23,212326508,23265,La Villeneuve,49,49,0
75,23,212326607,23266,La Villetelle,171,171,0
75,24,212400014,24001,Abjat-sur-Bandiat,636,627,9
75,24,212400022,24002,Agonac,1815,1791,24
75,24,212400048,24004,Ajat,288,285,3
75,24,212400055,24005,Alles-sur-Dordogne,401,392,9
75,24,212400063,24006,Allas-les-Mines,202,194,8
75,24,212400071,24007,Allemans,522,514,8
75,24,212400089,24008,Angoisse,599,588,11
75,24,212400097,24009,Anlhiac,274,265,9
75,24,212400105,24010,Annesse-et-Beaulieu,1462,1412,50
75,24,212400113,24011,Antonne-et-Trigonant,1312,1293,19
75,24,212400121,24012,Archignac,400,390,10
75,24,212400147,24014,Aubas,637,617,20
75,24,212400154,24015,Audrix,267,263,4
75,24,212400162,24016,Augignac,843,824,19
75,24,212400188,24018,Auriac-du-Périgord,411,401,10
75,24,212400196,24019,Azerat,447,440,7
75,24,212400204,24020,La Bachellerie,915,894,21
75,24,212400212,24021,Badefols-d'Ans,394,386,8
75,24,212400220,24022,Badefols-sur-Dordogne,213,208,5
75,24,212400238,24023,Baneuil,337,324,13
75,24,212400246,24024,Bardou,46,46,0
75,24,212400253,24025,Bars,244,237,7
75,24,200065159,24026,Bassillac et Auberoche,4447,4364,83
75,24,212400279,24027,Bayac,359,358,1
75,24,200060036,24028,Beaumontois en Périgord,1838,1803,35
75,24,212400295,24029,Beaupouyet,539,533,6
75,24,212400303,24030,Beauregard-de-Terrasson,697,681,16
75,24,212400311,24031,Beauregard-et-Bassac,278,273,5
75,24,212400329,24032,Beauronne,381,371,10
75,24,212400345,24034,Beleymas,280,272,8
75,24,200059731,24035,Pays de Belvès,1373,1337,36
75,24,212400360,24036,Berbiguières,180,177,3
75,24,212400378,24037,Bergerac,27101,26360,741
75,24,212400386,24038,Bertric-Burée,443,430,13
75,24,212400394,24039,Besse,167,163,4
75,24,212400402,24040,Beynac-et-Cazenac,555,546,9
75,24,212400428,24042,Biras,688,681,7
75,24,212400436,24043,Biron,152,142,10
75,24,212400451,24045,Boisse,250,246,4
75,24,212400469,24046,Boisseuilh,120,117,3
75,24,212400485,24048,Bonneville-et-Saint-Avit-de-Fumadières,326,315,11
75,24,212400501,24050,Borrèze,349,345,4
75,24,212400519,24051,Bosset,220,219,1
75,24,212400527,24052,Bouillac,128,128,0
75,24,200065357,24053,Boulazac Isle Manoire,11090,10738,352
75,24,212400543,24054,Bouniagues,629,609,20
75,24,212400550,24055,Bourdeilles,787,771,16
75,24,212400568,24056,Le Bourdeix,232,228,4
75,24,212400576,24057,Bourg-des-Maisons,71,69,2
75,24,212400584,24058,Bourg-du-Bost,221,216,5
75,24,212400592,24059,Bourgnac,353,349,4
75,24,212400600,24060,Bourniquel,72,71,1
75,24,212400618,24061,Bourrou,130,124,6
75,24,212400626,24062,Bouteilles-Saint-Sébastien,180,177,3
75,24,212400634,24063,Bouzic,153,150,3
75,24,200084127,24064,Brantôme en Périgord,3762,3694,68
75,24,212400667,24066,Brouchaud,216,211,5
75,24,212400675,24067,Le Bugue,2635,2595,40
75,24,212400683,24068,Le Buisson-de-Cadouin,1985,1936,49
75,24,212400691,24069,Bussac,400,398,2
75,24,212400709,24070,Busserolles,513,505,8
75,24,212400717,24071,Bussière-Badil,375,373,2
75,24,212400733,24073,Calès,389,377,12
75,24,212400741,24074,Calviac-en-Périgord,534,520,14
75,24,212400758,24075,Campagnac-lès-Quercy,329,321,8
75,24,212400766,24076,Campagne,430,416,14
75,24,212400774,24077,Campsegret,397,390,7
75,24,212400808,24080,Capdrot,475,463,12
75,24,212400816,24081,Carlux,650,640,10
75,24,212400824,24082,Carsac-Aillac,1558,1530,28
75,24,212400832,24083,Carsac-de-Gurson,188,184,4
75,24,212400840,24084,Carves,108,104,4
75,24,212400857,24085,La Cassagne,156,155,1
75,24,212400865,24086,Castelnaud-la-Chapelle,454,447,7
75,24,200065142,24087,Castels et Bézenac,829,812,17
75,24,212400881,24088,Cause-de-Clérans,353,346,7
75,24,212400907,24090,Celles,605,594,11
75,24,212400915,24091,Cénac-et-Saint-Julien,1230,1199,31
75,24,212400949,24094,Chalagnac,450,441,9
75,24,212400956,24095,Chalais,412,403,9
75,24,212400964,24096,Champagnac-de-Belair,800,786,14
75,24,212400972,24097,Champagne-et-Fontaine,364,350,14
75,24,212400980,24098,Champcevinel,3071,2980,91
75,24,212401004,24100,Champniers-et-Reilhac,456,452,4
75,24,212401012,24101,Champs-Romain,286,279,7
75,24,212401020,24102,Chancelade,4502,4419,83
75,24,212401046,24104,Chantérac,626,619,7
75,24,212401053,24105,Chapdeuil,138,137,1
75,24,212401061,24106,La Chapelle-Aubareil,556,533,23
75,24,212401079,24107,La Chapelle-Faucher,403,395,8
75,24,212401087,24108,La Chapelle-Gonaguet,1091,1076,15
75,24,212401095,24109,La Chapelle-Grésignac,105,102,3
75,24,212401103,24110,La Chapelle-Montabourlet,64,60,4
75,24,212401111,24111,La Chapelle-Montmoreau,75,74,1
75,24,212401137,24113,La Chapelle-Saint-Jean,92,89,3
75,24,212401145,24114,Chassaignes,70,68,2
75,24,212401152,24115,Château-l'Évêque,2171,2138,33
75,24,212401160,24116,Châtres,185,184,1
75,24,200065126,24117,Les Coteaux Périgourdins,581,563,18
75,24,212401194,24119,Cherval,241,237,4
75,24,212401202,24120,Cherveix-Cubas,560,554,6
75,24,212401210,24121,Chourgnac,63,62,1
75,24,212401228,24122,Cladech,107,103,4
75,24,212401236,24123,Clermont-de-Beauregard,121,120,1
75,24,212401244,24124,Clermont-d'Excideuil,240,234,6
75,24,212401269,24126,Colombier,280,268,12
75,24,212401285,24128,Comberanche-et-Épeluche,167,164,3
75,24,212401293,24129,Condat-sur-Trincou,484,476,8
75,24,212401301,24130,Condat-sur-Vézère,898,882,16
75,24,212401319,24131,Connezac,71,70,1
75,24,212401327,24132,Conne-de-Labarde,272,268,4
75,24,212401335,24133,La Coquille,1286,1269,17
75,24,212401343,24134,Corgnac-sur-l'Isle,860,846,14
75,24,212401350,24135,Cornille,699,687,12
75,24,212401368,24136,Coubjours,119,113,6
75,24,212401376,24137,Coulaures,802,725,77
75,24,212401384,24138,Coulounieix-Chamiers,7613,7316,297
75,24,212401392,24139,Coursac,2291,2242,49
75,24,212401400,24140,Cours-de-Pile,1597,1558,39
75,24,212401418,24141,Coutures,191,188,3
75,24,200059756,24142,Coux et Bigaroque-Mouzens,1260,1218,42
75,24,212401434,24143,Couze-et-Saint-Front,738,729,9
75,24,212401442,24144,Creyssac,98,98,0
75,24,212401459,24145,Creysse,1785,1751,34
75,24,212401467,24146,Creyssensac-et-Pissot,261,252,9
75,24,200065316,24147,Cubjac-Auvézère-Val d'Ans,1112,1100,12
75,24,212401483,24148,Cunèges,298,295,3
75,24,212401509,24150,Daglan,546,527,19
75,24,212401517,24151,Doissat,104,102,2
75,24,212401525,24152,Domme,930,907,23
75,24,212401533,24153,La Dornac,410,398,12
75,24,212401541,24154,Douchapt,360,350,10
75,24,212401558,24155,Douville,468,462,6
75,24,212401566,24156,La Douze,1179,1162,17
75,24,212401574,24157,Douzillac,824,810,14
75,24,212401582,24158,Dussac,412,408,4
75,24,212401590,24159,Échourgnac,400,392,8
75,24,212401608,24160,Église-Neuve-de-Vergt,573,571,2
75,24,212401616,24161,Église-Neuve-d'Issac,124,123,1
75,24,212401624,24162,Escoire,409,400,9
75,24,212401632,24163,Étouars,163,161,2
75,24,212401640,24164,Excideuil,1204,1176,28
75,24,212401657,24165,Eygurande-et-Gardedeuil,419,413,6
75,24,212401673,24167,Eymet,2588,2547,41
75,24,212401681,24168,Plaisance,436,423,13
75,24,212401715,24171,Eyzerac,564,556,8
75,24,200083434,24172,Les Eyzies,1129,1109,20
75,24,212401749,24174,Fanlac,144,143,1
75,24,212401756,24175,Les Farges,327,310,17
75,24,212401764,24176,Faurilles,36,36,0
75,24,212401772,24177,Faux,660,652,8
75,24,212401798,24179,La Feuillade,818,789,29
75,24,212401806,24180,Firbeix,318,312,6
75,24,212401822,24182,Le Fleix,1544,1492,52
75,24,212401830,24183,Fleurac,303,300,3
75,24,212401848,24184,Florimont-Gaumier,151,149,2
75,24,212401863,24186,Fonroque,334,332,2
75,24,212401889,24188,Fossemagne,552,542,10
75,24,212401897,24189,Fougueyrolles,463,447,16
75,24,212401905,24190,Fouleix,276,268,8
75,24,212401913,24191,Fraisse,173,172,1
75,24,212401921,24192,Gabillou,96,93,3
75,24,212401939,24193,Gageac-et-Rouillac,486,478,8
75,24,212401947,24194,Gardonne,1616,1588,28
75,24,212401954,24195,Gaugeac,109,108,1
75,24,212401962,24196,Génis,498,494,4
75,24,212401970,24197,Ginestet,749,733,16
75,24,212401996,24199,Gout-Rossignol,375,367,8
75,24,212402002,24200,Grand-Brassac,556,545,11
75,24,212402028,24202,Granges-d'Ans,147,143,4
75,24,212402051,24205,Grignols,674,669,5
75,24,212402069,24206,Grives,111,107,4
75,24,212402077,24207,Groléjac,670,654,16
75,24,212402085,24208,Grun-Bordas,247,243,4
75,24,212402093,24209,Hautefaye,140,139,1
75,24,212402101,24210,Hautefort,842,823,19
75,24,212402119,24211,Issac,433,430,3
75,24,212402127,24212,Issigeac,755,746,9
75,24,212402135,24213,Jaure,176,174,2
75,24,212402143,24214,Javerlhac-et-la-Chapelle-Saint-Robert,839,829,10
75,24,212402150,24215,Jayac,187,181,6
75,24,200069243,24216,La Jemaye-Ponteyraud,156,152,4
75,24,212402176,24217,Journiac,463,455,8
75,24,212402184,24218,Jumilhac-le-Grand,1187,1144,43
75,24,212402200,24220,Lacropte,696,686,10
75,24,212402218,24221,Rudeau-Ladosse,161,157,4
75,24,212402226,24222,La Force,2730,2641,89
75,24,212402234,24223,Lalinde,2873,2827,46
75,24,212402242,24224,Lamonzie-Montastruc,702,690,12
75,24,212402259,24225,Lamonzie-Saint-Martin,2781,2738,43
75,24,212402267,24226,Lamothe-Montravel,1411,1390,21
75,24,212402275,24227,Lanouaille,987,963,24
75,24,212402283,24228,Lanquais,509,498,11
75,24,212402291,24229,Le Lardin-Saint-Lazare,1710,1672,38
75,24,212402309,24230,Larzac,149,148,1
75,24,212402317,24231,Lavalade,101,100,1
75,24,212402325,24232,Lavaur,74,72,2
75,24,212402341,24234,Les Lèches,381,379,2
75,24,212402366,24236,Léguillac-de-l'Auche,1003,987,16
75,24,212402374,24237,Lembras,1266,1241,25
75,24,212402382,24238,Lempzours,141,136,5
75,24,212402408,24240,Limeuil,342,334,8
75,24,212402416,24241,Limeyrat,445,438,7
75,24,212402424,24242,Liorac-sur-Louyre,257,256,1
75,24,212402432,24243,Lisle,837,825,12
75,24,212402440,24244,Lolme,193,191,2
75,24,212402457,24245,Loubejac,263,259,4
75,24,212402465,24246,Lunas,430,426,4
75,24,212402473,24247,Lusignac,165,161,4
75,24,212402481,24248,Lussas-et-Nontronneau,292,286,6
75,24,212402515,24251,Manzac-sur-Vern,563,554,9
75,24,212402523,24252,Marcillac-Saint-Quentin,838,818,20
75,24,200065324,24253,Mareuil en Périgord,2331,2290,41
75,24,212402549,24254,Marnac,184,183,1
75,24,212402556,24255,Marquay,591,582,9
75,24,212402564,24256,Marsac-sur-l'Isle,3222,3147,75
75,24,212402572,24257,Marsalès,234,229,5
75,24,200082683,24259,Eyraud-Crempse-Maurens,1615,1587,28
75,24,212402606,24260,Mauzac-et-Grand-Castang,880,870,10
75,24,212402614,24261,Mauzens-et-Miremont,294,284,10
75,24,212402622,24262,Mayac,347,338,9
75,24,212402630,24263,Mazeyrolles,315,302,13
75,24,212402648,24264,Ménesplet,1884,1863,21
75,24,212402663,24266,Mensignac,1547,1520,27
75,24,212402671,24267,Mescoules,180,179,1
75,24,212402689,24268,Meyrals,692,677,15
75,24,212402697,24269,Mialet,640,635,5
75,24,212402713,24271,Milhac-de-Nontron,506,492,14
75,24,212402721,24272,Minzac,482,477,5
75,24,212402739,24273,Molières,347,337,10
75,24,212402747,24274,Monbazillac,888,800,88
75,24,212402762,24276,Monestier,410,406,4
75,24,212402770,24277,Monfaucon,292,288,4
75,24,212402788,24278,Monmadalès,83,82,1
75,24,212402796,24279,Monmarvès,63,62,1
75,24,212402804,24280,Monpazier,457,452,5
75,24,212402812,24281,Monsac,190,188,2
75,24,212402820,24282,Monsaguel,148,141,7
75,24,212402846,24284,Montagnac-d'Auberoche,140,135,5
75,24,212402853,24285,Montagnac-la-Crempse,433,418,15
75,24,212402861,24286,Montagrier,514,503,11
75,24,212402879,24287,Montaut,129,127,2
75,24,212402887,24288,Montazeau,287,283,4
75,24,212402895,24289,Montcaret,1472,1453,19
75,24,212402903,24290,Montferrand-du-Périgord,159,155,4
75,24,212402911,24291,Montignac-Lascaux,2811,2757,54
75,24,212402929,24292,Montpeyroux,485,472,13
75,24,212402937,24293,Monplaisant,298,289,9
75,24,212402945,24294,Montpon-Ménestérol,5878,5807,71
75,24,212402952,24295,Montrem,1218,1197,21
75,24,212402960,24296,Mouleydier,1155,1144,11
75,24,212402978,24297,Moulin-Neuf,959,947,12
75,24,212402994,24299,Mussidan,2836,2788,48
75,24,212403000,24300,Nabirat,377,368,9
75,24,212403018,24301,Nadaillac,390,386,4
75,24,212403026,24302,Nailhac,298,296,2
75,24,212403034,24303,Nanteuil-Auriac-de-Bourzac,233,231,2
75,24,212403042,24304,Nantheuil,997,974,23
75,24,212403059,24305,Nanthiat,240,238,2
75,24,212403067,24306,Nastringues,131,127,4
75,24,212403075,24307,Naussannes,259,255,4
75,24,212403083,24308,Négrondes,802,792,10
75,24,212403091,24309,Neuvic,3681,3618,63
75,24,212403117,24311,Nontron,3151,3040,111
75,24,200065464,24312,Sanilhac,4769,4665,104
75,24,212403133,24313,Orliac,49,49,0
75,24,200059046,24316,Parcoul-Chenaud,812,796,16
75,24,212403174,24317,Paulin,259,251,8
75,24,212403182,24318,Paunat,322,314,8
75,24,212403190,24319,Paussac-et-Saint-Vivien,488,478,10
75,24,212403208,24320,Payzac,989,971,18
75,24,212403216,24321,Pazayac,865,850,15
75,24,212403224,24322,Périgueux,30823,29255,1568
75,24,212403232,24323,Petit-Bersac,189,184,5
75,24,212403240,24324,Peyrignac,583,574,9
75,24,200096378,24325,Pechs-de-l'Espérance,786,760,26
75,24,212403265,24326,Peyzac-le-Moustier,196,194,2
75,24,212403273,24327,Pezuls,131,128,3
75,24,212403281,24328,Piégut-Pluviers,1206,1187,19
75,24,212403299,24329,Le Pizou,1372,1351,21
75,24,212403307,24330,Plazac,708,696,12
75,24,212403315,24331,Pomport,746,726,20
75,24,212403349,24334,Pontours,200,195,5
75,24,212403356,24335,Port-Sainte-Foy-et-Ponchapt,2530,2487,43
75,24,212403364,24336,Prats-de-Carlux,548,529,19
75,24,212403372,24337,Prats-du-Périgord,148,146,2
75,24,212403380,24338,Pressignac-Vicq,442,435,7
75,24,212403398,24339,Preyssac-d'Excideuil,145,145,0
75,24,212403406,24340,Prigonrieux,4299,4223,76
75,24,212403414,24341,Proissans,1076,1055,21
75,24,212403455,24345,Queyssac,500,488,12
75,24,212403463,24346,Quinsac,394,385,9
75,24,212403471,24347,Rampieux,142,142,0
75,24,212403489,24348,Razac-d'Eymet,314,313,1
75,24,212403497,24349,Razac-de-Saussignac,351,342,9
75,24,212403505,24350,Razac-sur-l'Isle,2419,2371,48
75,24,212403513,24351,Ribagnac,319,313,6
75,24,212403521,24352,Ribérac,3989,3837,152
75,24,212403539,24353,La Rochebeaucourt-et-Argentine,341,332,9
75,24,212403547,24354,La Roche-Chalais,3060,3009,51
75,24,212403554,24355,La Roque-Gageac,432,429,3
75,24,212403562,24356,Rouffignac-Saint-Cernin-de-Reilhac,1665,1630,35
75,24,212403570,24357,Rouffignac-de-Sigoulès,305,298,7
75,24,212403596,24359,Sadillac,118,116,2
75,24,212403604,24360,Sagelat,322,317,5
75,24,212403612,24361,Saint-Agne,457,450,7
75,24,200065332,24362,Val de Louyre et Caudeau,1609,1588,21
75,24,200082691,24364,Coly-Saint-Amand,604,588,16
75,24,212403653,24365,Saint-Amand-de-Vergt,253,245,8
75,24,212403661,24366,Saint-André-d'Allas,883,863,20
75,24,212403679,24367,Saint-André-de-Double,182,181,1
75,24,212403703,24370,Saint-Antoine-de-Breuilh,1890,1849,41
75,24,212403711,24371,Saint-Aquilin,467,465,2
75,24,212403729,24372,Saint-Astier,5429,5340,89
75,24,212403737,24373,Saint-Aubin-de-Cadelech,351,343,8
75,24,212403745,24374,Saint-Aubin-de-Lanquais,361,357,4
75,24,212403752,24375,Saint-Aubin-de-Nabirat,153,150,3
75,24,200059152,24376,Saint Aulaye-Puymangou,1441,1422,19
75,24,212403778,24377,Saint-Avit-de-Vialard,158,155,3
75,24,212403786,24378,Saint-Avit-Rivière,84,83,1
75,24,212403794,24379,Saint-Avit-Sénieur,416,412,4
75,24,212403802,24380,Saint-Barthélemy-de-Bellegarde,497,495,2
75,24,212403810,24381,Saint-Barthélemy-de-Bussière,220,212,8
75,24,212403828,24382,Saint-Capraise-de-Lalinde,535,526,9
75,24,212403836,24383,Saint-Capraise-d'Eymet,167,165,2
75,24,212403844,24384,Saint-Cassien,37,35,2
75,24,212403851,24385,Saint-Cernin-de-Labarde,226,224,2
75,24,212403869,24386,Saint-Cernin-de-l'Herm,215,205,10
75,24,212403885,24388,Saint-Chamassy,504,489,15
75,24,212403901,24390,Saint-Crépin-d'Auberoche,344,335,9
75,24,212403927,24392,Saint-Crépin-et-Carlucet,531,523,8
75,24,212403935,24393,Sainte-Croix,88,88,0
75,24,212403943,24394,Sainte-Croix-de-Mareuil,158,151,7
75,24,212403950,24395,Saint-Cybranet,372,366,6
75,24,212403968,24396,Saint-Cyprien,1572,1538,34
75,24,212403976,24397,Saint-Cyr-les-Champagnes,266,258,8
75,24,212403984,24398,Saint-Estèphe,600,592,8
75,24,212403992,24399,Saint-Étienne-de-Puycorbier,110,106,4
75,24,212404016,24401,Sainte-Eulalie-d'Ans,301,297,4
75,24,212404032,24403,Saint-Félix-de-Bourdeilles,66,66,0
75,24,212404040,24404,Saint-Félix-de-Reillac-et-Mortemart,178,177,1
75,24,212404057,24405,Saint-Félix-de-Villadeix,337,328,9
75,24,212404065,24406,Sainte-Foy-de-Belvès,142,140,2
75,24,212404073,24407,Sainte-Foy-de-Longas,248,241,7
75,24,212404081,24408,Saint-Front-d'Alemps,259,256,3
75,24,212404099,24409,Saint-Front-de-Pradoux,1205,1178,27
75,24,212404107,24410,Saint-Front-la-Rivière,506,498,8
75,24,212404115,24411,Saint-Front-sur-Nizonne,165,162,3
75,24,212404123,24412,Saint-Geniès,932,906,26
75,24,212404131,24413,Saint-Georges-Blancaneix,279,279,0
75,24,212404149,24414,Saint-Georges-de-Montclard,285,280,5
75,24,212404156,24415,Saint-Géraud-de-Corps,243,237,6
75,24,212404164,24416,Saint-Germain-de-Belvès,178,169,9
75,24,212404172,24417,Saint-Germain-des-Prés,474,466,8
75,24,212404180,24418,Saint-Germain-du-Salembre,951,933,18
75,24,212404198,24419,Saint-Germain-et-Mons,893,874,19
75,24,212404206,24420,Saint-Géry,250,248,2
75,24,212404214,24421,Saint-Geyrac,200,195,5
75,24,212404222,24422,Saint-Hilaire-d'Estissac,120,118,2
75,24,200082709,24423,Saint-Julien-Innocence-Eulalie,312,310,2
75,24,212404248,24424,Saint-Jean-d'Ataux,136,133,3
75,24,212404255,24425,Saint-Jean-de-Côle,375,369,6
75,24,212404263,24426,Saint-Jean-d'Estissac,167,161,6
75,24,212404289,24428,Saint-Jory-de-Chalais,619,581,38
75,24,212404297,24429,Saint-Jory-las-Bloux,246,238,8
75,24,212404321,24432,Saint-Julien-de-Lampon,658,643,15
75,24,212404347,24434,Saint-Just,149,146,3
75,24,212404362,24436,Saint-Laurent-des-Hommes,1046,1027,19
75,24,212404370,24437,Saint-Laurent-des-Vignes,988,974,14
75,24,212404388,24438,Saint-Laurent-la-Vallée,245,236,9
75,24,212404412,24441,Saint-Léon-d'Issigeac,146,143,3
75,24,212404420,24442,Saint-Léon-sur-l'Isle,2059,2029,30
75,24,212404438,24443,Saint-Léon-sur-Vézère,434,421,13
75,24,212404446,24444,Saint-Louis-en-l'Isle,311,304,7
75,24,212404453,24445,Saint-Marcel-du-Périgord,149,144,5
75,24,212404461,24446,Saint-Marcory,52,49,3
75,24,212404487,24448,Saint-Martial-d'Albarède,489,479,10
75,24,212404495,24449,Saint-Martial-d'Artenset,957,942,15
75,24,212404503,24450,Saint-Martial-de-Nabirat,575,571,4
75,24,212404511,24451,Saint-Martial-de-Valette,819,800,19
75,24,212404529,24452,Saint-Martial-Viveyrol,188,186,2
75,24,212404537,24453,Saint-Martin-de-Fressengeas,369,363,6
75,24,212404545,24454,Saint-Martin-de-Gurson,659,652,7
75,24,212404552,24455,Saint-Martin-de-Ribérac,749,739,10
75,24,212404560,24456,Saint-Martin-des-Combes,199,196,3
75,24,212404578,24457,Saint-Martin-l'Astier,140,138,2
75,24,212404586,24458,Saint-Martin-le-Pin,269,262,7
75,24,212404594,24459,Saint-Mayme-de-Péreyrol,295,285,10
75,24,212404602,24460,Saint-Méard-de-Drône,504,498,6
75,24,212404610,24461,Saint-Méard-de-Gurçon,826,815,11
75,24,212404628,24462,Saint-Médard-de-Mussidan,1710,1677,33
75,24,212404636,24463,Saint-Médard-d'Excideuil,557,542,15
75,24,212404644,24464,Saint-Mesmin,332,326,6
75,24,212404651,24465,Saint-Michel-de-Double,238,233,5
75,24,212404669,24466,Saint-Michel-de-Montaigne,330,325,5
75,24,212404685,24468,Saint-Michel-de-Villadeix,306,300,6
75,24,212404701,24470,Sainte-Mondane,278,272,6
75,24,212404719,24471,Sainte-Nathalène,641,629,12
75,24,212404727,24472,Saint-Nexans,1009,992,17
75,24,212404735,24473,Sainte-Orse,357,351,6
75,24,212404743,24474,Saint-Pancrace,159,158,1
75,24,212404768,24476,Saint-Pantaly-d'Excideuil,161,158,3
75,24,212404776,24477,Saint-Pardoux-de-Drône,194,192,2
75,24,212404784,24478,Saint-Pardoux-et-Vielvic,192,192,0
75,24,212404792,24479,Saint-Pardoux-la-Rivière,1189,1169,20
75,24,212404800,24480,Saint-Paul-de-Serre,316,313,3
75,24,212404818,24481,Saint-Paul-la-Roche,514,514,0
75,24,212404826,24482,Saint-Paul-Lizonne,279,277,2
75,24,212404834,24483,Saint-Perdoux,149,142,7
75,24,212404842,24484,Saint-Pierre-de-Chignac,905,889,16
75,24,212404859,24485,Saint-Pierre-de-Côle,418,415,3
75,24,212404867,24486,Saint-Pierre-de-Frugie,409,406,3
75,24,212404875,24487,Saint-Pierre-d'Eyraud,1829,1814,15
75,24,212404883,24488,Saint-Pompont,348,343,5
75,24,212404891,24489,Saint-Priest-les-Fougères,382,375,7
75,24,200065399,24490,Saint Privat en Périgord,1131,1116,15
75,24,212404917,24491,Saint-Rabier,590,579,11
75,24,212404925,24492,Sainte-Radegonde,68,66,2
75,24,212404933,24493,Saint-Raphaël,95,93,2
75,24,212404941,24494,Saint-Rémy,508,504,4
75,24,212404958,24495,Saint-Romain-de-Monpazier,119,116,3
75,24,212404966,24496,Saint-Romain-et-Saint-Clément,332,328,4
75,24,212404982,24498,Saint-Saud-Lacoussière,845,825,20
75,24,212404990,24499,Saint-Sauveur,883,862,21
75,24,212405005,24500,Saint-Sauveur-Lalande,153,146,7
75,24,212405013,24501,Saint-Seurin-de-Prats,488,483,5
75,24,212405021,24502,Saint-Séverin-d'Estissac,89,89,0
75,24,212405047,24504,Saint-Sulpice-de-Roumagnac,283,282,1
75,24,212405054,24505,Saint-Sulpice-d'Excideuil,354,351,3
75,24,212405070,24507,Sainte-Trie,112,110,2
75,24,212405088,24508,Saint-Victor,218,213,5
75,24,212405096,24509,Saint-Vincent-de-Connezac,679,667,12
75,24,212405104,24510,Saint-Vincent-de-Cosse,379,369,10
75,24,212405112,24511,Saint-Vincent-Jalmoutiers,259,256,3
75,24,212405120,24512,Saint-Vincent-le-Paluel,304,293,11
75,24,212405138,24513,Saint-Vincent-sur-l'Isle,316,313,3
75,24,212405146,24514,Saint-Vivien,244,242,2
75,24,212405153,24515,Salagnac,729,724,5
75,24,212405161,24516,Salignac-Eyvigues,1243,1189,54
75,24,212405179,24517,Salles-de-Belvès,75,73,2
75,24,212405187,24518,Salon,290,286,4
75,24,212405195,24519,Sarlande,436,431,5
75,24,212405203,24520,Sarlat-la-Canéda,9192,8788,404
75,24,212405211,24521,Sarliac-sur-l'Isle,1050,1031,19
75,24,212405229,24522,Sarrazac,372,361,11
75,24,212405237,24523,Saussignac,435,423,12
75,24,212405245,24524,Savignac-de-Miremont,180,178,2
75,24,212405252,24525,Savignac-de-Nontron,199,197,2
75,24,212405260,24526,Savignac-Lédrier,723,714,9
75,24,212405278,24527,Savignac-les-Églises,954,938,16
75,24,212405286,24528,Sceau-Saint-Angel,129,127,2
75,24,212405294,24529,Segonzac,202,200,2
75,24,212405310,24531,Sergeac,215,212,3
75,24,212405328,24532,Serres-et-Montguyard,253,250,3
75,24,212405336,24533,Servanches,83,79,4
75,24,200084275,24534,Sigoulès-et-Flaugeac,1430,1192,238
75,24,212405351,24535,Simeyrols,255,252,3
75,24,212405369,24536,Singleyrac,316,311,5
75,24,212405377,24537,Siorac-de-Ribérac,254,250,4
75,24,212405385,24538,Siorac-en-Périgord,1073,1062,11
75,24,200060267,24540,Sorges et Ligueux en Périgord,1630,1601,29
75,24,212405419,24541,Soudat,94,93,1
75,24,212405427,24542,Soulaures,77,74,3
75,24,212405435,24543,Sourzac,1128,1111,17
75,24,212405443,24544,Tamniès,401,392,9
75,24,212405450,24545,Teillots,99,98,1
75,24,212405468,24546,Temple-Laguyon,36,36,0
75,24,212405476,24547,Terrasson-Lavilledieu,6370,6264,106
75,24,212405484,24548,Teyjat,279,275,4
75,24,212405492,24549,Thénac,485,480,5
75,24,212405500,24550,Thenon,1270,1254,16
75,24,212405518,24551,Thiviers,3060,2870,190
75,24,212405526,24552,Thonac,262,256,6
75,24,212405534,24553,Tocane-Saint-Apre,1774,1738,36
75,24,200065340,24554,La Tour-Blanche-Cercles,577,563,14
75,24,212405559,24555,Tourtoirac,649,639,10
75,24,212405575,24557,Trélissac,7390,7191,199
75,24,212405583,24558,Trémolat,635,630,5
75,24,212405591,24559,Tursac,342,332,10
75,24,212406037,24560,Urval,121,114,7
75,24,212405625,24562,Vallereuil,279,267,12
75,24,212405633,24563,Valojoulx,288,281,7
75,24,212405641,24564,Vanxains,796,690,106
75,24,212405658,24565,Varaignes,376,368,8
75,24,212405666,24566,Varennes,473,463,10
75,24,212405674,24567,Vaunac,251,248,3
75,24,212405682,24568,Vélines,1065,1053,12
75,24,212405690,24569,Vendoire,130,129,1
75,24,212405708,24570,Verdon,40,39,1
75,24,212405716,24571,Vergt,1726,1712,14
75,24,212405724,24572,Vergt-de-Biron,195,190,5
75,24,212405732,24573,Verteillac,559,547,12
75,24,212405740,24574,Veyrignac,348,337,11
75,24,212405757,24575,Veyrines-de-Domme,254,232,22
75,24,212405765,24576,Veyrines-de-Vergt,255,245,10
75,24,212405773,24577,Vézac,526,516,10
75,24,212405807,24580,Villac,265,264,1
75,24,212405815,24581,Villamblard,927,908,19
75,24,212405823,24582,Villars,466,456,10
75,24,212405849,24584,Villefranche-de-Lonchat,982,963,19
75,24,212405856,24585,Villefranche-du-Périgord,683,671,12
75,24,212405864,24586,Villetoureix,931,912,19
75,24,212405872,24587,Vitrac,846,826,20
27,25,212500011,25001,Abbans-Dessous,253,247,6
27,25,212500029,25002,Abbans-Dessus,303,298,5
27,25,212500037,25003,Abbenans,327,321,6
27,25,212500045,25004,Abbévillers,1088,1068,20
27,25,212500052,25005,Accolans,90,89,1
27,25,212500060,25006,Adam-lès-Passavant,93,88,5
27,25,212500078,25007,Adam-lès-Vercel,111,108,3
27,25,212500086,25008,Aibre,469,465,4
27,25,212500094,25009,Aïssey,166,163,3
27,25,212500110,25011,Allenjoie,757,741,16
27,25,212500128,25012,Les Alliés,175,170,5
27,25,212500136,25013,Allondans,260,253,7
27,25,212500144,25014,Amagney,947,936,11
27,25,212500151,25015,Amancey,726,706,20
27,25,212500169,25016,Amathay-Vésigneux,170,167,3
27,25,212500177,25017,Amondans,93,90,3
27,25,212500185,25018,Anteuil,634,613,21
27,25,212500193,25019,Appenans,395,384,11
27,25,212500201,25020,Arbouans,911,902,9
27,25,212500219,25021,Arc-et-Senans,1643,1614,29
27,25,212500227,25022,Arcey,1520,1481,39
27,25,212500243,25024,Arçon,961,930,31
27,25,212500250,25025,Arc-sous-Cicon,730,717,13
27,25,212500268,25026,Arc-sous-Montenot,229,224,5
27,25,212500292,25029,Aubonne,251,248,3
27,25,212500300,25030,Audeux,437,427,10
27,25,212500318,25031,Audincourt,13763,13542,221
27,25,212500326,25032,Autechaux,437,427,10
27,25,212500334,25033,Autechaux-Roide,526,516,10
27,25,200048437,25035,Les Auxons,2558,2512,46
27,25,212500367,25036,Avanne-Aveney,2261,2232,29
27,25,212500383,25038,Avilley,164,160,4
27,25,212500391,25039,Avoudrey,946,927,19
27,25,212500409,25040,Badevel,821,807,14
27,25,212500417,25041,Bannans,379,370,9
27,25,212500425,25042,Le Barboux,234,226,8
27,25,212500433,25043,Bart,2059,2006,53
27,25,212500441,25044,Bartherans,59,59,0
27,25,212500458,25045,Battenans-les-Mines,48,47,1
27,25,212500466,25046,Battenans-Varin,79,75,4
27,25,212500474,25047,Baume-les-Dames,5144,4984,160
27,25,212500482,25048,Bavans,3678,3604,74
27,25,212500490,25049,Belfays,141,136,5
27,25,212500508,25050,Le Bélieu,516,504,12
27,25,212500516,25051,Belleherbe,635,622,13
27,25,212500524,25052,Belmont,66,66,0
27,25,212500532,25053,Belvoir,100,93,7
27,25,212500540,25054,Berche,553,540,13
27,25,212500557,25055,Berthelange,363,356,7
27,25,212500565,25056,Besançon,121519,118258,3261
27,25,212500573,25057,Bethoncourt,5404,5336,68
27,25,212500581,25058,Beure,1374,1361,13
27,25,212500599,25059,Beutal,273,268,5
27,25,212500607,25060,Bians-les-Usiers,723,699,24
27,25,212500615,25061,Bief,117,116,1
27,25,212500623,25062,Le Bizot,308,297,11
27,25,212500631,25063,Blamont,1236,1210,26
27,25,212500656,25065,Blarians,58,54,4
27,25,212500664,25066,Blussangeaux,86,85,1
27,25,212500672,25067,Blussans,193,190,3
27,25,212500706,25070,Bolandoz,392,377,15
27,25,212500714,25071,Bondeval,481,477,4
27,25,212500722,25072,Bonnal,21,20,1
27,25,212500730,25073,Bonnay,836,830,6
27,25,212500748,25074,Bonnétage,1005,984,21
27,25,212500755,25075,Bonnevaux,415,405,10
27,25,212500771,25077,La Bosse,75,75,0
27,25,200076370,25078,Bouclans,1089,1064,25
27,25,212500797,25079,Boujailles,452,445,7
27,25,212500821,25082,Bourguignon,911,888,23
27,25,212500839,25083,Bournois,192,190,2
27,25,212500847,25084,Boussières,1188,1169,19
27,25,212500854,25085,Bouverans,408,400,8
27,25,212500862,25086,Braillans,210,208,2
27,25,212500870,25087,Branne,182,179,3
27,25,212500888,25088,Breconchaux,93,87,6
27,25,212500896,25089,Bremondans,100,98,2
27,25,212500904,25090,Brères,69,69,0
27,25,212500912,25091,Les Bréseux,484,476,8
27,25,212500920,25092,La Bretenière,72,70,2
27,25,212500938,25093,Bretigney,76,76,0
27,25,212500946,25094,Bretigney-Notre-Dame,119,119,0
27,25,212500953,25095,Bretonvillers,287,284,3
27,25,212500961,25096,Brey-et-Maison-du-Bois,165,163,2
27,25,212500979,25097,Brognard,490,478,12
27,25,212500987,25098,Buffard,191,188,3
27,25,212500995,25099,Bugny,248,241,7
27,25,212501001,25100,Bulle,486,477,9
27,25,212501019,25101,Burgille,587,574,13
27,25,212501027,25102,Burnevillers,51,49,2
27,25,212501035,25103,Busy,653,649,4
27,25,212501043,25104,By,85,84,1
27,25,212501050,25105,Byans-sur-Doubs,614,608,6
27,25,212501068,25106,Cademène,68,68,0
27,25,212501076,25107,Cendrey,196,195,1
27,25,212501084,25108,Cernay-l'Église,320,312,8
27,25,212501092,25109,Cessey,335,325,10
27,25,212501100,25110,Chaffois,1050,1031,19
27,25,212501118,25111,Chalèze,377,364,13
27,25,212501126,25112,Chalezeule,1349,1323,26
27,25,212501134,25113,Chamesey,146,141,5
27,25,212501142,25114,Chamesol,396,390,6
27,25,212501159,25115,Champagney,281,277,4
27,25,212501167,25116,Champlive,252,245,7
27,25,212501175,25117,Champoux,89,89,0
27,25,212501191,25119,Champvans-les-Moulins,331,321,10
27,25,212501209,25120,Chantrans,404,394,10
27,25,212501217,25121,Chapelle-des-Bois,271,256,15
27,25,212501225,25122,Chapelle-d'Huin,540,528,12
27,25,212501241,25124,Charmauvillers,285,278,7
27,25,212501258,25125,Charmoille,328,323,5
27,25,212501266,25126,Charnay,486,478,8
27,25,212501274,25127,Charquemont,2840,2791,49
27,25,212501290,25129,Chassagne-Saint-Denis,114,111,3
27,25,212501308,25130,Châteauvieux-les-Fossés,10,10,0
27,25,212501316,25131,Châtelblanc,115,110,5
27,25,212501324,25132,Châtillon-Guyotte,146,142,4
27,25,212501332,25133,Châtillon-le-Duc,2062,2007,55
27,25,212501365,25136,Chaucenne,512,499,13
27,25,212501381,25138,Les Terres-de-Chaux,130,125,5
27,25,212501399,25139,La Chaux,616,606,10
27,25,212501415,25141,Chaux-lès-Passavant,128,122,6
27,25,212501423,25142,Chaux-Neuve,332,329,3
27,25,212501431,25143,Chay,214,204,10
27,25,212501456,25145,Chazot,119,118,1
27,25,200066686,25147,Chemaudin et Vaux,2107,2067,40
27,25,212501480,25148,La Chenalotte,502,497,5
27,25,212501498,25149,Chenecey-Buillon,516,505,11
27,25,212501506,25150,Chevigney-sur-l'Ognon,293,290,3
27,25,212501514,25151,Chevigney-lès-Vercel,139,135,4
27,25,212501522,25152,La Chevillotte,160,160,0
27,25,212501530,25153,Chevroz,134,133,1
27,25,212501548,25154,Chouzelot,275,265,10
27,25,212501555,25155,Cléron,309,296,13
27,25,200086288,25156,Pays-de-Clerval,1160,1139,21
27,25,212501571,25157,La Cluse-et-Mijoux,1360,1331,29
27,25,212501597,25159,Colombier-Fontaine,1228,1205,23
27,25,212501605,25160,Les Combes,778,752,26
27,25,212501613,25161,Consolation-Maisonnettes,32,28,4
27,25,212501621,25162,Corcelles-Ferrières,218,212,6
27,25,212501639,25163,Corcelle-Mieslot,106,105,1
27,25,212501647,25164,Corcondray,145,145,0
27,25,212501662,25166,Côtebrune,90,84,6
27,25,212501704,25170,Courcelles-lès-Montbéliard,1430,1388,42
27,25,212501712,25171,Courcelles,107,105,2
27,25,212501720,25172,Courchapon,236,233,3
27,25,212501738,25173,Cour-Saint-Maurice,152,148,4
27,25,212501746,25174,Courtefontaine,246,243,3
27,25,212501753,25175,Courtetain-et-Salans,92,91,1
27,25,212501761,25176,Courvières,324,319,5
27,25,212501779,25177,Crosey-le-Grand,153,148,5
27,25,212501787,25178,Crosey-le-Petit,126,123,3
27,25,212501795,25179,Le Crouzet,63,61,2
27,25,212501803,25180,Crouzet-Migette,122,116,6
27,25,212501811,25181,Cubrial,157,151,6
27,25,212501829,25182,Cubry,97,96,1
27,25,212501837,25183,Cusance,78,76,2
27,25,212501845,25184,Cuse-et-Adrisans,299,287,12
27,25,200096808,25185,Cussey-sur-Lison,71,68,3
27,25,212501860,25186,Cussey-sur-l'Ognon,1068,1044,24
27,25,212501878,25187,Dambelin,508,502,6
27,25,212501886,25188,Dambenois,773,748,25
27,25,212501894,25189,Dammartin-les-Templiers,190,184,6
27,25,212501902,25190,Dampierre-les-Bois,1609,1584,25
27,25,212501910,25191,Dampierre-sur-le-Doubs,460,450,10
27,25,212501928,25192,Dampjoux,173,169,4
27,25,212501936,25193,Damprichard,1877,1832,45
27,25,212501944,25194,Dannemarie,114,114,0
27,25,212501951,25195,Dannemarie-sur-Crète,1833,1543,290
27,25,212501969,25196,Dasle,1406,1380,26
27,25,212501977,25197,Deluz,630,620,10
27,25,212501985,25198,Désandans,744,723,21
27,25,212501993,25199,Déservillers,349,342,7
27,25,212502009,25200,Devecey,1379,1343,36
27,25,212502017,25201,Dommartin,781,766,15
27,25,212502025,25202,Dompierre-les-Tilleuls,314,307,7
27,25,212502033,25203,Domprel,186,184,2
27,25,212502041,25204,Doubs,3309,3235,74
27,25,212502074,25207,Dung,637,620,17
27,25,212502082,25208,Durnes,193,184,9
27,25,212502090,25209,Échay,129,125,4
27,25,212502108,25210,Échenans,165,161,4
27,25,212502116,25211,Échevannes,88,87,1
27,25,212502124,25212,École-Valentin,2754,2703,51
27,25,212502132,25213,Les Écorces,768,745,23
27,25,212502140,25214,Écot,499,489,10
27,25,212502157,25215,L'Écouvotte,88,88,0
27,25,212502165,25216,Écurcey,273,263,10
27,25,212502173,25217,Émagny,613,603,10
27,25,212502181,25218,Épenouse,172,165,7
27,25,212502199,25219,Épenoy,651,637,14
27,25,212502207,25220,Épeugney,608,593,15
27,25,212502215,25221,Esnans,64,64,0
27,25,200066629,25222,Étalans,1644,1607,37
27,25,212502231,25223,Éternoz,331,322,9
27,25,212502249,25224,Étouvans,844,831,13
27,25,212502256,25225,Étrabonne,188,187,1
27,25,212502264,25226,Étrappe,218,213,5
27,25,212502272,25227,Étray,285,285,0
27,25,212502280,25228,Étupes,3784,3721,63
27,25,212502298,25229,Évillers,396,392,4
27,25,212502306,25230,Exincourt,3299,3245,54
27,25,212502314,25231,Eysson,122,120,2
27,25,212502322,25232,Faimbe,101,99,2
27,25,212502330,25233,Fallerans,296,286,10
27,25,212502348,25234,Ferrières-le-Lac,181,174,7
27,25,212502355,25235,Ferrières-les-Bois,327,320,7
27,25,212502363,25236,Fertans,307,304,3
27,25,212502371,25237,Fesches-le-Châtel,2197,2163,34
27,25,212502389,25238,Fessevillers,159,157,2
27,25,212502397,25239,Feule,183,181,2
27,25,212502405,25240,Les Fins,3282,3157,125
27,25,212502413,25241,Flagey,146,140,6
27,25,212502421,25242,Flagey-Rigney,122,122,0
27,25,212502439,25243,Flangebouche,826,807,19
27,25,212502447,25244,Fleurey,87,84,3
27,25,200085827,25245,Fontain,1248,1226,22
27,25,212502462,25246,Fontaine-lès-Clerval,280,270,10
27,25,212502470,25247,Fontenelle-Montby,87,84,3
27,25,212502488,25248,Les Fontenelles,639,527,112
27,25,212502496,25249,Fontenotte,64,62,2
27,25,212502512,25251,Fourbanne,182,174,8
27,25,212502520,25252,Fourcatier-et-Maison-Neuve,117,117,0
27,25,212502538,25253,Fourg,388,386,2
27,25,212502546,25254,Les Fourgs,1432,1400,32
27,25,212502553,25255,Fournet-Blancheroche,362,349,13
27,25,212502561,25256,Frambouhans,914,900,14
27,25,212502579,25257,Franey,273,268,5
27,25,212502587,25258,Franois,2311,2272,39
27,25,212502595,25259,Frasne,1970,1933,37
27,25,212502611,25261,Froidevaux,80,80,0
27,25,212502629,25262,Fuans,491,467,24
27,25,212502637,25263,Gellin,256,254,2
27,25,212502645,25264,Gémonval,85,83,2
27,25,212502652,25265,Geneuille,1328,1299,29
27,25,212502660,25266,Geney,123,119,4
27,25,212502678,25267,Gennes,701,682,19
27,25,212502686,25268,Germéfontaine,116,114,2
27,25,212502694,25269,Germondans,63,62,1
27,25,212502702,25270,Gevresin,131,131,0
27,25,212502710,25271,Gilley,1768,1730,38
27,25,212502736,25273,Glamondans,206,202,4
27,25,212502744,25274,Glay,342,340,2
27,25,212502751,25275,Glère,193,189,4
27,25,212502769,25276,Gondenans-Montby,170,168,2
27,25,212502777,25277,Gondenans-les-Moulins,78,76,2
27,25,212502785,25278,Gonsans,579,566,13
27,25,212502793,25279,Gouhelans,120,119,1
27,25,212502801,25280,Goumois,158,154,4
27,25,212502819,25281,Goux-lès-Dambelin,282,278,4
27,25,212502827,25282,Goux-les-Usiers,794,781,13
27,25,212502835,25283,Goux-sous-Landet,63,62,1
27,25,212502843,25284,Grand-Charmont,5922,5849,73
27,25,212502850,25285,Grand'Combe-Châteleu,1525,1499,26
27,25,212502868,25286,Grand'Combe-des-Bois,128,123,5
27,25,212502876,25287,Grandfontaine,1826,1784,42
27,25,212502884,25288,Fournets-Luisans,753,734,19
27,25,212502892,25289,Grandfontaine-sur-Creuse,77,74,3
27,25,212502900,25290,La Grange,98,96,2
27,25,212502934,25293,Granges-Narboz,1339,1288,51
27,25,212502959,25295,Les Grangettes,313,308,5
27,25,212502967,25296,Les Gras,817,789,28
27,25,212502975,25297,Le Gratteris,163,160,3
27,25,212502983,25298,Grosbois,252,244,8
27,25,212502991,25299,Guillon-les-Bains,112,111,1
27,25,212503007,25300,Guyans-Durnes,310,304,6
27,25,212503015,25301,Guyans-Vennes,893,867,26
27,25,212503031,25303,Hauterive-la-Fresse,229,223,6
27,25,212503049,25304,Hérimoncourt,3672,3619,53
27,25,212503056,25305,L'Hôpital-du-Grosbois,606,590,16
27,25,212503064,25306,L'Hôpital-Saint-Lieffroy,125,123,2
27,25,212503072,25307,Les Hôpitaux-Neufs,918,907,11
27,25,212503080,25308,Les Hôpitaux-Vieux,470,464,6
27,25,212503098,25309,Houtaud,1196,1159,37
27,25,212503106,25310,Huanne-Montmartin,101,100,1
27,25,212503114,25311,Hyémondans,214,210,4
27,25,212503122,25312,Hyèvre-Magny,67,66,1
27,25,212503130,25313,Hyèvre-Paroisse,200,197,3
27,25,212503148,25314,Indevillers,274,272,2
27,25,212503155,25315,L'Isle-sur-le-Doubs,2920,2849,71
27,25,212503163,25316,Issans,242,237,5
27,25,212503171,25317,Jallerange,271,267,4
27,25,212503189,25318,Jougne,1882,1850,32
27,25,212503205,25320,Labergement-Sainte-Marie,1253,1218,35
27,25,212503213,25321,Villers-le-Lac,5307,5207,100
27,25,212503221,25322,Laire,419,409,10
27,25,212503239,25323,Laissey,454,448,6
27,25,212503247,25324,Lanans,167,159,8
27,25,212503254,25325,Landresse,240,232,8
27,25,212503262,25326,Lantenne-Vertière,548,534,14
27,25,212503270,25327,Lanthenans,70,70,0
27,25,212503288,25328,Larnod,807,796,11
27,25,212503296,25329,Laval-le-Prieuré,36,35,1
27,25,212503304,25330,Lavans-Quingey,183,179,4
27,25,212503312,25331,Lavans-Vuillafans,256,251,5
27,25,212503320,25332,Lavernay,579,569,10
27,25,212503338,25333,Laviron,362,347,15
27,25,200068401,25334,Levier,2511,2269,242
27,25,212503353,25335,Liebvillers,155,150,5
27,25,212503361,25336,Liesle,553,548,5
27,25,212503387,25338,Lizine,100,99,1
27,25,212503395,25339,Lods,226,224,2
27,25,212503403,25340,Lombard,196,191,5
27,25,212503411,25341,Lomont-sur-Crête,179,173,6
27,25,212503429,25342,Longechaux,81,78,3
27,25,212503437,25343,Longemaison,170,164,6
27,25,212503445,25344,Longevelle-lès-Russey,45,45,0
27,25,212503452,25345,Longevelle-sur-Doubs,679,665,14
27,25,212503460,25346,Longeville,185,183,2
27,25,212503478,25347,La Longeville,844,829,15
27,25,212503486,25348,Longevilles-Mont-d'Or,620,611,9
27,25,212503494,25349,Loray,599,584,15
27,25,212503502,25350,Lougres,752,730,22
27,25,212503510,25351,Le Luhier,240,239,1
27,25,212503544,25354,Luxiol,160,158,2
27,25,212503551,25355,Magny-Châtelard,63,63,0
27,25,212503569,25356,Maîche,4362,4259,103
27,25,212503577,25357,Maisons-du-Bois-Lièvremont,861,853,8
27,25,212503593,25359,Malans,163,158,5
27,25,212503601,25360,Malbrans,178,174,4
27,25,212503619,25361,Malbuisson,877,851,26
27,25,212503627,25362,Malpas,298,286,12
27,25,212503643,25364,Mamirolle,1825,1806,19
27,25,212503650,25365,Mancenans,316,310,6
27,25,212503668,25366,Mancenans-Lizerne,197,191,6
27,25,212503676,25367,Mandeure,4945,4795,150
27,25,200077212,25368,Marchaux-Chaudefontaine,1482,1462,20
27,25,212503692,25369,Marvelise,160,158,2
27,25,212503700,25370,Mathay,2189,2152,37
27,25,212503718,25371,Mazerolles-le-Salin,223,216,7
27,25,212503726,25372,Médière,283,277,6
27,25,212503734,25373,Le Mémont,47,46,1
27,25,212503742,25374,Mercey-le-Grand,570,553,17
27,25,200096915,25375,Les Monts-Ronds,674,661,13
27,25,212503767,25376,Mérey-Vieilley,163,158,5
27,25,212503775,25377,Mésandans,238,232,6
27,25,212503783,25378,Meslières,350,342,8
27,25,212503791,25379,Mesmay,76,71,5
27,25,212503809,25380,Métabief,1449,1411,38
27,25,212503817,25381,Miserey-Salines,2695,2658,37
27,25,212503825,25382,Moncey,617,612,5
27,25,212503833,25383,Moncley,279,272,7
27,25,212503841,25384,Mondon,96,91,5
27,25,212503858,25385,Montagney-Servigney,129,126,3
27,25,212503866,25386,Montancy,126,122,4
27,25,212503874,25387,Montandon,384,375,9
27,25,212503882,25388,Montbéliard,26269,25726,543
27,25,212503890,25389,Montbéliardot,117,113,4
27,25,212503908,25390,Montbenoît,410,398,12
27,25,212503916,25391,Mont-de-Laval,191,185,6
27,25,212503924,25392,Mont-de-Vougney,203,198,5
27,25,212503932,25393,Montécheroux,553,546,7
27,25,212503940,25394,Montenois,1502,1459,43
27,25,212503957,25395,Montfaucon,1626,1576,50
27,25,212503973,25397,Montferrand-le-Château,2234,2190,44
27,25,212503981,25398,Montflovin,122,118,4
27,25,212504005,25400,Montgesoye,485,479,6
27,25,212504013,25401,Montivernage,27,27,0
27,25,212504021,25402,Montjoie-le-Château,25,24,1
27,25,212504039,25403,Montlebon,2263,2190,73
27,25,212504047,25404,Montmahoux,95,91,4
27,25,212504054,25405,Montperreux,970,929,41
27,25,212504062,25406,Montrond-le-Château,582,568,14
27,25,212504088,25408,Montussaint,56,55,1
27,25,212504104,25410,Morre,1389,1327,62
27,25,212504112,25411,Morteau,7187,6851,336
27,25,212504138,25413,Mouthe,1057,1022,35
27,25,212504146,25414,Le Moutherot,128,126,2
27,25,212504153,25415,Mouthier-Haute-Pierre,349,344,5
27,25,212504161,25416,Myon,186,182,4
27,25,212504179,25417,Naisey-les-Granges,827,806,21
27,25,212504187,25418,Nancray,1304,1272,32
27,25,212504195,25419,Nans,97,93,4
27,25,212504203,25420,Nans-sous-Sainte-Anne,171,167,4
27,25,212504211,25421,Narbief,81,81,0
27,25,212504229,25422,Neuchâtel-Urtière,174,170,4
27,25,200057156,25424,Les Premiers Sapins,1578,1548,30
27,25,212504252,25425,Noël-Cerneux,475,458,17
27,25,212504260,25426,Noirefontaine,337,331,6
27,25,212504278,25427,Noironte,402,397,5
27,25,212504286,25428,Nommay,1649,1611,38
27,25,212504294,25429,Novillars,1479,1446,33
27,25,212504302,25430,Ollans,38,38,0
27,25,212504310,25431,Onans,355,348,7
27,25,212504328,25432,Orchamps-Vennes,2218,2161,57
27,25,212504336,25433,Orgeans-Blanchefontaine,40,39,1
27,25,200055903,25434,Ornans,4528,4422,106
27,25,212504351,25435,Orsans,171,168,3
27,25,212504369,25436,Orve,59,57,2
27,25,212504377,25437,Osse,352,349,3
27,25,200060556,25438,Osselle-Routelle,974,959,15
27,25,212504393,25439,Ougney-Douvot,256,254,2
27,25,212504401,25440,Ouhans,391,383,8
27,25,212504419,25441,Ouvans,68,67,1
27,25,212504427,25442,Oye-et-Pallet,751,725,26
27,25,212504435,25443,Palantine,75,72,3
27,25,212504443,25444,Palise,146,142,4
27,25,212504450,25445,Paroy,125,123,2
27,25,212504468,25446,Passavant,199,188,11
27,25,212504476,25447,Passonfontaine,350,341,9
27,25,212504484,25448,Pelousey,1560,1531,29
27,25,212504492,25449,Péseux,142,141,1
27,25,212504500,25450,Pessans,88,85,3
27,25,212504518,25451,Petite-Chaux,155,152,3
27,25,212504526,25452,Pierrefontaine-lès-Blamont,482,473,9
27,25,212504534,25453,Pierrefontaine-les-Varans,1423,1384,39
27,25,212504542,25454,Pirey,2179,2128,51
27,25,212504559,25455,Placey,200,196,4
27,25,212504567,25456,Plaimbois-du-Miroir,280,271,9
27,25,212504575,25457,Plaimbois-Vennes,114,114,0
27,25,212504583,25458,Les Plains-et-Grands-Essarts,219,214,5
27,25,212504591,25459,La Planée,325,315,10
27,25,200068344,25460,Le Val,260,242,18
27,25,212504617,25461,Pompierre-sur-Doubs,307,302,5
27,25,212504625,25462,Pontarlier,18618,17738,880
27,25,200037182,25463,Pont-de-Roide-Vermondans,4162,4088,74
27,25,212504641,25464,Les Pontets,139,135,4
27,25,212504658,25465,Pont-les-Moulins,208,205,3
27,25,212504666,25466,Pouilley-Français,843,826,17
27,25,212504674,25467,Pouilley-les-Vignes,2078,2042,36
27,25,212504682,25468,Pouligney-Lusans,863,844,19
27,25,212504690,25469,Présentevillers,476,463,13
27,25,212504708,25470,La Prétière,163,158,5
27,25,212504716,25471,Provenchère,143,138,5
27,25,212504724,25472,Puessans,36,33,3
27,25,212504732,25473,Pugey,729,716,13
27,25,212504740,25474,Le Puy,114,111,3
27,25,212504757,25475,Quingey,1422,1399,23
27,25,212504765,25476,Rahon,131,128,3
27,25,212504773,25477,Rancenay,409,403,6
27,25,212504781,25478,Randevillers,124,122,2
27,25,212504799,25479,Rang,396,392,4
27,25,212504815,25481,Raynans,345,340,5
27,25,212504823,25482,Recologne,689,687,2
27,25,212504831,25483,Reculfoz,41,38,3
27,25,212504856,25485,Rémondans-Vaivre,229,224,5
27,25,212504864,25486,Remoray-Boujeons,446,435,11
27,25,212504872,25487,Renédale,51,47,4
27,25,212504880,25488,Rennes-sur-Loue,109,108,1
27,25,212504898,25489,Reugney,306,280,26
27,25,212504906,25490,Rigney,396,377,19
27,25,212504914,25491,Rignosot,117,114,3
27,25,212504922,25492,Rillans,96,93,3
27,25,212504930,25493,La Rivière-Drugeon,947,924,23
27,25,212504948,25494,Rochejean,754,729,25
27,25,212504955,25495,Roche-lez-Beaupré,2193,2169,24
27,25,212504963,25496,Roche-lès-Clerval,99,99,0
27,25,212504971,25497,Roches-lès-Blamont,630,616,14
27,25,212504989,25498,Rognon,49,49,0
27,25,212504997,25499,Romain,124,122,2
27,25,212505002,25500,Ronchaux,86,85,1
27,25,212505010,25501,Rondefontaine,38,37,1
27,25,212505028,25502,Roset-Fluans,559,555,4
27,25,212505036,25503,Rosières-sur-Barbèche,118,114,4
27,25,212505044,25504,Rosureux,83,81,2
27,25,212505051,25505,Rougemont,1055,1028,27
27,25,212505069,25506,Rougemontot,91,91,0
27,25,212505077,25507,Rouhe,74,72,2
27,25,212505085,25508,Roulans,1154,1127,27
27,25,212505101,25510,Ruffey-le-Château,369,360,9
27,25,212505119,25511,Rurey,362,356,6
27,25,212505127,25512,Le Russey,2499,2446,53
27,25,212505135,25513,Sainte-Anne,49,49,0
27,25,212505143,25514,Saint-Antoine,342,330,12
27,25,212505150,25515,Sainte-Colombe,452,446,6
27,25,212505168,25516,Saint-Georges-Armont,130,124,6
27,25,212505176,25517,Saint-Gorgon-Main,285,276,9
27,25,212505184,25518,Saint-Hilaire,166,157,9
27,25,212505192,25519,Saint-Hippolyte,926,913,13
27,25,212505200,25520,Saint-Juan,182,181,1
27,25,212505218,25521,Saint-Julien-lès-Montbéliard,164,159,5
27,25,212505226,25522,Saint-Julien-lès-Russey,187,184,3
27,25,212505234,25523,Sainte-Marie,687,672,15
27,25,212505242,25524,Saint-Maurice-Colombier,928,902,26
27,25,212505259,25525,Saint-Point-Lac,310,298,12
27,25,212505267,25526,Sainte-Suzanne,1488,1447,41
27,25,212505275,25527,Saint-Vit,4998,4924,74
27,25,212505283,25528,Samson,73,72,1
27,25,200054146,25529,Sancey,1345,1327,18
27,25,212505325,25532,Saône,3232,3164,68
27,25,212505333,25533,Saraz,17,17,0
27,25,212505341,25534,Sarrageois,198,194,4
27,25,212505358,25535,Saules,237,231,6
27,25,212505366,25536,Sauvagney,190,188,2
27,25,212505374,25537,Scey-Maisières,296,287,9
27,25,212505382,25538,Séchin,121,117,4
27,25,212505390,25539,Seloncourt,5894,5756,138
27,25,212505408,25540,Semondans,315,309,6
27,25,212505416,25541,Septfontaines,386,378,8
27,25,212505424,25542,Serre-les-Sapins,1823,1794,29
27,25,212505440,25544,Servin,217,209,8
27,25,212505457,25545,Silley-Amancey,147,145,2
27,25,212505465,25546,Silley-Bléfond,62,61,1
27,25,212505473,25547,Sochaux,3862,3820,42
27,25,212505481,25548,Solemont,144,137,7
27,25,212505499,25549,Sombacour,639,632,7
27,25,212505507,25550,La Sommette,253,245,8
27,25,212505515,25551,Soulce-Cernay,134,133,1
27,25,212505523,25552,Sourans,119,117,2
27,25,212505531,25553,Soye,395,387,8
27,25,212505549,25554,Surmont,118,115,3
27,25,212505556,25555,Taillecourt,1129,1104,25
27,25,212505564,25556,Tallans,50,47,3
27,25,212505572,25557,Tallenay,438,430,8
27,25,200082758,25558,Tarcenay-Foucherans,1553,1518,35
27,25,212505598,25559,Thiébouhans,264,258,6
27,25,212505606,25560,Thise,3048,3010,38
27,25,212505614,25561,Thoraise,350,341,9
27,25,212505622,25562,Thulay,218,212,6
27,25,212505630,25563,Thurey-le-Mont,121,119,2
27,25,212505648,25564,Torpes,1036,1020,16
27,25,212505655,25565,Touillon-et-Loutelet,281,273,8
27,25,212505663,25566,La Tour-de-Sçay,311,307,4
27,25,212505671,25567,Tournans,118,115,3
27,25,212505697,25569,Trépot,555,544,11
27,25,212505705,25570,Tressandans,29,28,1
27,25,212505713,25571,Trévillers,518,509,9
27,25,212505721,25572,Trouvans,109,104,5
27,25,212505739,25573,Urtière,14,14,0
27,25,212505747,25574,Uzelle,180,179,1
27,25,200062438,25575,Vaire,812,801,11
27,25,212505788,25578,Valdahon,5841,5734,107
27,25,212505796,25579,Val-de-Roulans,212,209,3
27,25,212505804,25580,Valentigney,11065,10897,168
27,25,212505820,25582,Valleroy,145,143,2
27,25,212505838,25583,Valonne,259,254,5
27,25,212505846,25584,Valoreille,128,124,4
27,25,212505861,25586,Vandoncourt,840,809,31
27,25,212505887,25588,Vaucluse,146,123,23
27,25,212505895,25589,Vauclusotte,83,82,1
27,25,212505903,25590,Vaudrivillers,82,80,2
27,25,212505911,25591,Vaufrey,153,153,0
27,25,212505929,25592,Vaux-et-Chantegrue,646,630,16
27,25,212505945,25594,Velesmes-Essarts,355,350,5
27,25,212505952,25595,Vellerot-lès-Belvoir,95,94,1
27,25,212505960,25596,Vellerot-lès-Vercel,70,69,1
27,25,212505978,25597,Vellevans,240,237,3
27,25,212505986,25598,Venise,528,521,7
27,25,212505994,25599,Vennans,263,255,8
27,25,212506000,25600,Vennes,229,224,5
27,25,212506018,25601,Vercel-Villedieu-le-Camp,1775,1691,84
27,25,212506026,25602,Vergranne,123,118,5
27,25,212506042,25604,Verne,126,125,1
27,25,212506059,25605,Vernierfontaine,493,481,12
27,25,212506075,25607,Vernois-lès-Belvoir,58,57,1
27,25,212506083,25608,Le Vernoy,180,178,2
27,25,212506091,25609,Verrières-de-Joux,501,489,12
27,25,212506117,25611,La Vèze,490,483,7
27,25,212506125,25612,Vieilley,702,684,18
27,25,212506133,25613,Viéthorey,95,93,2
27,25,212506141,25614,Vieux-Charmont,2904,2850,54
27,25,212506158,25615,Villars-lès-Blamont,458,450,8
27,25,212506166,25616,Villars-Saint-Georges,287,284,3
27,25,212506174,25617,Villars-sous-Dampjoux,357,351,6
27,25,212506182,25618,Villars-sous-Écot,353,345,8
27,25,212506190,25619,Les Villedieu,201,199,2
27,25,212506208,25620,Ville-du-Pont,340,333,7
27,25,212506216,25621,Villeneuve-d'Amont,259,223,36
27,25,212506224,25622,Villers-Buzon,261,260,1
27,25,212506232,25623,Villers-Chief,133,131,2
27,25,212506240,25624,Villers-Grélot,149,146,3
27,25,212506257,25625,Villers-la-Combe,52,51,1
27,25,212506265,25626,Villers-Saint-Martin,234,226,8
27,25,212506273,25627,Villers-sous-Chalamont,311,300,11
27,25,212506299,25629,Voillans,206,200,6
27,25,212506307,25630,Voires,78,78,0
27,25,212506315,25631,Vorges-les-Pins,599,591,8
27,25,212506323,25632,Voujeaucourt,3190,3105,85
27,25,212506331,25633,Vuillafans,731,717,14
27,25,212506349,25634,Vuillecin,659,648,11
27,25,212506356,25635,Vyt-lès-Belvoir,193,186,7
84,26,200060721,26001,Solaure en Diois,436,428,8
84,26,212600027,26002,Albon,2013,1967,46
84,26,212600035,26003,Aleyrac,52,52,0
84,26,212600043,26004,Alixan,2648,2592,56
84,26,212600050,26005,Allan,1875,1824,51
84,26,212600068,26006,Allex,2563,2488,75
84,26,212600076,26007,Ambonil,108,101,7
84,26,212600084,26008,Ancône,1392,1366,26
84,26,212600092,26009,Andancette,1363,1328,35
84,26,212600100,26010,Anneyron,4218,4117,101
84,26,212600118,26011,Aouste-sur-Sye,2644,2601,43
84,26,212600126,26012,Arnayon,23,20,3
84,26,212600134,26013,Arpavon,78,76,2
84,26,212600142,26014,Arthémonay,627,618,9
84,26,212600159,26015,Aubenasson,82,78,4
84,26,212600167,26016,Aubres,429,420,9
84,26,212600175,26017,Aucelon,16,16,0
84,26,212600183,26018,Aulan,10,10,0
84,26,212600191,26019,Aurel,247,244,3
84,26,212600209,26020,La Répara-Auriples,251,245,6
84,26,212600217,26021,Autichamp,135,133,2
84,26,212600225,26022,Ballons,93,91,2
84,26,212600233,26023,Barbières,1147,1128,19
84,26,212600241,26024,Barcelonne,364,354,10
84,26,212600258,26025,Barnave,216,209,7
84,26,212600266,26026,Barret-de-Lioure,64,64,0
84,26,212600274,26027,Barsac,144,143,1
84,26,212600282,26028,Bathernay,240,227,13
84,26,212600308,26030,La Bâtie-des-Fonds,2,2,0
84,26,212600316,26031,La Bâtie-Rolland,1057,1031,26
84,26,212600324,26032,La Baume-Cornillane,460,451,9
84,26,212600332,26033,La Baume-de-Transit,942,926,16
84,26,212600340,26034,La Baume-d'Hostun,600,592,8
84,26,212600357,26035,Beaufort-sur-Gervanne,485,477,8
84,26,212600365,26036,Beaumont-en-Diois,108,104,4
84,26,212600373,26037,Beaumont-lès-Valence,4240,4154,86
84,26,212600381,26038,Beaumont-Monteux,1360,1328,32
84,26,212600399,26039,Beauregard-Baret,910,896,14
84,26,212600407,26040,Beaurières,71,69,2
84,26,212600415,26041,Beausemblant,1455,1430,25
84,26,212600423,26042,Beauvallon,1621,1595,26
84,26,212600431,26043,Beauvoisin,152,146,6
84,26,212600456,26045,La Bégude-de-Mazenc,1702,1656,46
84,26,212600464,26046,Bellecombe-Tarendol,68,65,3
84,26,212600472,26047,Bellegarde-en-Diois,95,95,0
84,26,212600480,26048,Bénivay-Ollon,76,75,1
84,26,212600498,26049,Bésayes,1286,1248,38
84,26,212600506,26050,Bésignan,87,85,2
84,26,212600514,26051,Bézaudun-sur-Bîne,70,68,2
84,26,212600522,26052,Bonlieu-sur-Roubion,480,473,7
84,26,212600548,26054,Bouchet,1537,1501,36
84,26,212600555,26055,Boulc,158,156,2
84,26,212600563,26056,Bourdeaux,703,686,17
84,26,212600571,26057,Bourg-de-Péage,9977,9818,159
84,26,212600589,26058,Bourg-lès-Valence,20331,19814,517
84,26,212600597,26059,Bouvante,213,210,3
84,26,212600605,26060,Bouvières,154,148,6
84,26,212600613,26061,Bren,634,624,10
84,26,212600621,26062,Brette,37,34,3
84,26,212600639,26063,Buis-les-Baronnies,2370,2291,79
84,26,212600647,26064,Chabeuil,7021,6839,182
84,26,212600654,26065,Chabrillan,765,757,8
84,26,212600662,26066,Le Chaffal,41,41,0
84,26,212600670,26067,Chalancon,59,58,1
84,26,212600688,26068,Le Chalon,209,203,6
84,26,212600696,26069,Chamaloc,132,126,6
84,26,212600704,26070,Chamaret,529,520,9
84,26,212600712,26071,Chanos-Curson,1181,1146,35
84,26,212600720,26072,Chantemerle-les-Blés,1349,1327,22
84,26,212600738,26073,Chantemerle-lès-Grignan,247,244,3
84,26,212600746,26074,La Chapelle-en-Vercors,857,724,133
84,26,212600753,26075,La Charce,26,25,1
84,26,212600761,26076,Charens,28,28,0
84,26,212600779,26077,Charmes-sur-l'Herbasse,889,867,22
84,26,212600787,26078,Charols,948,935,13
84,26,212600795,26079,Charpey,1553,1515,38
84,26,212600803,26080,Chastel-Arnaud,44,44,0
84,26,212600811,26081,Châteaudouble,596,573,23
84,26,212600829,26082,Châteauneuf-de-Bordette,105,104,1
84,26,212600837,26083,Châteauneuf-de-Galaure,2412,1827,585
84,26,212600845,26084,Châteauneuf-sur-Isère,4137,3988,149
84,26,212600852,26085,Châteauneuf-du-Rhône,2836,2784,52
84,26,200084960,26086,Châtillon-en-Diois,670,658,12
84,26,212600878,26087,Châtillon-Saint-Jean,1338,1294,44
84,26,212600886,26088,Chatuzange-le-Goubet,6265,6122,143
84,26,212600894,26089,Chaudebonne,62,61,1
84,26,212600902,26090,La Chaudière,35,35,0
84,26,212600910,26091,Chauvac-Laux-Montaux,42,42,0
84,26,212600928,26092,Chavannes,749,738,11
84,26,212600936,26093,Clansayes,538,526,12
84,26,212600944,26094,Claveyson,899,883,16
84,26,212600951,26095,Cléon-d'Andran,998,965,33
84,26,212600969,26096,Clérieux,2085,2049,36
84,26,212600977,26097,Cliousclat,632,615,17
84,26,212600985,26098,Cobonne,175,170,5
84,26,212600993,26099,Colonzelle,561,547,14
84,26,212601009,26100,Combovin,475,460,15
84,26,212601017,26101,Comps,149,140,9
84,26,212601025,26102,Condillac,138,135,3
84,26,212601033,26103,Condorcet,504,500,4
84,26,212601041,26104,Cornillac,91,91,0
84,26,212601058,26105,Cornillon-sur-l'Oule,75,74,1
84,26,212601066,26106,La Coucourde,1189,1163,26
84,26,212601074,26107,Crépol,547,532,15
84,26,212601082,26108,Crest,8974,8707,267
84,26,212601108,26110,Crozes-Hermitage,675,657,18
84,26,212601116,26111,Crupies,101,100,1
84,26,212601124,26112,Curnier,209,201,8
84,26,212601132,26113,Die,5014,4770,244
84,26,212601140,26114,Dieulefit,3371,3238,133
84,26,212601157,26115,Divajeu,744,671,73
84,26,212601165,26116,Donzère,6062,5963,99
84,26,212601173,26117,Échevis,60,56,4
84,26,212601181,26118,Épinouze,1544,1520,24
84,26,212601199,26119,Érôme,816,808,8
84,26,212601215,26121,Espeluche,1143,1114,29
84,26,212601223,26122,Espenel,181,179,2
84,26,212601231,26123,Establet,23,23,0
84,26,212601249,26124,Étoile-sur-Rhône,5673,5545,128
84,26,212601256,26125,Eurre,1443,1409,34
84,26,212601264,26126,Eygalayes,90,90,0
84,26,212601272,26127,Eygaliers,122,120,2
84,26,212601280,26128,Eygluy-Escoulin,70,69,1
84,26,212601298,26129,Eymeux,1068,1048,20
84,26,212601306,26130,Eyroles,23,23,0
84,26,212601314,26131,Eyzahut,154,151,3
84,26,212601330,26133,Fay-le-Clos,180,176,4
84,26,212601348,26134,Félines-sur-Rimandoule,87,86,1
84,26,212601355,26135,Ferrassières,124,122,2
84,26,212601363,26136,Val-Maravel,51,51,0
84,26,212601371,26137,Francillon-sur-Roubion,194,192,2
84,26,212601389,26138,La Garde-Adhémar,1153,1126,27
84,26,212601397,26139,Génissieux,2468,2409,59
84,26,212601405,26140,Geyssans,733,706,27
84,26,212601413,26141,Gigors-et-Lozeron,218,213,5
84,26,212601421,26142,Glandage,119,118,1
84,26,212601439,26143,Le Grand-Serre,953,900,53
84,26,212601447,26144,Grane,2059,2007,52
84,26,212601454,26145,Les Granges-Gontardes,701,680,21
84,26,212601462,26146,Grignan,1633,1590,43
84,26,212601470,26147,Gumiane,20,19,1
84,26,212601488,26148,Hauterives,1931,1876,55
84,26,212601496,26149,Hostun,1025,1009,16
84,26,212601504,26150,Izon-la-Bruisse,11,11,0
84,26,212601520,26152,Jonchères,26,26,0
84,26,212601538,26153,Laborel,106,103,3
84,26,212601546,26154,Lachau,234,233,1
84,26,212601553,26155,Lapeyrouse-Mornay,1226,1210,16
84,26,212601561,26156,Larnage,1088,1046,42
84,26,212601579,26157,La Laupie,766,749,17
84,26,212601595,26159,Laval-d'Aix,117,115,2
84,26,212601603,26160,Laveyron,1260,1239,21
84,26,212601611,26161,Lemps,49,49,0
84,26,212601629,26162,Lens-Lestang,916,888,28
84,26,212601637,26163,Léoncel,46,46,0
84,26,212601645,26164,Lesches-en-Diois,58,57,1
84,26,212601652,26165,Livron-sur-Drôme,9404,9254,150
84,26,212601660,26166,Loriol-sur-Drôme,6722,6629,93
84,26,212601678,26167,Luc-en-Diois,544,543,1
84,26,212601686,26168,Lus-la-Croix-Haute,541,528,13
84,26,212601694,26169,Malataverne,2241,2198,43
84,26,212601702,26170,Malissard,3333,3239,94
84,26,212601710,26171,Manas,194,184,10
84,26,212601728,26172,Manthes,675,665,10
84,26,212601736,26173,Marches,894,872,22
84,26,212601744,26174,Margès,1127,1094,33
84,26,212601751,26175,Marignac-en-Diois,227,225,2
84,26,212601769,26176,Marsanne,1321,1280,41
84,26,212601777,26177,Marsaz,724,702,22
84,26,212601785,26178,Menglon,542,535,7
84,26,200056547,26179,Mercurol-Veaunes,2864,2807,57
84,26,212601801,26180,Mérindol-les-Oliviers,219,213,6
84,26,212601819,26181,Mévouillon,240,233,7
84,26,212601827,26182,Mirabel-aux-Baronnies,1550,1515,35
84,26,212601835,26183,Mirabel-et-Blacons,1215,1185,30
84,26,212601850,26185,Mirmande,607,592,15
84,26,212601868,26186,Miscon,60,60,0
84,26,212601884,26188,Mollans-sur-Ouvèze,1089,1065,24
84,26,212601892,26189,Montauban-sur-l'Ouvèze,122,120,2
84,26,212601900,26190,Montaulieu,87,85,2
84,26,212601918,26191,Montboucher-sur-Jabron,2526,2456,70
84,26,212601926,26192,Montbrison-sur-Lez,284,274,10
84,26,212601934,26193,Montbrun-les-Bains,445,443,2
84,26,212601942,26194,Montchenu,608,591,17
84,26,212601959,26195,Montclar-sur-Gervanne,194,192,2
84,26,212601967,26196,Montéléger,1884,1743,141
84,26,212601975,26197,Montélier,4395,4278,117
84,26,212601983,26198,Montélimar,40969,39790,1179
84,26,212601991,26199,Montferrand-la-Fare,29,28,1
84,26,212602007,26200,Montfroc,85,84,1
84,26,212602015,26201,Montguers,54,48,6
84,26,212602023,26202,Montjoux,344,333,11
84,26,212602031,26203,Montjoyer,284,278,6
84,26,212602049,26204,Montlaur-en-Diois,149,144,5
84,26,212602056,26205,Montmaur-en-Diois,85,85,0
84,26,212602064,26206,Montmeyran,3057,2955,102
84,26,212602072,26207,Montmiral,695,685,10
84,26,212602080,26208,Montoison,1976,1942,34
84,26,212602098,26209,Montréal-les-Sources,23,23,0
84,26,200083731,26210,Valherbasse,1038,1021,17
84,26,212602114,26211,Montségur-sur-Lauzon,1381,1352,29
84,26,212602122,26212,Montvendre,1256,1227,29
84,26,212602130,26213,Moras-en-Valloire,694,679,15
84,26,212602148,26214,Mornans,77,77,0
84,26,212602155,26215,La Motte-Chalancon,432,410,22
84,26,200096543,26216,Saint-Jean-de-Galaure,1299,1275,24
84,26,212602171,26217,La Motte-Fanjas,197,193,4
84,26,212602189,26218,Mours-Saint-Eusèbe,3314,3255,59
84,26,212602205,26220,Nyons,6921,6737,184
84,26,212602213,26221,Omblèze,72,70,2
84,26,212602221,26222,Orcinas,37,37,0
84,26,212602239,26223,Oriol-en-Royans,529,523,6
84,26,212602247,26224,Ourches,281,273,8
84,26,212602254,26225,Parnans,729,707,22
84,26,212602262,26226,Le Pègue,371,365,6
84,26,212602270,26227,Pelonne,26,26,0
84,26,212602288,26228,Pennes-le-Sec,34,34,0
84,26,212602296,26229,La Penne-sur-l'Ouvèze,99,94,5
84,26,212602312,26231,Peyrins,2715,2644,71
84,26,212602320,26232,Peyrus,588,580,8
84,26,212602338,26233,Piégon,250,241,9
84,26,212602346,26234,Piégros-la-Clastre,903,887,16
84,26,212602353,26235,Pierrelatte,13979,13708,271
84,26,212602361,26236,Pierrelongue,222,220,2
84,26,212602387,26238,Les Pilles,242,240,2
84,26,212602395,26239,Plaisians,213,208,5
84,26,212602403,26240,Plan-de-Baix,156,154,2
84,26,212602411,26241,Le Poët-Célard,139,137,2
84,26,212602429,26242,Le Poët-en-Percip,16,16,0
84,26,212602437,26243,Le Poët-Laval,1005,966,39
84,26,212602445,26244,Le Poët-Sigillat,133,128,5
84,26,212602452,26245,Pommerol,5,5,0
84,26,212602460,26246,Ponet-et-Saint-Auban,135,132,3
84,26,212602478,26247,Ponsas,536,530,6
84,26,212602486,26248,Pontaix,183,178,5
84,26,212602494,26249,Pont-de-Barret,685,668,17
84,26,212602502,26250,Pont-de-l'Isère,3661,3608,53
84,26,212602510,26251,Portes-en-Valdaine,434,427,7
84,26,212602528,26252,Portes-lès-Valence,10685,10526,159
84,26,212602536,26253,Poyols,73,72,1
84,26,212602544,26254,Pradelle,21,21,0
84,26,212602551,26255,Les Prés,22,22,0
84,26,212602569,26256,Propiac,143,138,5
84,26,212602577,26257,Puygiron,479,459,20
84,26,212602585,26258,Puy-Saint-Martin,888,869,19
84,26,212602593,26259,Ratières,273,269,4
84,26,212602619,26261,Réauville,406,396,10
84,26,212602627,26262,Recoubeau-Jansac,290,288,2
84,26,212602635,26263,Reilhanette,148,146,2
84,26,212602643,26264,Rémuzat,332,325,7
84,26,212602668,26266,Rimon-et-Savel,23,23,0
84,26,212602676,26267,Rioms,25,24,1
84,26,212602684,26268,Rochebaudin,125,125,0
84,26,212602692,26269,Rochebrune,54,54,0
84,26,212602700,26270,Rochechinard,131,129,2
84,26,212602718,26271,La Roche-de-Glun,3521,3456,65
84,26,212602726,26272,Rochefort-en-Valdaine,379,370,9
84,26,212602734,26273,Rochefort-Samson,1041,1022,19
84,26,212602742,26274,Rochefourchat,1,1,0
84,26,212602759,26275,Rochegude,1719,1671,48
84,26,212602767,26276,Roche-Saint-Secret-Béconne,483,469,14
84,26,212602775,26277,La Roche-sur-Grane,177,173,4
84,26,212602783,26278,La Roche-sur-le-Buis,294,285,9
84,26,212602791,26279,La Rochette-du-Buis,58,57,1
84,26,212602817,26281,Romans-sur-Isère,33486,32818,668
84,26,212602825,26282,Romeyer,206,202,4
84,26,212602833,26283,Rottier,24,24,0
84,26,212602841,26284,Roussas,391,383,8
84,26,212602858,26285,Rousset-les-Vignes,288,279,9
84,26,212602866,26286,Roussieux,25,24,1
84,26,212602874,26287,Roynac,498,483,15
84,26,212602882,26288,Sahune,312,306,6
84,26,212602890,26289,Saillans,1409,1388,21
84,26,212602908,26290,Saint-Agnan-en-Vercors,363,354,9
84,26,212602916,26291,Saint-Andéol,87,85,2
84,26,212602924,26292,Saint-Auban-sur-l'Ouvèze,216,212,4
84,26,212602932,26293,Saint-Avit,335,326,9
84,26,212602940,26294,Saint-Bardoux,612,594,18
84,26,212602957,26295,Saint-Barthélemy-de-Vals,1890,1859,31
84,26,212602965,26296,Saint-Benoit-en-Diois,33,32,1
84,26,212602981,26298,Saint-Christophe-et-le-Laris,426,421,5
84,26,212602999,26299,Sainte-Croix,108,105,3
84,26,212603005,26300,Saint-Dizier-en-Diois,50,49,1
84,26,212603013,26301,Saint-Donat-sur-l'Herbasse,4388,4294,94
84,26,212603021,26302,Sainte-Eulalie-en-Royans,559,549,10
84,26,212603039,26303,Sainte-Euphémie-sur-Ouvèze,78,74,4
84,26,212603047,26304,Saint-Ferréol-Trente-Pas,265,257,8
84,26,212603054,26305,Saint-Gervais-sur-Roubion,1106,1083,23
84,26,212603062,26306,Sainte-Jalle,323,318,5
84,26,212603070,26307,Saint-Jean-en-Royans,2862,2796,66
84,26,212603088,26308,Saint-Julien-en-Quint,148,148,0
84,26,212603096,26309,Saint-Julien-en-Vercors,233,228,5
84,26,212603104,26310,Saint-Laurent-d'Onay,162,158,4
84,26,212603112,26311,Saint-Laurent-en-Royans,1460,1409,51
84,26,212603120,26312,Saint-Marcel-lès-Sauzet,1298,1269,29
84,26,212603138,26313,Saint-Marcel-lès-Valence,6444,6320,124
84,26,212603146,26314,Saint-Martin-d'Août,406,390,16
84,26,212603153,26315,Saint-Martin-en-Vercors,389,382,7
84,26,212603161,26316,Saint-Martin-le-Colonel,217,210,7
84,26,212603179,26317,Saint-Maurice-sur-Eygues,808,796,12
84,26,212603187,26318,Saint-May,34,33,1
84,26,212603195,26319,Saint-Michel-sur-Savasse,570,558,12
84,26,212603203,26320,Saint-Nazaire-en-Royans,821,811,10
84,26,212603211,26321,Saint-Nazaire-le-Désert,209,208,1
84,26,212603229,26322,Saint-Pantaléon-les-Vignes,432,410,22
84,26,212603237,26323,Saint-Paul-lès-Romans,1892,1858,34
84,26,212603245,26324,Saint-Paul-Trois-Châteaux,9162,8731,431
84,26,212603252,26325,Saint-Rambert-d'Albon,6900,6833,67
84,26,212603260,26326,Saint-Restitut,1510,1462,48
84,26,212603278,26327,Saint-Roman,221,218,3
84,26,212603286,26328,Saint-Sauveur-en-Diois,54,53,1
84,26,212603294,26329,Saint-Sauveur-Gouvernet,184,178,6
84,26,212603302,26330,Saint-Sorlin-en-Valloire,2291,2247,44
84,26,212603310,26331,Saint-Thomas-en-Royans,622,608,14
84,26,212603328,26332,Saint-Uze,2106,2083,23
84,26,212603336,26333,Saint-Vallier,4172,4017,155
84,26,212603344,26334,Salettes,143,141,2
84,26,212603351,26335,Salles-sous-Bois,205,202,3
84,26,212603369,26336,Saou,588,565,23
84,26,212603377,26337,Saulce-sur-Rhône,1868,1838,30
84,26,212603385,26338,Sauzet,1888,1830,58
84,26,212603393,26339,Savasse,1579,1536,43
84,26,212603401,26340,Séderon,256,251,5
84,26,212603419,26341,Serves-sur-Rhône,739,726,13
84,26,212603427,26342,Solérieux,322,315,7
84,26,212603435,26343,Souspierre,109,107,2
84,26,212603443,26344,Soyans,402,395,7
84,26,212603450,26345,Suze-la-Rousse,2197,2126,71
84,26,212603468,26346,Suze,244,236,8
84,26,212603476,26347,Tain-l'Hermitage,6269,6025,244
84,26,212603484,26348,Taulignan,1673,1645,28
84,26,212603492,26349,Tersanne,371,363,8
84,26,212603500,26350,Teyssières,69,68,1
84,26,212603518,26351,Les Tonils,34,34,0
84,26,212603526,26352,La Touche,269,261,8
84,26,212603534,26353,Les Tourrettes,1053,1034,19
84,26,212603559,26355,Triors,625,617,8
84,26,212603567,26356,Truinas,133,127,6
84,26,212603575,26357,Tulette,2043,2004,39
84,26,212603583,26358,Upie,1564,1523,41
84,26,212603591,26359,Vachères-en-Quint,36,36,0
84,26,212603609,26360,Valaurie,718,692,26
84,26,212603617,26361,Valdrôme,137,134,3
84,26,212603625,26362,Valence,65709,64431,1278
84,26,212603633,26363,Valouse,40,40,0
84,26,212603641,26364,Vassieux-en-Vercors,341,333,8
84,26,212603658,26365,Vaunaveys-la-Rochette,594,583,11
84,26,212603674,26367,Venterol,683,672,11
84,26,212603682,26368,Vercheny,469,461,8
84,26,212603690,26369,Verclause,61,61,0
84,26,212603708,26370,Vercoiran,142,138,4
84,26,212603716,26371,Véronne,45,44,1
84,26,212603724,26372,Vers-sur-Méouge,40,39,1
84,26,212603732,26373,Vesc,250,242,8
84,26,212603740,26374,Villebois-les-Pins,14,14,0
84,26,212603757,26375,Villefranche-le-Château,18,17,1
84,26,212603765,26376,Villeperdrix,102,101,1
84,26,212603773,26377,Vinsobres,1048,1025,23
84,26,212603781,26378,Volvent,33,33,0
84,26,212603799,26379,Granges-les-Beaumont,902,890,12
84,26,212603807,26380,Gervans,556,546,10
84,26,212603815,26381,Jaillans,922,910,12
84,26,212603823,26382,Saint-Vincent-la-Commanderie,578,571,7
28,27,212700017,27001,Aclou,339,330,9
28,27,212700025,27002,Acon,469,460,9
28,27,212700033,27003,Acquigny,1708,1674,34
28,27,212700041,27004,Aigleville,433,420,13
28,27,212700058,27005,Ailly,1212,1191,21
28,27,212700066,27006,Aizier,157,154,3
28,27,212700082,27008,Alizay,1614,1597,17
28,27,212700090,27009,Ambenay,576,565,11
28,27,212700108,27010,Amécourt,181,174,7
28,27,200056026,27011,Amfreville-Saint-Amand,1210,1197,13
28,27,212700124,27012,Amfreville-les-Champs,459,443,16
28,27,212700132,27013,Amfreville-sous-les-Monts,499,488,11
28,27,212700140,27014,Amfreville-sur-Iton,880,859,21
28,27,212700157,27015,Andé,1336,1304,32
28,27,212700165,27016,Les Andelys,8193,8055,138
28,27,212700173,27017,Angerville-la-Campagne,1388,1350,38
28,27,212700181,27018,Appeville-Annebault,1001,989,12
28,27,212700199,27019,Armentières-sur-Avre,168,161,7
28,27,212700207,27020,Arnières-sur-Iton,1710,1667,43
28,27,212700215,27021,Asnières,347,338,9
28,27,200059657,27022,Le Val d'Hazey,5354,5248,106
28,27,212700231,27023,Aulnay-sur-Iton,725,706,19
28,27,212700256,27025,Autheuil-Authouillet,969,949,20
28,27,212700264,27026,Authevernes,457,448,9
28,27,212700272,27027,Les Authieux,298,291,7
28,27,212700280,27028,Authou,340,336,4
28,27,212700314,27031,Aviron,1139,1102,37
28,27,200056117,27032,Chambois,1429,1398,31
28,27,212700330,27033,Bacquepuis,310,306,4
28,27,212700348,27034,Bacqueville,635,628,7
28,27,212700355,27035,Bailleul-la-Vallée,101,100,1
28,27,212700363,27036,Bâlines,562,541,21
28,27,212700371,27037,Barc,1176,1155,21
28,27,212700389,27038,Les Barils,282,276,6
28,27,212700397,27039,Barneville-sur-Seine,552,517,35
28,27,212700405,27040,Barquet,453,448,5
28,27,212700421,27042,Barville,82,82,0
28,27,212700439,27043,Les Baux-de-Breteuil,698,677,21
28,27,212700447,27044,Les Baux-Sainte-Croix,855,836,19
28,27,212700454,27045,Bazincourt-sur-Epte,795,783,12
28,27,212700462,27046,Bazoques,144,143,1
28,27,212700470,27047,Beaubray,344,336,8
28,27,212700488,27048,Beauficel-en-Lyons,189,186,3
28,27,200058162,27049,Mesnil-en-Ouche,4603,4484,119
28,27,212700504,27050,Beaumontel,653,636,17
28,27,212700512,27051,Beaumont-le-Roger,2831,2791,40
28,27,212700520,27052,Le Bec-Hellouin,405,402,3
28,27,212700538,27053,Le Bec-Thomas,215,213,2
28,27,212700546,27054,Bémécourt,590,582,8
28,27,212700553,27055,Bérengeville-la-Campagne,336,330,6
28,27,212700561,27056,Bernay,9935,9654,281
28,27,212700579,27057,Bernienville,294,288,6
28,27,212700595,27059,Bernouville,317,313,4
28,27,212700611,27061,Berthouville,332,327,5
28,27,200063931,27062,Les Monts du Roumois,1616,1571,45
28,27,212700637,27063,Berville-la-Campagne,259,258,1
28,27,212700645,27064,Berville-sur-Mer,689,680,9
28,27,212700652,27065,Beuzeville,4735,4682,53
28,27,212700660,27066,Bézu-la-Forêt,318,315,3
28,27,212700678,27067,Bézu-Saint-Éloi,1600,1572,28
28,27,212700686,27068,Bois-Anzeray,173,171,2
28,27,212700694,27069,Bois-Arnault,704,689,15
28,27,200085462,27070,Frenelles-en-Vexin,1741,1714,27
28,27,212700710,27071,Le Bois-Hellain,215,213,2
28,27,212700728,27072,Bois-Jérôme-Saint-Ouen,771,748,23
28,27,212700736,27073,Bois-le-Roi,1257,1238,19
28,27,212700744,27074,Boisney,284,276,8
28,27,212700751,27075,Bois-Normand-près-Lyre,356,350,6
28,27,212700769,27076,Boisset-les-Prévanches,506,498,8
28,27,212700777,27077,Boissey-le-Châtel,864,854,10
28,27,212700785,27078,La Boissière,273,262,11
28,27,212700793,27079,Boissy-Lamberville,372,367,5
28,27,212700819,27081,Boncourt,188,181,7
28,27,212700827,27082,La Bonneville-sur-Iton,2094,2047,47
28,27,212700835,27083,Bonneville-Aptot,268,264,4
28,27,200054633,27085,Flancourt-Crescy-en-Roumois,1576,1554,22
28,27,200076479,27089,Thénouville,1025,1008,17
28,27,200063873,27090,Bosroumois,3786,3718,68
28,27,212700918,27091,Bosgouet,759,755,4
28,27,212700942,27094,Bosquentin,126,125,1
28,27,212700959,27095,Bosrobert,679,668,11
28,27,212700967,27096,Les Bottereaux,355,344,11
28,27,212700975,27097,Bouafles,675,663,12
28,27,212700983,27098,Bouchevilliers,84,79,5
28,27,212700991,27099,Le Boulay-Morin,820,810,10
28,27,212701007,27100,Boulleville,1228,1204,24
28,27,212701015,27101,Bouquelon,536,526,10
28,27,212701023,27102,Bouquetot,1057,1035,22
28,27,212701031,27103,Bourg-Achard,4012,3939,73
28,27,212701049,27104,Bourg-Beaudouin,717,707,10
28,27,200058147,27105,Grand Bourgtheroulde,4117,4038,79
28,27,212701064,27106,Bournainville-Faverolles,487,482,5
28,27,200056059,27107,Bourneville-Sainte-Croix,1360,1336,24
28,27,212701080,27108,Bourth,1219,1188,31
28,27,212701098,27109,Bray,406,398,8
28,27,212701106,27110,Brestot,660,652,8
28,27,212701114,27111,Bretagnolles,208,203,5
28,27,200058246,27112,Breteuil,4445,4321,124
28,27,212701130,27113,Brétigny,143,141,2
28,27,212701148,27114,Breuilpont,1233,1210,23
28,27,212701155,27115,Breux-sur-Avre,346,339,7
28,27,212701163,27116,Brionne,4336,4184,152
28,27,212701171,27117,Broglie,1033,1013,20
28,27,212701189,27118,Brosville,654,644,10
28,27,212701197,27119,Bueil,1653,1625,28
28,27,212701205,27120,Burey,410,405,5
28,27,212701239,27123,Caillouet-Orgeville,499,487,12
28,27,212701247,27124,Cailly-sur-Eure,215,213,2
28,27,212701254,27125,Calleville,664,654,10
28,27,212701262,27126,Campigny,1122,1101,21
28,27,212701270,27127,Canappeville,721,699,22
28,27,212701296,27129,Caorches-Saint-Nicolas,616,597,19
28,27,212701304,27130,Capelle-les-Grands,428,417,11
28,27,212701320,27132,Caugé,867,846,21
28,27,212701338,27133,Caumont,1098,1086,12
28,27,212701346,27134,Cauverville-en-Roumois,213,213,0
28,27,212701353,27135,Cesseville,455,444,11
28,27,212701361,27136,Chaignes,280,276,4
28,27,212701379,27137,Chaise-Dieu-du-Theil,204,199,5
28,27,212701387,27138,Chamblac,396,385,11
28,27,212701395,27139,Chambord,181,175,6
28,27,212701403,27140,Chambray,416,407,9
28,27,212701411,27141,Champ-Dolent,63,63,0
28,27,212701429,27142,Champenard,295,288,7
28,27,212701445,27144,Champigny-la-Futelaye,278,273,5
28,27,212701460,27146,La Chapelle-Bayvel,387,382,5
28,27,212701478,27147,La Chapelle-du-Bois-des-Faulx,704,693,11
28,27,212701486,27148,La Chapelle-Gauthier,419,410,9
28,27,212701494,27149,La Chapelle-Hareng,120,117,3
28,27,212701510,27151,Charleval,1728,1706,22
28,27,212701528,27152,Château-sur-Epte,568,559,9
28,27,212701536,27153,Chauvincourt-Provemont,384,377,7
28,27,212701544,27154,Chavigny-Bailleul,613,597,16
28,27,212701551,27155,Chennebrun,107,105,2
28,27,212701569,27156,Chéronvilliers,484,467,17
28,27,200056075,27157,Marbois,1341,1321,20
28,27,212701585,27158,Cierrey,801,774,27
28,27,212701619,27161,Claville,1101,1080,21
28,27,212701627,27162,Collandres-Quincarnon,246,242,4
28,27,212701635,27163,Colletot,201,198,3
28,27,212701643,27164,Combon,826,819,7
28,27,212701650,27165,Conches-en-Ouche,5022,4950,72
28,27,212701676,27167,Condé-sur-Risle,667,661,6
28,27,212701684,27168,Connelles,184,177,7
28,27,212701692,27169,Conteville,1027,1015,12
28,27,212701700,27170,Cormeilles,1215,1195,20
28,27,212701718,27171,Le Cormier,383,373,10
28,27,212701734,27173,Corneville-la-Fouquetière,126,123,3
28,27,212701742,27174,Corneville-sur-Risle,1397,1371,26
28,27,212701767,27176,Coudray,222,217,5
28,27,212701775,27177,Coudres,564,551,13
28,27,212701791,27179,Courbépine,733,717,16
28,27,212701809,27180,Courcelles-sur-Seine,2167,2129,38
28,27,212701817,27181,Courdemanche,611,600,11
28,27,212701825,27182,Courteilles,164,162,2
28,27,212701833,27183,La Couture-Boussey,2356,2315,41
28,27,212701841,27184,Crasville,126,123,3
28,27,212701858,27185,Crestot,583,575,8
28,27,212701874,27187,Criquebeuf-la-Campagne,344,338,6
28,27,212701882,27188,Criquebeuf-sur-Seine,1528,1512,16
28,27,212701890,27189,La Croisille,432,425,7
28,27,212701908,27190,Croisy-sur-Eure,220,216,4
28,27,200057610,27191,Clef Vallée d'Eure,2547,2482,65
28,27,212701924,27192,Crosville-la-Vieille,615,604,11
28,27,212701932,27193,Croth,1390,1374,16
28,27,212701940,27194,Cuverville,252,250,2
28,27,212701965,27196,Les Damps,1370,1360,10
28,27,200084812,27198,Mesnils-sur-Iton,6365,6149,216
28,27,212701999,27199,Dangu,582,570,12
28,27,212702005,27200,Dardez,150,143,7
28,27,212702013,27201,Daubeuf-la-Campagne,241,238,3
28,27,212702021,27202,Daubeuf-près-Vatteville,469,461,8
28,27,212702039,27203,Douains,478,461,17
28,27,212702047,27204,Doudeauville-en-Vexin,282,275,7
28,27,212702054,27205,Douville-sur-Andelle,447,439,8
28,27,212702062,27206,Droisy,461,458,3
28,27,212702070,27207,Drucourt,591,584,7
28,27,212702088,27208,Duranville,152,150,2
28,27,212702096,27209,Écaquelon,612,601,11
28,27,212702104,27210,Écardenville-la-Campagne,477,465,12
28,27,212702120,27212,Écauville,112,110,2
28,27,200057685,27213,Vexin-sur-Epte,6099,5964,135
28,27,212702146,27214,Écouis,832,818,14
28,27,212702153,27215,Ecquetot,399,389,10
28,27,212702161,27216,Émalleville,508,483,25
28,27,212702179,27217,Émanville,563,554,9
28,27,212702187,27218,Épaignes,1586,1561,25
28,27,212702195,27219,Épégard,543,536,7
28,27,212702203,27220,Épieds,355,347,8
28,27,212702229,27222,Épreville-en-Lieuvin,204,200,4
28,27,212702245,27224,Épreville-près-le-Neubourg,463,454,9
28,27,212702260,27226,Étrépagny,3784,3703,81
28,27,212702278,27227,Étréville,678,667,11
28,27,212702286,27228,Éturqueraye,307,304,3
28,27,212702294,27229,Évreux,48096,46869,1227
28,27,212702302,27230,Ézy-sur-Eure,3735,3686,49
28,27,212702310,27231,Fains,458,451,7
28,27,212702328,27232,Farceaux,352,345,7
28,27,212702336,27233,Fatouville-Grestain,736,725,11
28,27,212702344,27234,Fauville,357,351,6
28,27,212702351,27235,Faverolles-la-Campagne,168,166,2
28,27,212702377,27237,Le Favril,175,171,4
28,27,212702385,27238,Ferrières-Haut-Clocher,1192,1162,30
28,27,212702393,27239,Ferrières-Saint-Hilaire,423,416,7
28,27,212702401,27240,La Ferrière-sur-Risle,226,222,4
28,27,212702419,27241,Feuguerolles,178,173,5
28,27,212702427,27242,Le Fidelaire,1023,1013,10
28,27,212702435,27243,Fiquefleur-Équainville,758,748,10
28,27,212702450,27245,Fleury-la-Forêt,274,269,5
28,27,212702468,27246,Fleury-sur-Andelle,1846,1826,20
28,27,212702476,27247,Flipou,326,323,3
28,27,212702484,27248,Folleville,198,195,3
28,27,212702492,27249,Fontaine-Bellenger,1182,1161,21
28,27,212702518,27251,Fontaine-l'Abbé,559,553,6
28,27,212702526,27252,Fontaine-la-Louvet,335,328,7
28,27,212702542,27254,Fontaine-sous-Jouy,870,847,23
28,27,212702567,27256,La Forêt-du-Parc,637,628,9
28,27,212702583,27258,Fort-Moville,532,526,6
28,27,212702591,27259,Foucrainville,95,91,4
28,27,212702609,27260,Foulbec,672,664,8
28,27,212702617,27261,Fouqueville,453,442,11
28,27,200087534,27263,Le Perrey,1256,1236,20
28,27,212702666,27266,Franqueville,312,310,2
28,27,212702674,27267,Freneuse-sur-Risle,349,345,4
28,27,212702690,27269,Fresne-Cauverville,196,193,3
28,27,212702716,27271,Fresney,333,320,13
28,27,212702732,27273,Gadencourt,386,375,11
28,27,212702757,27275,Gaillon,6935,6833,102
28,27,212702765,27276,Gamaches-en-Vexin,289,281,8
28,27,200059566,27277,La Baronnie,763,748,15
28,27,212702781,27278,Garennes-sur-Eure,2005,1967,38
28,27,212702799,27279,Gasny,3129,3065,64
28,27,212702807,27280,Gauciel,842,835,7
28,27,212702815,27281,Gaudreville-la-Rivière,230,222,8
28,27,212702823,27282,Gauville-la-Campagne,636,620,16
28,27,212702849,27284,Gisors,12046,11863,183
28,27,212702856,27285,Giverny,499,486,13
28,27,212702864,27286,Giverville,410,400,10
28,27,212702872,27287,Glisolles,880,864,16
28,27,212702880,27288,Glos-sur-Risle,618,604,14
28,27,212702898,27289,La Goulafrière,172,170,2
28,27,200076461,27290,Goupil-Othon,1273,1256,17
28,27,212702914,27291,Gournay-le-Guérin,129,124,5
28,27,200063865,27294,Val d'Orger,1008,993,15
28,27,212702955,27295,Grand-Camp,485,470,15
28,27,212702989,27298,Graveron-Sémerville,325,319,6
28,27,212702997,27299,Gravigny,4097,4016,81
28,27,212703003,27300,Grosley-sur-Risle,536,530,6
28,27,212703011,27301,Grossoeuvre,1401,1366,35
28,27,200059509,27302,Le Bosc du Theil,1313,1300,13
28,27,212703045,27304,Guerny,167,163,4
28,27,212703060,27306,Guichainville,3078,3017,61
28,27,212703078,27307,Guiseniers,484,473,11
28,27,212703094,27309,L'Habit,509,502,7
28,27,212703102,27310,Hacqueville,428,420,8
28,27,212703110,27311,Harcourt,1100,1096,4
28,27,212703128,27312,Hardencourt-Cocherel,287,275,12
28,27,212703136,27313,La Harengère,623,618,5
28,27,212703151,27315,Harquency,280,272,8
28,27,212703169,27316,Hauville,1322,1294,28
28,27,212703177,27317,La Haye-Aubrée,462,453,9
28,27,212703185,27318,La Haye-de-Calleville,259,256,3
28,27,212703193,27319,La Haye-de-Routot,302,300,2
28,27,212703201,27320,La Haye-du-Theil,309,309,0
28,27,212703219,27321,La Haye-le-Comte,141,136,5
28,27,212703227,27322,La Haye-Malherbe,1406,1388,18
28,27,212703235,27323,La Haye-Saint-Sylvestre,289,286,3
28,27,212703243,27324,Hébécourt,636,623,13
28,27,212703250,27325,Hecmanville,197,194,3
28,27,212703268,27326,Hécourt,327,314,13
28,27,212703276,27327,Hectomare,219,211,8
28,27,212703292,27329,Hennezis,784,762,22
28,27,212703300,27330,Herqueville,136,132,4
28,27,212703318,27331,Heubécourt-Haricourt,466,456,10
28,27,212703326,27332,Heudebouville,800,787,13
28,27,212703334,27333,Heudicourt,743,736,7
28,27,212703342,27334,Heudreville-en-Lieuvin,111,110,1
28,27,212703359,27335,Heudreville-sur-Eure,1099,1073,26
28,27,212703367,27336,La Heunière,454,450,4
28,27,212703375,27337,Heuqueville,358,352,6
28,27,212703383,27338,Les Hogues,688,679,9
28,27,212703391,27339,Hondouville,801,785,16
28,27,212703409,27340,Honguemare-Guenouville,718,707,11
28,27,212703417,27341,L'Hosmes,68,67,1
28,27,212703425,27342,Houetteville,204,198,6
28,27,212703433,27343,Houlbec-Cocherel,1326,1271,55
28,27,212703458,27345,La Houssaye,209,207,2
28,27,212703466,27346,Houville-en-Vexin,239,235,4
28,27,212703474,27347,Huest,804,778,26
28,27,212703482,27348,Igoville,1773,1747,26
28,27,212703490,27349,Illeville-sur-Montfort,874,861,13
28,27,212703508,27350,Illiers-l'Évêque,1043,1026,17
28,27,212703516,27351,Incarville,1418,1397,21
28,27,212703532,27353,Irreville,475,467,8
28,27,212703540,27354,Iville,421,417,4
28,27,212703557,27355,Ivry-la-Bataille,2688,2658,30
28,27,212703581,27358,Jouy-sur-Eure,605,592,13
28,27,212703599,27359,Juignettes,225,224,1
28,27,212703607,27360,Jumelles,335,328,7
28,27,212703615,27361,La Lande-Saint-Léger,399,395,4
28,27,212703631,27363,Le Landin,230,223,7
28,27,212703649,27364,Launay,198,193,5
28,27,212703656,27365,Léry,2039,2013,26
28,27,212703664,27366,Letteguives,210,207,3
28,27,212703672,27367,Lieurey,1517,1502,15
28,27,212703680,27368,Lignerolles,351,342,9
28,27,212703698,27369,Lilly,79,77,2
28,27,212703706,27370,Lisors,328,319,9
28,27,212703714,27371,Livet-sur-Authou,162,161,1
28,27,212703722,27372,Longchamps,689,684,5
28,27,212703730,27373,Lorleau,106,105,1
28,27,212703748,27374,Louversey,537,522,15
28,27,212703755,27375,Louviers,19022,18636,386
28,27,212703763,27376,Louye,229,224,5
28,27,212703771,27377,Lyons-la-Forêt,715,709,6
28,27,212703789,27378,La Madeleine-de-Nonancourt,1163,1139,24
28,27,212703797,27379,Mainneville,453,445,8
28,27,212703805,27380,Malleville-sur-le-Bec,271,266,5
28,27,212703813,27381,Malouy,164,164,0
28,27,212703821,27382,Mandeville,326,317,9
28,27,212703839,27383,Mandres,379,367,12
28,27,212703847,27384,Manneville-la-Raoult,507,497,10
28,27,212703854,27385,Manneville-sur-Risle,1522,1479,43
28,27,212703862,27386,Le Manoir,1324,1311,13
28,27,212703888,27388,Marais-Vernier,485,475,10
28,27,212703896,27389,Marbeuf,477,471,6
28,27,212703904,27390,Marcilly-la-Campagne,1135,1119,16
28,27,212703912,27391,Marcilly-sur-Eure,1614,1594,20
28,27,212703920,27392,Martagny,149,146,3
28,27,212703938,27393,Martainville,507,501,6
28,27,212703946,27394,Martot,465,454,11
28,27,212703953,27395,Mélicourt,90,89,1
28,27,212703961,27396,Ménesqueville,474,465,9
28,27,212703979,27397,Ménilles,1779,1738,41
28,27,212703987,27398,Menneval,1631,1525,106
28,27,212703995,27399,Mercey,54,53,1
28,27,212704001,27400,Merey,344,339,5
28,27,212704019,27401,Le Mesnil-Fuguet,183,180,3
28,27,212704035,27403,Le Mesnil-Jourdain,248,236,12
28,27,212704043,27404,Mesnil-Rousset,92,88,4
28,27,212704050,27405,Mesnil-sous-Vienne,103,99,4
28,27,212704068,27406,Mesnil-sur-l'Estrée,935,912,23
28,27,212704076,27407,Mesnil-Verclives,341,332,9
28,27,212704084,27408,Mézières-en-Vexin,614,595,19
28,27,212704100,27410,Miserey,646,634,12
28,27,212704118,27411,Moisville,231,229,2
28,27,200071736,27412,Terres de Bord,1552,1520,32
28,27,212704134,27413,Montfort-sur-Risle,795,783,12
28,27,212704142,27414,Montreuil-l'Argillé,836,829,7
28,27,212704159,27415,Morainville-Jouveaux,375,368,7
28,27,212704175,27417,Morgny,685,673,12
28,27,212704183,27418,Morsan,114,111,3
28,27,212704191,27419,Mouettes,764,747,17
28,27,212704209,27420,Mouflaines,170,164,6
28,27,212704217,27421,Mousseaux-Neuville,647,634,13
28,27,212704225,27422,Muids,897,876,21
28,27,212704233,27423,Muzy,783,766,17
28,27,212704241,27424,Nagel-Séez-Mesnil,333,329,4
28,27,200063907,27425,Nassandres sur Risle,2406,2366,40
28,27,212704266,27426,Neaufles-Saint-Martin,1347,1341,6
28,27,212704274,27427,Neaufles-Auvergny,428,419,9
28,27,212704282,27428,Le Neubourg,4478,4254,224
28,27,212704290,27429,Neuilly,186,186,0
28,27,212704308,27430,La Neuve-Grange,362,358,4
28,27,212704316,27431,La Neuve-Lyre,585,580,5
28,27,212704324,27432,La Neuville-du-Bosc,726,719,7
28,27,212704332,27433,Neuville-sur-Authou,196,194,2
28,27,212704340,27434,Noards,54,54,0
28,27,212704357,27435,La Noë-Poulain,279,274,5
28,27,212704365,27436,Nogent-le-Sec,447,441,6
28,27,212704373,27437,Nojeon-en-Vexin,347,341,6
28,27,212704381,27438,Nonancourt,2301,2260,41
28,27,212704399,27439,Normanville,1130,1105,25
28,27,212704407,27440,Notre-Dame-de-l'Isle,675,653,22
28,27,212704415,27441,Notre-Dame-d'Épine,72,71,1
28,27,212704423,27442,Notre-Dame-du-Hamel,201,194,7
28,27,212704449,27444,Le Noyer-en-Ouche,232,231,1
28,27,212704456,27445,Noyers,252,248,4
28,27,212704464,27446,Ormes,482,479,3
28,27,200076487,27447,Le Val-Doré,943,888,55
28,27,200063774,27448,Pacy-sur-Eure,5168,5042,126
28,27,212704514,27451,Parville,297,291,6
28,27,212704530,27453,Perriers-sur-Andelle,1822,1801,21
28,27,212704548,27454,Perruel,470,463,7
28,27,212704555,27455,Piencourt,169,166,3
28,27,212704563,27456,Pinterville,785,767,18
28,27,212704571,27457,Piseux,706,694,12
28,27,212704589,27458,Pîtres,2645,2620,25
28,27,212704597,27459,Les Places,73,71,2
28,27,212704605,27460,Plainville,210,205,5
28,27,212704621,27462,Le Planquay,167,166,1
28,27,212704639,27463,Plasnes,742,724,18
28,27,212704647,27464,Le Plessis-Grohan,938,919,19
28,27,212704654,27465,Le Plessis-Hébert,412,399,13
28,27,212704662,27466,Le Plessis-Sainte-Opportune,346,341,5
28,27,200077329,27467,Pont-Audemer,10152,9891,261
28,27,212704688,27468,Pont-Authou,598,589,9
28,27,212704696,27469,Pont-de-l'Arche,4190,4139,51
28,27,212704704,27470,Pont-Saint-Pierre,1159,1137,22
28,27,200077311,27471,Porte-de-Seine,212,207,5
28,27,212704720,27472,Portes,277,271,6
28,27,212704738,27473,Port-Mort,924,903,21
28,27,212704746,27474,Poses,1162,1143,19
28,27,212704753,27475,La Poterie-Mathieu,165,164,1
28,27,212704761,27476,Les Préaux,401,393,8
28,27,212704779,27477,Pressagny-l'Orgueilleux,712,696,16
28,27,212704787,27478,Prey,993,968,25
28,27,212704803,27480,Puchay,659,640,19
28,27,212704811,27481,Pullay,455,401,54
28,27,212704829,27482,La Pyle,172,168,4
28,27,212704837,27483,Quatremare,440,437,3
28,27,212704852,27485,Quillebeuf-sur-Seine,835,826,9
28,27,212704860,27486,Quittebeuf,669,650,19
28,27,212704878,27487,Radepont,658,655,3
28,27,212704886,27488,Renneville,197,191,6
28,27,212704894,27489,Reuilly,532,519,13
28,27,212704902,27490,Richeville,271,267,4
28,27,212704928,27492,Romilly-la-Puthenaye,332,321,11
28,27,212704936,27493,Romilly-sur-Andelle,3311,3268,43
28,27,212704951,27495,La Roquette,241,239,2
28,27,212704969,27496,Rosay-sur-Lieure,516,510,6
28,27,212704977,27497,Rougemontiers,1055,1038,17
28,27,212704985,27498,Rouge-Perriers,369,365,4
28,27,212705008,27500,Routot,1755,1699,56
28,27,212705016,27501,Rouvray,266,260,6
28,27,212705024,27502,Rugles,2231,2204,27
28,27,212705040,27504,Sacquenville,1298,1261,37
28,27,212705057,27505,Saint-Agnan-de-Cernières,167,166,1
28,27,212705073,27507,Saint-André-de-l'Eure,4121,4055,66
28,27,212705081,27508,Saint-Antonin-de-Sommaire,208,206,2
28,27,212705115,27511,Saint-Aubin-d'Écrosville,746,735,11
28,27,212705123,27512,Saint-Aubin-de-Scellon,342,335,7
28,27,212705149,27514,Saint-Aubin-du-Thenney,376,370,6
28,27,200082808,27516,Treis-Sants-en-Ouche,1420,1386,34
28,27,212705172,27517,Saint-Aubin-sur-Gaillon,2220,2171,49
28,27,212705180,27518,Saint-Aubin-sur-Quillebeuf,772,758,14
28,27,212705206,27520,Saint-Benoît-des-Ombres,142,141,1
28,27,212705214,27521,Saint-Christophe-sur-Avre,142,136,6
28,27,212705222,27522,Saint-Christophe-sur-Condé,443,439,4
28,27,212705248,27524,Sainte-Colombe-la-Commanderie,886,879,7
28,27,212705255,27525,Sainte-Colombe-près-Vernon,317,299,18
28,27,212705271,27527,Saint-Cyr-de-Salerne,206,205,1
28,27,212705289,27528,Le Vaudreuil,3748,3660,88
28,27,212705297,27529,Saint-Cyr-la-Campagne,439,433,6
28,27,212705305,27530,Saint-Denis-d'Augerons,83,80,3
28,27,212705313,27531,Saint-Denis-des-Monts,208,204,4
28,27,212705339,27533,Saint-Denis-le-Ferment,510,491,19
28,27,212705347,27534,Saint-Didier-des-Bois,900,890,10
28,27,212705354,27535,Saint-Élier,438,427,11
28,27,212705362,27536,Saint-Éloi-de-Fourques,558,543,15
28,27,212705370,27537,Saint-Étienne-du-Vauvray,887,872,15
28,27,212705388,27538,Saint-Étienne-l'Allier,550,541,9
28,27,212705396,27539,Saint-Étienne-sous-Bailleul,392,386,6
28,27,212705404,27540,Sainte-Geneviève-lès-Gasny,672,660,12
28,27,200082816,27541,Le Mesnil-Saint-Jean,207,202,5
28,27,212705420,27542,Saint-Georges-du-Vièvre,901,889,12
28,27,212705438,27543,Saint-Georges-Motel,890,879,11
28,27,212705446,27544,Saint-Germain-de-Fresney,207,202,5
28,27,212705453,27545,Saint-Germain-de-Pasquier,122,122,0
28,27,212705461,27546,Saint-Germain-des-Angles,170,168,2
28,27,212705479,27547,Saint-Germain-la-Campagne,885,864,21
28,27,212705487,27548,Saint-Germain-sur-Avre,1204,1179,25
28,27,212705503,27550,Saint-Grégoire-du-Vièvre,314,307,7
28,27,212705529,27552,Saint-Jean-du-Thenney,243,237,6
28,27,212705537,27553,Saint-Julien-de-la-Liègue,420,418,2
28,27,200063824,27554,La Chapelle-Longueville,3424,3319,105
28,27,212705552,27555,Saint-Laurent-des-Bois,251,246,5
28,27,212705560,27556,Saint-Laurent-du-Tencement,65,65,0
28,27,212705578,27557,Saint-Léger-de-Rôtes,472,466,6
28,27,212705586,27558,Saint-Léger-du-Gennetey,183,177,6
28,27,212705602,27560,Saint-Luc,261,249,12
28,27,212705610,27561,Saint-Maclou,669,658,11
28,27,212705628,27562,Saint-Marcel,4547,4412,135
28,27,212705636,27563,Saint-Mards-de-Blacarville,854,831,23
28,27,212705644,27564,Saint-Mards-de-Fresne,339,334,5
28,27,200057602,27565,Le Lesme,693,684,9
28,27,212705677,27567,Sainte-Marie-de-Vatimesnil,286,280,6
28,27,212705685,27568,Sainte-Marthe,504,496,8
28,27,212705693,27569,Saint-Martin-du-Tilleul,257,247,10
28,27,212705701,27570,Saint-Martin-la-Campagne,104,102,2
28,27,212705719,27571,Saint-Martin-Saint-Firmin,347,336,11
28,27,212705727,27572,Saint-Meslin-du-Bosc,303,299,4
28,27,212705768,27576,Sainte-Opportune-du-Bosc,662,647,15
28,27,212705776,27577,Sainte-Opportune-la-Mare,446,435,11
28,27,200056257,27578,Sainte-Marie-d'Attez,603,591,12
28,27,212705792,27579,Saint-Ouen-de-Pontcheuil,103,101,2
28,27,212705800,27580,Saint-Ouen-de-Thouberville,2481,2452,29
28,27,212705826,27582,Saint-Ouen-du-Tilleul,1763,1747,16
28,27,212705842,27584,Saint-Paul-de-Fourques,286,277,9
28,27,212705867,27586,Saint-Philbert-sur-Boissey,174,173,1
28,27,212705875,27587,Saint-Philbert-sur-Risle,795,789,6
28,27,212705891,27589,Saint-Pierre-de-Bailleul,1009,977,32
28,27,212705909,27590,Saint-Pierre-de-Cernières,243,239,4
28,27,212705917,27591,Saint-Pierre-de-Cormeilles,600,589,11
28,27,212705925,27592,Saint-Pierre-de-Salerne,247,244,3
28,27,212705933,27593,Saint-Pierre-des-Fleurs,1656,1634,22
28,27,212705941,27594,Saint-Pierre-des-Ifs,275,272,3
28,27,212705958,27595,Saint-Pierre-du-Bosguérard,1014,995,19
28,27,212705974,27597,Saint-Pierre-du-Val,590,589,1
28,27,212705982,27598,Saint-Pierre-du-Vauvray,1262,1240,22
28,27,212705990,27599,Saint-Pierre-la-Garenne,928,918,10
28,27,212706014,27601,Saint-Samson-de-la-Roque,443,431,12
28,27,212706022,27602,Saint-Sébastien-de-Morsent,5728,5561,167
28,27,212706030,27603,Saint-Siméon,316,310,6
28,27,212706048,27604,Saint-Sulpice-de-Grimbouville,156,154,2
28,27,212706055,27605,Saint-Sylvestre-de-Cormeilles,233,229,4
28,27,212706063,27606,Saint-Symphorien,486,482,4
28,27,212706089,27608,Saint-Victor-de-Chrétienville,453,444,9
28,27,212706097,27609,Saint-Victor-d'Épine,345,339,6
28,27,212706105,27610,Saint-Victor-sur-Avre,56,55,1
28,27,212706113,27611,Saint-Vigor,326,316,10
28,27,212706121,27612,Saint-Vincent-des-Bois,344,335,9
28,27,212706139,27613,Saint-Vincent-du-Boulay,381,376,5
28,27,212706147,27614,Sancourt,175,173,2
28,27,212706154,27615,Sassey,199,194,5
28,27,212706162,27616,La Saussaye,1942,1889,53
28,27,212706170,27617,Saussay-la-Campagne,539,530,9
28,27,212706188,27618,Sébécourt,476,465,11
28,27,212706204,27620,Selles,470,468,2
28,27,212706212,27621,Serez,177,172,5
28,27,212706220,27622,Serquigny,1838,1793,45
28,27,212706238,27623,Surtauville,505,491,14
28,27,212706246,27624,Surville,900,877,23
28,27,212706253,27625,Suzay,360,354,6
28,27,212706279,27627,Le Theil-Nolent,255,243,12
28,27,212706295,27629,Thiberville,1803,1781,22
28,27,212706303,27630,Thibouville,353,321,32
28,27,212706311,27631,Thierville,375,371,4
28,27,212706329,27632,Le Thil,604,596,8
28,27,212706337,27633,Les Thilliers-en-Vexin,501,497,4
28,27,212706352,27635,Le Thuit,142,141,1
28,27,200054625,27638,Le Thuit de l'Oison,3789,3734,55
28,27,212706402,27640,Tilleul-Dame-Agnès,194,190,4
28,27,212706410,27641,Le Tilleul-Lambert,267,262,5
28,27,212706436,27643,Tillières-sur-Avre,1075,1059,16
28,27,212706444,27644,Tilly,607,566,41
28,27,212706451,27645,Tocqueville,159,155,4
28,27,212706469,27646,Le Torpt,448,443,5
28,27,212706493,27649,Touffreville,360,353,7
28,27,212706501,27650,Tournedos-Bois-Hubert,472,464,8
28,27,212706527,27652,Tourneville,313,305,8
28,27,212706543,27654,Tourville-la-Campagne,1139,1127,12
28,27,212706550,27655,Tourville-sur-Pont-Audemer,891,731,160
28,27,212706568,27656,Toutainville,1326,1294,32
28,27,212706584,27658,Le Tremblay-Omonville,378,369,9
28,27,212706592,27659,La Trinité,133,127,6
28,27,212706600,27660,La Trinité-de-Réville,238,236,2
28,27,212706618,27661,La Trinité-de-Thouberville,433,424,9
28,27,212706626,27662,Triqueville,341,336,5
28,27,212706634,27663,Le Troncq,173,169,4
28,27,212706642,27664,Le Tronquay,524,516,8
28,27,212706659,27665,Trouville-la-Haule,769,756,13
28,27,212706667,27666,La Vacherie,589,570,19
28,27,212706675,27667,Valailles,403,392,11
28,27,212706683,27668,Le Val-David,701,690,11
28,27,212706691,27669,Valletot,439,431,8
28,27,212706709,27670,Vandrimare,984,966,18
28,27,212706717,27671,Vannecrocq,163,163,0
28,27,212706725,27672,Vascoeuil,356,355,1
28,27,212706733,27673,Vatteville,180,176,4
28,27,212706741,27674,Vaux-sur-Eure,278,268,10
28,27,200063782,27676,Les Trois Lacs,1804,1759,45
28,27,212706774,27677,Venon,411,405,6
28,27,212706782,27678,Les Ventes,1066,1043,23
28,27,200063790,27679,Verneuil d'Avre et d'Iton,7717,7374,343
28,27,212706808,27680,Verneusses,195,189,6
28,27,212706816,27681,Vernon,24678,24056,622
28,27,212706824,27682,Vesly,655,639,16
28,27,212706832,27683,Vézillon,234,231,3
28,27,212706840,27684,Le Vieil-Évreux,849,838,11
28,27,200085645,27685,La Vieille-Lyre,682,663,19
28,27,212706865,27686,Vieux-Port,48,48,0
28,27,212706899,27689,Villegats,367,350,17
28,27,212706907,27690,Villers-en-Vexin,319,312,7
28,27,212706915,27691,Villers-sur-le-Roule,884,865,19
28,27,212706923,27692,Villettes,171,164,7
28,27,200054682,27693,Sylvains-Lès-Moulins,1331,1299,32
28,27,212706949,27694,Villez-sous-Bailleul,334,319,15
28,27,212706956,27695,Villez-sur-le-Neubourg,276,265,11
28,27,212706964,27696,Villiers-en-Désoeuvre,930,908,22
28,27,212706972,27697,Vironvay,346,329,17
28,27,212706980,27698,Vitot,577,564,13
28,27,212706998,27699,Voiscreville,121,118,3
28,27,212707004,27700,Vraiville,741,727,14
28,27,212707012,27701,Val-de-Reuil,12988,12702,286
24,28,212800015,28001,Abondant,2455,2409,46
24,28,212800031,28003,Allainville,145,141,4
24,28,212800049,28004,Allonnes,319,316,3
24,28,212800056,28005,Alluyes,838,751,87
24,28,212800064,28006,Amilly,1856,1809,47
24,28,212800072,28007,Anet,2793,2689,104
24,28,212800080,28008,Ardelles,210,208,2
24,28,212800098,28009,Ardelu,72,71,1
24,28,212800106,28010,Argenvilliers,331,323,8
24,28,200064632,28012,Vald'Yerre,3639,3580,59
24,28,212800130,28013,Aunay-sous-Auneau,1589,1565,24
24,28,212800148,28014,Aunay-sous-Crécy,693,686,7
24,28,200056463,28015,Auneau-Bleury-Saint-Symphorien,6324,6230,94
24,28,212800163,28016,Les Autels-Villevillon,124,118,6
24,28,200081610,28018,Authon-du-Perche,1508,1492,16
24,28,212800197,28019,Baigneaux,207,204,3
24,28,212800213,28021,Bailleau-le-Pin,1627,1597,30
24,28,212800221,28022,Bailleau-l'Évêque,1177,1146,31
24,28,212800239,28023,Bailleau-Armenonville,1393,1367,26
24,28,212800247,28024,Barjouville,1841,1780,61
24,28,212800254,28025,Barmainville,102,100,2
24,28,212800262,28026,Baudreville,243,243,0
24,28,212800270,28027,La Bazoche-Gouet,1243,1223,20
24,28,212800288,28028,Bazoches-en-Dunois,264,260,4
24,28,212800296,28029,Bazoches-les-Hautes,328,322,6
24,28,212800304,28030,Beauche,283,278,5
24,28,212800312,28031,Beaumont-les-Autels,497,386,111
24,28,212800320,28032,Beauvilliers,347,343,4
24,28,212800338,28033,Belhomert-Guéhouville,829,797,32
24,28,212803381,28034,Berchères-Saint-Germain,903,890,13
24,28,212800353,28035,Berchères-les-Pierres,992,969,23
24,28,212800361,28036,Berchères-sur-Vesgre,863,842,21
24,28,212800379,28037,Bérou-la-Mulotière,341,337,4
24,28,212800387,28038,Béthonvilliers,122,118,4
24,28,212800395,28039,Béville-le-Comte,1702,1670,32
24,28,212800403,28040,Billancelles,329,320,9
24,28,212800411,28041,Blandainville,282,278,4
24,28,212800452,28045,Boissy-en-Drouais,234,228,6
24,28,212800460,28046,Boissy-lès-Perche,488,480,8
24,28,212800478,28047,Boisville-la-Saint-Père,733,718,15
24,28,212800486,28048,La Bourdinière-Saint-Loup,758,744,14
24,28,212800494,28049,Boncé,249,244,5
24,28,212800502,28050,Boncourt,274,268,6
24,28,212800510,28051,Bonneval,4942,4841,101
24,28,212800528,28052,Bouglainval,761,746,15
24,28,212800536,28053,Le Boullay-les-Deux-Églises,249,246,3
24,28,212800544,28054,Le Boullay-Mivoye,516,506,10
24,28,212800551,28055,Le Boullay-Thierry,572,563,9
24,28,212800569,28056,Boutigny-Prouais,1721,1676,45
24,28,212800577,28057,Bouville,607,598,9
24,28,212800585,28058,Bréchamps,367,363,4
24,28,212800593,28059,Brezolles,1840,1814,26
24,28,212800601,28060,Briconville,268,264,4
24,28,212800619,28061,Brou,3302,3265,37
24,28,212800627,28062,Broué,919,904,15
24,28,212800643,28064,Bû,2077,2026,51
24,28,212800650,28065,Bullainville,112,107,5
24,28,212800676,28067,Cernay,91,89,2
24,28,212800684,28068,Challet,443,431,12
24,28,212800700,28070,Champhol,3848,3737,111
24,28,212800718,28071,Champrond-en-Gâtine,705,702,3
24,28,212800726,28072,Champrond-en-Perchet,417,405,12
24,28,212800734,28073,Champseru,349,344,5
24,28,212800742,28074,La Chapelle-d'Aunainville,251,247,4
24,28,212800759,28075,La Chapelle-du-Noyer,1194,1014,180
24,28,212800767,28076,La Chapelle-Forainvilliers,199,196,3
24,28,212800775,28077,La Chapelle-Fortin,173,169,4
24,28,212800783,28078,Chapelle-Guillaume,188,184,4
24,28,212800791,28079,Chapelle-Royale,300,296,4
24,28,212800809,28080,Charbonnières,258,255,3
24,28,212800817,28081,Charonville,307,302,5
24,28,212800825,28082,Charpont,660,646,14
24,28,212800841,28084,Chartainvilliers,712,690,22
24,28,212800858,28085,Chartres,39511,38443,1068
24,28,212800866,28086,Chassant,328,320,8
24,28,212800874,28087,Châtaincourt,244,240,4
24,28,212800882,28088,Châteaudun,13259,12949,310
24,28,212800890,28089,Châteauneuf-en-Thymerais,2647,2614,33
24,28,212800908,28090,Les Châtelets,110,107,3
24,28,212800916,28091,Les Châtelliers-Notre-Dame,149,146,3
24,28,212800924,28092,Châtenay,236,230,6
24,28,212800940,28094,Chaudon,1689,1662,27
24,28,212800957,28095,Chauffours,287,281,6
24,28,212800965,28096,La Chaussée-d'Ivry,1283,1264,19
24,28,212800981,28098,Cherisy,1877,1829,48
24,28,212800999,28099,Chuisnes,1117,1096,21
24,28,212801005,28100,Cintray,458,452,6
24,28,212801021,28102,Clévilliers,725,716,9
24,28,200064764,28103,Cloyes-les-Trois-Rivières,5724,5618,106
24,28,212801047,28104,Coltainville,939,911,28
24,28,212801054,28105,Combres,558,552,6
24,28,212801062,28106,Conie-Molitard,411,400,11
24,28,212801070,28107,Corancez,365,356,9
24,28,212801088,28108,Cormainville,239,231,8
24,28,212801096,28109,Les Corvées-les-Yys,324,319,5
24,28,212801104,28110,Le Coudray,4160,4042,118
24,28,212801112,28111,Coudray-au-Perche,379,366,13
24,28,212801138,28113,Coulombs,1369,1337,32
24,28,212801146,28114,Courbehaye,135,135,0
24,28,212801161,28116,Courville-sur-Eure,2874,2812,62
24,28,212801179,28117,Crécy-Couvé,275,266,9
24,28,212801187,28118,Croisilles,441,426,15
24,28,212801195,28119,La Croix-du-Perche,150,148,2
24,28,212801203,28120,Crucey-Villages,451,449,2
24,28,212801211,28121,Dambron,110,110,0
24,28,212801229,28122,Dammarie,1522,1499,23
24,28,212801237,28123,Dampierre-sous-Brou,454,449,5
24,28,212801245,28124,Dampierre-sur-Avre,764,746,18
24,28,212801260,28126,Dancy,203,199,4
24,28,200076537,28127,Dangeau,1276,1250,26
24,28,212801286,28128,Dangers,440,434,6
24,28,212801294,28129,Denonville,796,775,21
24,28,212801302,28130,Digny,1009,996,13
24,28,212801328,28132,Donnemain-Saint-Mamès,678,662,16
24,28,212801344,28134,Dreux,31239,30744,495
24,28,212801351,28135,Droue-sur-Drouette,1265,1208,57
24,28,212801369,28136,Écluzelles,165,164,1
24,28,212801377,28137,Écrosnes,846,829,17
24,28,212801393,28139,Épeautrolles,185,184,1
24,28,212801401,28140,Épernon,5669,5601,68
24,28,212801419,28141,Ermenonville-la-Grande,330,319,11
24,28,212801427,28142,Ermenonville-la-Petite,184,182,2
24,28,212801435,28143,Escorpain,248,245,3
24,28,212801443,28144,Les Étilleux,213,206,7
24,28,212801468,28146,Faverolles,861,852,9
24,28,212801476,28147,Favières,619,609,10
24,28,212801484,28148,Le Favril,382,371,11
24,28,212801492,28149,La Ferté-Vidame,597,581,16
24,28,212801518,28151,Fessanvilliers-Mattanvilliers,181,176,5
24,28,212801534,28153,Flacey,213,207,6
24,28,212801542,28154,Fontaine-la-Guyon,1732,1699,33
24,28,212801559,28155,Fontaine-les-Ribouts,204,199,5
24,28,212801567,28156,Fontaine-Simon,910,894,16
24,28,212801575,28157,Fontenay-sur-Conie,133,130,3
24,28,212801583,28158,Fontenay-sur-Eure,1155,1127,28
24,28,212801591,28159,La Framboisière,350,346,4
24,28,212801609,28160,Francourville,872,864,8
24,28,212801617,28161,Frazé,506,499,7
24,28,212801625,28162,Fresnay-le-Comte,299,294,5
24,28,212801633,28163,Fresnay-le-Gilmert,218,215,3
24,28,212801641,28164,Fresnay-l'Évêque,747,737,10
24,28,212801666,28166,Friaize,257,255,2
24,28,212801674,28167,Fruncé,389,382,7
24,28,212801682,28168,Gallardon,3707,3641,66
24,28,212801690,28169,Garancières-en-Beauce,232,225,7
24,28,212801708,28170,Garancières-en-Drouais,289,283,6
24,28,212801716,28171,Garnay,965,943,22
24,28,212801724,28172,Gas,790,774,16
24,28,212801732,28173,Gasville-Oisème,1522,1489,33
24,28,212801757,28175,La Gaudaine,180,177,3
24,28,212801765,28176,Le Gault-Saint-Denis,693,680,13
24,28,212801773,28177,Gellainville,765,751,14
24,28,212801781,28178,Germainville,331,325,6
24,28,212801807,28180,Gilles,504,491,13
24,28,212801823,28182,Gohory,318,316,2
24,28,200056489,28183,Gommerville,695,682,13
24,28,212801849,28184,Gouillons,345,341,4
24,28,200048783,28185,Goussainville,1328,1307,21
24,28,212801872,28187,Guainville,675,661,14
24,28,212801880,28188,Le Gué-de-Longroi,964,948,16
24,28,212801898,28189,Guilleville,182,178,4
24,28,212801906,28190,Guillonville,472,459,13
24,28,212801914,28191,Hanches,2732,2675,57
24,28,212801922,28192,Happonvilliers,322,319,3
24,28,212801930,28193,Havelu,134,131,3
24,28,212801948,28194,Houville-la-Branche,419,403,16
24,28,212801955,28195,Houx,761,749,12
24,28,212801963,28196,Illiers-Combray,3287,3237,50
24,28,212801971,28197,Intréville,140,139,1
24,28,212801989,28198,Jallans,807,796,11
24,28,200086759,28199,Janville-en-Beauce,2585,2541,44
24,28,212802003,28200,Jaudrais,426,421,5
24,28,212802011,28201,Jouy,2014,1970,44
24,28,212802029,28202,Lamblore,331,325,6
24,28,212802037,28203,Landelles,647,641,6
24,28,212802060,28206,Laons,684,671,13
24,28,212802078,28207,Léthuin,236,233,3
24,28,212802086,28208,Levainville,392,378,14
24,28,212802094,28209,Lèves,5788,5629,159
24,28,212802102,28210,Levesville-la-Chenard,226,224,2
24,28,212802110,28211,Logron,584,577,7
24,28,212802128,28212,Loigny-la-Bataille,211,202,9
24,28,212802136,28213,Lormaye,687,676,11
24,28,212802144,28214,La Loupe,3408,3327,81
24,28,212802151,28215,Louville-la-Chenard,258,252,6
24,28,212802169,28216,Louvilliers-en-Drouais,205,204,1
24,28,212802177,28217,Louvilliers-lès-Perche,181,179,2
24,28,212802185,28218,Lucé,15734,15525,209
24,28,212802193,28219,Luigny,423,413,10
24,28,212802201,28220,Luisant,6999,6686,313
24,28,212802219,28221,Lumeau,142,135,7
24,28,212802227,28222,Luplanté,395,385,10
24,28,212802235,28223,Luray,1586,1563,23
24,28,212802250,28225,Magny,656,645,11
24,28,212802268,28226,Maillebois,911,896,15
24,28,212802276,28227,Maintenon,4572,4494,78
24,28,212802292,28229,Mainvilliers,11445,11186,259
24,28,212802300,28230,Maisons,391,384,7
24,28,212802318,28231,La Mancelière,173,169,4
24,28,212802326,28232,Manou,622,592,30
24,28,212802334,28233,Marboué,1182,1156,26
24,28,212802342,28234,Marchéville,484,476,8
24,28,212802359,28235,Marchezais,386,383,3
24,28,200084531,28236,Arcisses,2232,2190,42
24,28,212802375,28237,Marolles-les-Buis,211,207,4
24,28,212802391,28239,Marville-Moutiers-Brûlé,1008,983,25
24,28,212802409,28240,Meaucé,515,507,8
24,28,212802425,28242,Méréglise,102,101,1
24,28,212802433,28243,Mérouville,219,212,7
24,28,212802458,28245,Meslay-le-Grenet,376,367,9
24,28,212802466,28246,Meslay-le-Vidame,542,533,9
24,28,212802474,28247,Le Mesnil-Simon,585,570,15
24,28,212802482,28248,Le Mesnil-Thomas,337,332,5
24,28,212802490,28249,Mévoisins,631,617,14
24,28,212802516,28251,Mézières-en-Drouais,1090,1063,27
24,28,212802524,28252,Miermaigne,189,186,3
24,28,212802532,28253,Mignières,1173,1091,82
24,28,200054542,28254,Mittainvilliers-Vérigny,810,797,13
24,28,212802557,28255,Moinville-la-Jeulin,168,166,2
24,28,212802565,28256,Moléans,458,444,14
24,28,212802573,28257,Mondonville-Saint-Jean,89,87,2
24,28,212802599,28259,Montboissier,337,332,5
24,28,212802607,28260,Montharville,105,100,5
24,28,212802615,28261,Montigny-le-Chartif,609,597,12
24,28,212802631,28263,Montigny-sur-Avre,258,252,6
24,28,212802649,28264,Montireau,141,138,3
24,28,212802656,28265,Montlandon,260,258,2
24,28,212802672,28267,Montreuil,519,514,5
24,28,212802680,28268,Morainville,18,16,2
24,28,212802698,28269,Morancez,1966,1908,58
24,28,212802706,28270,Moriers,226,222,4
24,28,212802714,28271,Morvilliers,140,136,4
24,28,212802722,28272,Mottereau,157,154,3
24,28,212802730,28273,Moulhard,141,139,2
24,28,212802748,28274,Moutiers,244,238,6
24,28,212802755,28275,Néron,682,667,15
24,28,212802763,28276,Neuvy-en-Beauce,214,206,8
24,28,212802771,28277,Neuvy-en-Dunois,317,304,13
24,28,212802789,28278,Nogent-le-Phaye,1518,1484,34
24,28,212802797,28279,Nogent-le-Roi,4057,3990,67
24,28,212802805,28280,Nogent-le-Rotrou,9866,9433,433
24,28,212802813,28281,Nogent-sur-Eure,528,513,15
24,28,212802821,28282,Nonvilliers-Grandhoux,444,434,10
24,28,212802839,28283,Nottonville,288,283,5
24,28,212802847,28284,Oinville-Saint-Liphard,283,277,6
24,28,212802854,28285,Oinville-sous-Auneau,361,352,9
24,28,212802862,28286,Ollé,635,623,12
24,28,212802870,28287,Orgères-en-Beauce,1018,1003,15
24,28,212802896,28289,Ormoy,225,219,6
24,28,212802904,28290,Orrouer,293,284,9
24,28,212802912,28291,Ouarville,535,519,16
24,28,212802920,28292,Ouerre,765,751,14
24,28,212802938,28293,Oulins,1217,1190,27
24,28,212802946,28294,Oysonville,536,523,13
24,28,212802961,28296,Péronville,273,269,4
24,28,212802987,28298,Pierres,2815,2768,47
24,28,212802995,28299,Les Pinthières,172,166,6
24,28,212803001,28300,Poinville,166,160,6
24,28,212803019,28301,Poisvilliers,451,445,6
24,28,212803027,28302,Pontgouin,1414,1095,319
24,28,212803035,28303,Poupry,99,96,3
24,28,212803043,28304,Prasville,445,438,7
24,28,212803050,28305,Pré-Saint-Évroult,302,295,7
24,28,212803068,28306,Pré-Saint-Martin,194,191,3
24,28,212803084,28308,Prudemanche,272,261,11
24,28,212803092,28309,Prunay-le-Gillon,1093,1077,16
24,28,212803100,28310,La Puisaye,263,257,6
24,28,212803126,28312,Puiseux,130,128,2
24,28,212803134,28313,Réclainville,197,196,1
24,28,212803142,28314,Les Ressuintes,132,128,4
24,28,212803159,28315,Revercourt,23,22,1
24,28,212803167,28316,Rohaire,129,126,3
24,28,212803175,28317,Roinville,575,570,5
24,28,212803191,28319,Rouvray-Saint-Denis,354,343,11
24,28,212803217,28321,Rouvres,851,837,14
24,28,212803225,28322,Rueil-la-Gadelière,498,489,9
24,28,212803233,28323,Saint-Ange-et-Torçay,286,285,1
24,28,212803241,28324,Saint-Arnoult-des-Bois,908,886,22
24,28,212803258,28325,Saint-Aubin-des-Bois,1081,1055,26
24,28,212803266,28326,Saint-Avit-les-Guespières,360,358,2
24,28,212803274,28327,Saint-Bomer,193,191,2
24,28,212803290,28329,Saint-Christophe,160,158,2
24,28,200064723,28330,Villemaury,1382,1350,32
24,28,200086684,28331,Saintigny,968,949,19
24,28,212803324,28332,Sainte-Gemme-Moronval,1113,1092,21
24,28,212803332,28333,Saint-Denis-des-Puits,150,143,7
24,28,200081941,28334,Saint-Denis-Lanneray,2217,2164,53
24,28,212803357,28335,Saint-Éliph,867,843,24
24,28,212803365,28336,Saint-Éman,103,103,0
24,28,212803373,28337,Saint-Georges-sur-Eure,2848,2789,59
24,28,212803399,28339,Saint-Germain-le-Gaillard,380,369,11
24,28,212803415,28341,Saint-Jean-de-Rebervilliers,255,250,5
24,28,212803423,28342,Saint-Jean-Pierre-Fixte,270,265,5
24,28,212803431,28343,Saint-Laurent-la-Gâtine,459,448,11
24,28,212803449,28344,Saint-Léger-des-Aubées,277,266,11
24,28,212803464,28346,Saint-Lubin-de-Cravant,59,56,3
24,28,212803472,28347,Saint-Lubin-de-la-Haye,951,922,29
24,28,212803480,28348,Saint-Lubin-des-Joncherets,4110,4041,69
24,28,212803498,28349,Saint-Lucien,267,259,8
24,28,212803506,28350,Saint-Luperce,977,954,23
24,28,212803514,28351,Saint-Maixme-Hauterive,411,403,8
24,28,212803522,28352,Saint-Martin-de-Nigelles,1602,1561,41
24,28,212803530,28353,Saint-Maur-sur-le-Loir,406,401,5
24,28,212803548,28354,Saint-Maurice-Saint-Germain,492,423,69
24,28,212803555,28355,Saint-Ouen-Marchefroy,304,296,8
24,28,212803571,28357,Saint-Piat,1092,1063,29
24,28,212803589,28358,Saint-Prest,2157,2093,64
24,28,212803597,28359,Saint-Rémy-sur-Avre,4097,4048,49
24,28,212803605,28360,Saint-Sauveur-Marville,942,923,19
24,28,212803621,28362,Saint-Victor-de-Buthon,508,505,3
24,28,212803639,28363,Sainville,1034,1021,13
24,28,212803647,28364,Sancheville,769,758,11
24,28,212803654,28365,Sandarville,419,410,9
24,28,212803662,28366,Santeuil,323,320,3
24,28,212803670,28367,Santilly,322,322,0
24,28,212803688,28368,La Saucelle,205,202,3
24,28,212803696,28369,Saulnières,824,814,10
24,28,212803704,28370,Saumeray,506,492,14
24,28,212803712,28371,Saussay,1121,1100,21
24,28,212803720,28372,Senantes,569,558,11
24,28,212803738,28373,Senonches,3049,3005,44
24,28,212803746,28374,Serazereux,545,541,4
24,28,212803753,28375,Serville,375,367,8
24,28,212803779,28377,Sorel-Moussel,1783,1740,43
24,28,212803787,28378,Souancé-au-Perche,529,514,15
24,28,212803795,28379,Soulaires,484,474,10
24,28,212803803,28380,Sours,2128,1973,155
24,28,212803829,28382,Terminiers,894,882,12
24,28,200057743,28383,Theuville,712,706,6
24,28,212803852,28385,Le Thieulin,467,450,17
24,28,212803860,28386,Thimert-Gâtelles,1261,1240,21
24,28,212803878,28387,Thiron-Gardais,994,983,11
24,28,212803886,28388,Thivars,1080,1048,32
24,28,212803894,28389,Thiville,349,341,8
24,28,212803902,28390,Tillay-le-Péneux,313,307,6
24,28,212803910,28391,Toury,2612,2580,32
24,28,212803928,28392,Trancrainville,168,166,2
24,28,212803936,28393,Tremblay-les-Villages,2294,2228,66
24,28,212803944,28394,Tréon,1447,1420,27
24,28,212803951,28395,Trizay-Coutretot-Saint-Serge,446,432,14
24,28,212803969,28396,Trizay-lès-Bonneval,312,308,4
24,28,212803977,28397,Umpeau,422,409,13
24,28,212803985,28398,Unverre,1202,1181,21
24,28,212804009,28400,Varize,202,194,8
24,28,212804017,28401,Vaupillon,461,453,8
24,28,212804033,28403,Ver-lès-Chartres,784,763,21
24,28,212804041,28404,Vernouillet,12583,12411,172
24,28,212804058,28405,Vert-en-Drouais,1120,1097,23
24,28,200084085,28406,Éole-en-Beauce,1263,1244,19
24,28,212804074,28407,Vichères,298,290,8
24,28,212804082,28408,Vierville,119,116,3
24,28,212804090,28409,Vieuvicq,460,444,16
24,28,212804108,28410,Villampuy,306,302,4
24,28,212804116,28411,Villars,173,171,2
24,28,212804140,28414,Villebon,64,59,5
24,28,212804157,28415,Villemeux-sur-Eure,1724,1692,32
24,28,212804173,28417,Villiers-le-Morhier,1400,1366,34
24,28,212804181,28418,Villiers-Saint-Orien,168,163,5
24,28,212804199,28419,Vitray-en-Beauce,345,337,8
24,28,212804215,28421,Voise,270,267,3
24,28,200054179,28422,Les Villages Vovéens,3993,3932,61
24,28,212804231,28423,Yermenonville,614,599,15
24,28,212804249,28424,Yèvres,1667,1635,32
24,28,212804256,28425,Ymeray,575,564,11
24,28,212804264,28426,Ymonville,500,491,9
53,29,212900013,29001,Argol,1017,998,19
53,29,212900021,29002,Arzano,1426,1397,29
53,29,200054724,29003,Audierne,3756,3690,66
53,29,212900047,29004,Bannalec,5811,5656,155
53,29,212900054,29005,Baye,1312,1281,31
53,29,212900062,29006,Bénodet,3775,3702,73
53,29,212900070,29007,Berrien,907,879,28
53,29,212900088,29008,Beuzec-Cap-Sizun,1033,1006,27
53,29,212900104,29010,Bodilis,1689,1653,36
53,29,212900112,29011,Bohars,3650,3559,91
53,29,212900120,29012,Bolazec,181,179,2
53,29,212900138,29013,Botmeur,227,222,5
53,29,212900146,29014,Botsorhel,440,431,9
53,29,212900153,29015,Bourg-Blanc,3608,3545,63
53,29,212900161,29016,Brasparts,1033,1025,8
53,29,212900179,29017,Brélès,886,860,26
53,29,212900187,29018,Brennilis,444,439,5
53,29,212900195,29019,Brest,142110,139456,2654
53,29,212900203,29020,Briec,5850,5736,114
53,29,200063055,29021,Plounéour-Brignogan-plages,1980,1926,54
53,29,212900229,29022,Camaret-sur-Mer,2516,2462,54
53,29,212900237,29023,Carantec,3309,3212,97
53,29,212900245,29024,Carhaix-Plouguer,7773,7165,608
53,29,212900252,29025,Cast,1576,1532,44
53,29,212900260,29026,Châteaulin,5578,5156,422
53,29,212900278,29027,Châteauneuf-du-Faou,3741,3650,91
53,29,212900286,29028,Cléden-Cap-Sizun,935,915,20
53,29,212900294,29029,Cléden-Poher,1155,1138,17
53,29,212900302,29030,Cléder,3746,3635,111
53,29,212900310,29031,Clohars-Carnoët,4742,4625,117
53,29,212900328,29032,Clohars-Fouesnant,2163,2113,50
53,29,212900336,29033,Le Cloître-Pleyben,526,520,6
53,29,212900344,29034,Le Cloître-Saint-Thégonnec,665,653,12
53,29,212900351,29035,Coat-Méal,1140,1121,19
53,29,212900369,29036,Collorec,612,603,9
53,29,212900377,29037,Combrit,4364,4236,128
53,29,212900385,29038,Commana,1020,997,23
53,29,212900393,29039,Concarneau,21099,20209,890
53,29,212900401,29040,Le Conquet,2844,2768,76
53,29,212900419,29041,Coray,1920,1887,33
53,29,212900427,29042,Crozon,7575,7360,215
53,29,212900435,29043,Daoulas,1879,1833,46
53,29,212900443,29044,Dinéault,1902,1864,38
53,29,212900450,29045,Dirinon,2274,2206,68
53,29,212900468,29046,Douarnenez,14379,13956,423
53,29,212900476,29047,Le Drennec,1937,1904,33
53,29,212900484,29048,Edern,2287,2235,52
53,29,212900492,29049,Elliant,3471,3328,143
53,29,212900518,29051,Ergué-Gabéric,8690,8484,206
53,29,212900534,29053,Le Faou,1843,1782,61
53,29,212900542,29054,La Feuillée,670,656,14
53,29,212900559,29055,Le Folgoët,3316,3239,77
53,29,212900567,29056,La Forest-Landerneau,1995,1962,33
53,29,212900575,29057,La Forêt-Fouesnant,3583,3459,124
53,29,212900583,29058,Fouesnant,10557,10060,497
53,29,212900591,29059,Garlan,1084,1052,32
53,29,212900609,29060,Gouesnach,2860,2781,79
53,29,212900617,29061,Gouesnou,6393,6281,112
53,29,212900625,29062,Gouézec,1129,1104,25
53,29,212900633,29063,Goulien,437,430,7
53,29,212900641,29064,Goulven,451,447,4
53,29,212900658,29065,Gourlizon,935,924,11
53,29,212900666,29066,Guengat,1854,1824,30
53,29,212900674,29067,Guerlesquin,1327,1286,41
53,29,212900682,29068,Guiclan,2577,2529,48
53,29,212900690,29069,Guilers,8265,8119,146
53,29,212900708,29070,Guiler-sur-Goyen,533,523,10
53,29,212900716,29071,Guilligomarc'h,805,790,15
53,29,212900724,29072,Guilvinec,2741,2693,48
53,29,212900732,29073,Guimaëc,964,932,32
53,29,212900740,29074,Guimiliau,1028,1007,21
53,29,212900757,29075,Guipavas,15573,15196,377
53,29,200062974,29076,Milizac-Guipronvel,4671,4606,65
53,29,212900773,29077,Guissény,2030,1983,47
53,29,212900781,29078,Hanvec,2077,2036,41
53,29,212900799,29079,Henvic,1264,1224,40
53,29,212900807,29080,Hôpital-Camfrout,2289,2224,65
53,29,212900815,29081,Huelgoat,1431,1405,26
53,29,212900823,29082,Île-de-Batz,462,450,12
53,29,212900831,29083,Île-de-Sein,267,266,1
53,29,212900849,29084,Île-Molène,167,162,5
53,29,212900856,29085,Île-Tudy,755,737,18
53,29,212900864,29086,Irvillac,1481,1459,22
53,29,212900872,29087,Le Juch,741,725,16
53,29,212900898,29089,Kergloff,874,852,22
53,29,212900906,29090,Kerlaz,809,784,25
53,29,212900914,29091,Kerlouan,2124,2087,37
53,29,212900930,29093,Kernilis,1448,1417,31
53,29,212900948,29094,Kernouës,665,651,14
53,29,212900955,29095,Kersaint-Plabennec,1535,1507,28
53,29,212900971,29097,Lampaul-Guimiliau,2072,2023,49
53,29,212900989,29098,Lampaul-Plouarzel,2198,2148,50
53,29,212900997,29099,Lampaul-Ploudalmézeau,846,825,21
53,29,212901003,29100,Lanarvily,423,411,12
53,29,212901011,29101,Landéda,3708,3613,95
53,29,212901029,29102,Landeleau,976,963,13
53,29,212901037,29103,Landerneau,16627,16025,602
53,29,212901045,29104,Landévennec,350,342,8
53,29,212901052,29105,Landivisiau,9522,9204,318
53,29,212901060,29106,Landrévarzec,1897,1855,42
53,29,212901078,29107,Landudal,902,888,14
53,29,212901086,29108,Landudec,1529,1490,39
53,29,212901094,29109,Landunvez,1524,1487,37
53,29,212901102,29110,Langolen,868,854,14
53,29,212901110,29111,Lanhouarneau,1339,1317,22
53,29,212901128,29112,Lanildut,973,956,17
53,29,212901136,29113,Lanmeur,2407,2369,38
53,29,212901144,29114,Lannéanou,354,347,7
53,29,212901151,29115,Lannédern,309,301,8
53,29,212901169,29116,Lanneuffret,154,152,2
53,29,212901177,29117,Lannilis,5808,5694,114
53,29,212901193,29119,Lanrivoaré,1502,1485,17
53,29,212901201,29120,Lanvéoc,2031,1966,65
53,29,212901227,29122,Laz,698,683,15
53,29,212901235,29123,Lennon,801,778,23
53,29,212901243,29124,Lesneven,7506,7285,221
53,29,212901250,29125,Leuhan,845,828,17
53,29,212901268,29126,Loc-Brévalaire,215,208,7
53,29,212901284,29128,Loc-Eguiner,401,396,5
53,29,212901300,29130,Locmaria-Plouzané,5242,5115,127
53,29,212901318,29131,Locmélar,484,472,12
53,29,212901326,29132,Locquénolé,830,799,31
53,29,212901334,29133,Locquirec,1564,1521,43
53,29,212901342,29134,Locronan,815,790,25
53,29,212901359,29135,Loctudy,4086,3980,106
53,29,212901367,29136,Locunolé,1193,1167,26
53,29,212901375,29137,Logonna-Daoulas,2169,2120,49
53,29,212901391,29139,Lopérec,1017,877,140
53,29,212901409,29140,Loperhet,4018,3931,87
53,29,212901417,29141,Loqueffret,346,343,3
53,29,212901425,29142,Lothey,467,463,4
53,29,212901433,29143,Mahalon,992,971,21
53,29,212901441,29144,La Martyre,766,757,9
53,29,212901458,29145,Confort-Meilars,901,873,28
53,29,212901466,29146,Melgven,3472,3422,50
53,29,212901474,29147,Mellac,3384,3303,81
53,29,212901482,29148,Mespaul,961,932,29
53,29,212901508,29150,Moëlan-sur-Mer,6906,6748,158
53,29,212901516,29151,Morlaix,15172,14709,463
53,29,212901524,29152,Motreff,719,707,12
53,29,212901532,29153,Névez,2748,2694,54
53,29,212901557,29155,Ouessant,848,832,16
53,29,212901565,29156,Pencran,2133,2089,44
53,29,212901581,29158,Penmarch,5241,5139,102
53,29,212901599,29159,Peumerit,883,865,18
53,29,212901607,29160,Plabennec,8721,8545,176
53,29,212901615,29161,Pleuven,3307,3223,84
53,29,212901623,29162,Pleyben,3846,3579,267
53,29,212901631,29163,Pleyber-Christ,3267,3190,77
53,29,212901656,29165,Plobannalec-Lesconil,3697,3615,82
53,29,212901664,29166,Ploéven,521,502,19
53,29,212901672,29167,Plogastel-Saint-Germain,2032,1989,43
53,29,212901680,29168,Plogoff,1249,1230,19
53,29,212901698,29169,Plogonnec,3272,3196,76
53,29,212901706,29170,Plomelin,4357,4195,162
53,29,212901714,29171,Plomeur,3931,3855,76
53,29,212901722,29172,Plomodiern,2313,2245,68
53,29,212901730,29173,Plonéis,2509,2449,60
53,29,212901748,29174,Plonéour-Lanvern,6485,6300,185
53,29,212901755,29175,Plonévez-du-Faou,2174,2130,44
53,29,212901763,29176,Plonévez-Porzay,1831,1787,44
53,29,212901771,29177,Plouarzel,4017,3924,93
53,29,212901789,29178,Ploudalmézeau,6465,6333,132
53,29,212901797,29179,Ploudaniel,3868,3750,118
53,29,212901805,29180,Ploudiry,916,894,22
53,29,212901813,29181,Plouédern,3080,3009,71
53,29,212901821,29182,Plouégat-Guérand,1084,1061,23
53,29,212901839,29183,Plouégat-Moysan,730,716,14
53,29,212901847,29184,Plouénan,2593,2539,54
53,29,212901854,29185,Plouescat,3612,3522,90
53,29,212901862,29186,Plouezoc'h,1679,1620,59
53,29,212901870,29187,Plougar,821,794,27
53,29,212901888,29188,Plougasnou,2844,2724,120
53,29,212901896,29189,Plougastel-Daoulas,13637,13277,360
53,29,212901904,29190,Plougonvelin,4396,4299,97
53,29,212901912,29191,Plougonven,3525,3432,93
53,29,212901920,29192,Plougoulm,1815,1774,41
53,29,212901938,29193,Plougourvest,1478,1449,29
53,29,212901953,29195,Plouguerneau,6760,6633,127
53,29,212901961,29196,Plouguin,2215,2173,42
53,29,212901979,29197,Plouhinec,4019,3940,79
53,29,212901987,29198,Plouider,1869,1824,45
53,29,200083178,29199,Plouigneau,5249,5082,167
53,29,212902019,29201,Ploumoguer,2184,2143,41
53,29,212902027,29202,Plounéour-Ménez,1331,1296,35
53,29,212902043,29204,Plounéventer,2168,2134,34
53,29,212902050,29205,Plounévézel,1196,1171,25
53,29,212902068,29206,Plounévez-Lochrist,2391,2297,94
53,29,212902076,29207,Plourin-lès-Morlaix,4801,4510,291
53,29,212902084,29208,Plourin,1281,1253,28
53,29,212902092,29209,Plouvien,3958,3851,107
53,29,212902100,29210,Plouvorn,2951,2879,72
53,29,212902118,29211,Plouyé,671,654,17
53,29,212902126,29212,Plouzané,13808,13558,250
53,29,212902134,29213,Plouzévédé,1811,1775,36
53,29,212902142,29214,Plovan,703,683,20
53,29,212902159,29215,Plozévet,3015,2945,70
53,29,212902167,29216,Pluguffan,4300,4196,104
53,29,212902175,29217,Pont-Aven,2888,2831,57
53,29,212902183,29218,Pont-Croix,1596,1566,30
53,29,212902209,29220,Pont-l'Abbé,8786,8392,394
53,29,212902217,29221,Porspoder,1815,1764,51
53,29,212902225,29222,Port-Launay,405,398,7
53,29,212902241,29224,Pouldergat,1241,1214,27
53,29,212902258,29225,Pouldreuzic,2200,2157,43
53,29,212902266,29226,Poullan-sur-Mer,1565,1485,80
53,29,200085439,29227,Poullaouen,1506,1473,33
53,29,212902282,29228,Primelin,666,650,16
53,29,212902290,29229,Quéménéven,1146,1112,34
53,29,212902308,29230,Querrien,1699,1665,34
53,29,212902324,29232,Quimper,65875,63473,2402
53,29,212902332,29233,Quimperlé,12553,12077,476
53,29,212902340,29234,Rédené,2976,2911,65
53,29,212902357,29235,Le Relecq-Kerhuon,11930,11710,220
53,29,212902365,29236,Riec-sur-Bélon,4327,4240,87
53,29,212902373,29237,La Roche-Maurice,1854,1810,44
53,29,212902381,29238,Roscanvel,860,830,30
53,29,212902399,29239,Roscoff,3446,3362,84
53,29,212902407,29240,Rosnoën,983,960,23
53,29,212902415,29241,Rosporden,7755,7594,161
53,29,212902431,29243,Saint-Coulitz,472,459,13
53,29,212902449,29244,Saint-Derrien,842,829,13
53,29,212902456,29245,Saint-Divy,1591,1572,19
53,29,212902464,29246,Saint-Eloy,220,216,4
53,29,212902472,29247,Saint-Évarzec,3635,3521,114
53,29,212902480,29248,Saint-Frégant,859,851,8
53,29,212902498,29249,Saint-Goazec,722,713,9
53,29,212902506,29250,Saint-Hernin,767,750,17
53,29,212902514,29251,Saint-Jean-du-Doigt,674,662,12
53,29,212902522,29252,Saint-Jean-Trolimon,948,923,25
53,29,212902548,29254,Saint-Martin-des-Champs,4826,4707,119
53,29,212902555,29255,Saint-Méen,959,939,20
53,29,212902563,29256,Saint-Nic,774,754,20
53,29,212902571,29257,Saint-Pabu,2128,2067,61
53,29,212902597,29259,Saint-Pol-de-Léon,6985,6743,242
53,29,212902605,29260,Saint-Renan,8470,8276,194
53,29,212902613,29261,Saint-Rivoal,217,214,3
53,29,212902621,29262,Saint-Sauveur,794,784,10
53,29,212902639,29263,Saint-Ségal,1141,1124,17
53,29,212902647,29264,Saint-Servais,801,786,15
53,29,212902654,29265,Sainte-Sève,1083,1052,31
53,29,200059798,29266,Saint-Thégonnec Loc-Eguiner,3138,3059,79
53,29,212902670,29267,Saint-Thois,739,722,17
53,29,212902688,29268,Saint-Thonan,1953,1916,37
53,29,212902696,29269,Saint-Thurien,1041,1027,14
53,29,212902704,29270,Saint-Urbain,1699,1667,32
53,29,212902712,29271,Saint-Vougay,912,887,25
53,29,212902720,29272,Saint-Yvi,3375,3308,67
53,29,212902738,29273,Santec,2461,2385,76
53,29,212902746,29274,Scaër,5354,5245,109
53,29,212902753,29275,Scrignac,759,739,20
53,29,212902761,29276,Sibiril,1213,1182,31
53,29,212902779,29277,Sizun,2381,2304,77
53,29,212902787,29278,Spézet,1799,1757,42
53,29,212902795,29279,Taulé,2951,2878,73
53,29,212902803,29280,Telgruc-sur-Mer,2163,2102,61
53,29,212902811,29281,Tourch,1026,998,28
53,29,212902829,29282,Trébabu,373,363,10
53,29,212902845,29284,Treffiagat,2517,2410,107
53,29,212902852,29285,Tréflaouénan,531,523,8
53,29,212902860,29286,Tréflévénez,252,244,8
53,29,212902878,29287,Tréflez,994,975,19
53,29,212902886,29288,Trégarantec,621,615,6
53,29,212902894,29289,Trégarvan,119,112,7
53,29,212902902,29290,Tréglonou,706,691,15
53,29,212902910,29291,Trégourez,973,955,18
53,29,212902928,29292,Tréguennec,320,314,6
53,29,212902936,29293,Trégunc,7282,7058,224
53,29,212902944,29294,Le Tréhou,655,644,11
53,29,212902951,29295,Trémaouézan,532,511,21
53,29,212902969,29296,Tréméoc,1439,1400,39
53,29,212902977,29297,Tréméven,2377,2329,48
53,29,212902985,29298,Tréogat,584,574,10
53,29,212902993,29299,Tréouergat,332,329,3
53,29,212903009,29300,Le Trévoux,1660,1608,52
53,29,212903017,29301,Trézilidé,410,401,9
53,29,212903025,29302,Pont-de-Buis-lès-Quimerch,3755,3617,138
94,2A,212000012,2A001,Afa,3335,3277,58
94,2A,212000046,2A004,Ajaccio,73483,72647,836
94,2A,212000061,2A006,Alata,3633,3562,71
94,2A,212000087,2A008,Albitreccia,1811,1785,26
94,2A,212000111,2A011,Altagène,56,54,2
94,2A,212000145,2A014,Ambiegna,74,74,0
94,2A,212000178,2A017,Appietto,1833,1795,38
94,2A,212000186,2A018,Arbellara,161,159,2
94,2A,212000194,2A019,Arbori,54,54,0
94,2A,212000210,2A021,Argiusta-Moriccio,78,77,1
94,2A,212000228,2A022,Arro,80,80,0
94,2A,212000244,2A024,Aullène,186,185,1
94,2A,212000269,2A026,Azilone-Ampaza,196,193,3
94,2A,212000277,2A027,Azzana,53,53,0
94,2A,212000285,2A028,Balogna,152,146,6
94,2A,212000319,2A031,Bastelica,523,517,6
94,2A,212000327,2A032,Bastelicaccia,4364,4250,114
94,2A,212000350,2A035,Belvédère-Campomoro,161,159,2
94,2A,212000384,2A038,Bilia,53,52,1
94,2A,212000400,2A040,Bocognano,379,372,7
94,2A,212000418,2A041,Bonifacio,3259,3204,55
94,2A,212000483,2A048,Calcatoggio,508,503,5
94,2A,212000566,2A056,Campo,110,105,5
94,2A,212000608,2A060,Cannelle,77,76,1
94,2A,212000616,2A061,Carbini,117,114,3
94,2A,212000624,2A062,Carbuccia,384,375,9
94,2A,212000640,2A064,Cardo-Torgia,33,31,2
94,2A,212000657,2A065,Cargèse,1301,1280,21
94,2A,212000665,2A066,Cargiaca,60,60,0
94,2A,212000707,2A070,Casaglione,390,384,6
94,2A,212000715,2A071,Casalabriva,223,219,4
94,2A,212000855,2A085,Cauro,1530,1492,38
94,2A,212000897,2A089,Ciamannacce,133,133,0
94,2A,212000905,2A090,Coggia,736,722,14
94,2A,212000913,2A091,Cognocoli-Monticchi,176,175,1
94,2A,212000921,2A092,Conca,1171,1151,20
94,2A,212000947,2A094,Corrano,74,73,1
94,2A,212000988,2A098,Coti-Chiavari,733,724,9
94,2A,212000996,2A099,Cozzano,279,278,1
94,2A,212001002,2A100,Cristinacce,67,67,0
94,2A,212001036,2A103,Cuttoli-Corticchiato,2065,2032,33
94,2A,212001044,2A104,Eccica-Suarella,1389,1353,36
94,2A,212001085,2A108,Évisa,218,213,5
94,2A,212001143,2A114,Figari,1593,1559,34
94,2A,212001150,2A115,Foce,153,151,2
94,2A,212001176,2A117,Forciolo,83,83,0
94,2A,212001184,2A118,Fozzano,211,209,2
94,2A,212001192,2A119,Frasseto,143,140,3
94,2A,212001275,2A127,Giuncheto,95,91,4
94,2A,212001283,2A128,Granace,95,93,2
94,2A,212001291,2A129,Grossa,54,53,1
94,2A,212001309,2A130,Grosseto-Prugna,3455,3398,57
94,2A,212001317,2A131,Guagno,160,158,2
94,2A,212001325,2A132,Guargualé,154,153,1
94,2A,212001333,2A133,Guitera-les-Bains,155,152,3
94,2A,212001390,2A139,Lecci,1920,1889,31
94,2A,212001416,2A141,Letia,128,128,0
94,2A,212001424,2A142,Levie,687,674,13
94,2A,212001440,2A144,Lopigna,105,102,3
94,2A,212001465,2A146,Loreto-di-Tallano,53,52,1
94,2A,212001549,2A154,Marignana,112,106,6
94,2A,212001580,2A158,Mela,29,28,1
94,2A,212001606,2A160,Moca-Croce,261,259,2
94,2A,212001630,2A163,Monacia-d'Aullène,574,559,15
94,2A,212001747,2A174,Murzo,104,101,3
94,2A,212001812,2A181,Ocana,645,628,17
94,2A,212001861,2A186,Olivese,219,218,1
94,2A,212001895,2A189,Olmeto,1245,1217,28
94,2A,212001911,2A191,Olmiccia,123,119,4
94,2A,212001960,2A196,Orto,51,50,1
94,2A,212001978,2A197,Osani,98,98,0
94,2A,212001986,2A198,Ota,520,511,9
94,2A,212002000,2A200,Palneca,137,134,3
94,2A,212002034,2A203,Partinello,95,95,0
94,2A,212002042,2A204,Pastricciola,97,96,1
94,2A,212002091,2A209,Peri,2071,2038,33
94,2A,212002117,2A211,Petreto-Bicchisano,581,564,17
94,2A,212002125,2A212,Piana,470,461,9
94,2A,212002158,2A215,Pianottoli-Caldarello,908,901,7
94,2A,212002281,2A228,Pietrosella,1964,1945,19
94,2A,212002323,2A232,Pila-Canale,281,278,3
94,2A,212002406,2A240,Poggiolo,114,114,0
94,2A,212002471,2A247,Porto-Vecchio,11210,11040,170
94,2A,212002497,2A249,Propriano,3747,3705,42
94,2A,212002539,2A253,Quasquara,51,51,0
94,2A,212002547,2A254,Quenza,199,195,4
94,2A,212002588,2A258,Renno,63,61,2
94,2A,212002596,2A259,Rezza,66,65,1
94,2A,212002620,2A262,Rosazia,51,50,1
94,2A,212002661,2A266,Salice,93,89,4
94,2A,212002687,2A268,Sampolo,81,81,0
94,2A,212002695,2A269,Sari-Solenzara,1431,1411,20
94,2A,212002703,2A270,Sari-d'Orcino,355,352,3
94,2A,212002711,2A271,Sarrola-Carcopino,3361,3309,52
94,2A,212002729,2A272,Sartène,3503,3408,95
94,2A,212002760,2A276,Serra-di-Ferro,573,563,10
94,2A,212002786,2A278,Serra-di-Scopamène,84,81,3
94,2A,212002794,2A279,Serriera,120,120,0
94,2A,212002828,2A282,Soccia,154,152,2
94,2A,212002844,2A284,Sollacaro,377,372,5
94,2A,212002851,2A285,Sorbollano,72,72,0
94,2A,212002885,2A288,Sotta,1578,1556,22
94,2A,212002950,2A295,Sant'Andréa-d'Orcino,129,125,4
94,2A,212003008,2A300,San-Gavino-di-Carbini,1098,1077,21
94,2A,212003081,2A308,Sainte-Lucie-de-Tallano,388,381,7
94,2A,212003107,2A310,Santa-Maria-Figaniella,102,102,0
94,2A,212003123,2A312,Santa-Maria-Siché,396,387,9
94,2A,212003222,2A322,Tasso,87,87,0
94,2A,212003230,2A323,Tavaco,412,405,7
94,2A,212003248,2A324,Tavera,398,394,4
94,2A,212003263,2A326,Tolla,123,121,2
94,2A,212003305,2A330,Ucciani,503,501,2
94,2A,212003313,2A331,Urbalacone,59,59,0
94,2A,212003362,2A336,Valle-di-Mezzana,533,522,11
94,2A,212003453,2A345,Vero,610,606,4
94,2A,212003487,2A348,Vico,940,929,11
94,2A,212003495,2A349,Viggianello,872,854,18
94,2A,212003511,2A351,Villanova,408,403,5
94,2A,212003578,2A357,Zérubia,51,48,3
94,2A,212003586,2A358,Zévaco,53,52,1
94,2A,212003594,2A359,Zicavo,221,219,2
94,2A,212003602,2A360,Zigliara,133,128,5
94,2A,212003628,2A362,Zonza,2790,2755,35
94,2A,212003636,2A363,Zoza,66,66,0
94,2B,212000020,2B002,Aghione,239,235,4
94,2B,212000038,2B003,Aiti,26,26,0
94,2B,212000053,2B005,Alando,29,27,2
94,2B,212000079,2B007,Albertacce,209,204,5
94,2B,212000095,2B009,Aléria,2211,2185,26
94,2B,212000103,2B010,Algajola,365,358,7
94,2B,212000129,2B012,Altiani,53,52,1
94,2B,212000137,2B013,Alzi,25,25,0
94,2B,212000152,2B015,Ampriani,25,25,0
94,2B,212000160,2B016,Antisanti,556,556,0
94,2B,212000202,2B020,Aregno,609,597,12
94,2B,212000236,2B023,Asco,116,115,1
94,2B,212000251,2B025,Avapessa,84,82,2
94,2B,212000293,2B029,Barbaggio,301,297,4
94,2B,212000301,2B030,Barrettali,136,132,4
94,2B,212000335,2B033,Bastia,48928,48296,632
94,2B,212000343,2B034,Belgodère,704,696,8
94,2B,212000368,2B036,Bigorno,87,87,0
94,2B,212000376,2B037,Biguglia,7858,7732,126
94,2B,212000392,2B039,Bisinchi,230,228,2
94,2B,212000426,2B042,Borgo,9432,9254,178
94,2B,212000434,2B043,Brando,1638,1602,36
94,2B,212000459,2B045,Bustanico,66,66,0
94,2B,212000467,2B046,Cagnano,157,154,3
94,2B,212000475,2B047,Calacuccia,271,268,3
94,2B,212000491,2B049,Calenzana,2551,2520,31
94,2B,212000509,2B050,Calvi,5848,5766,82
94,2B,212000517,2B051,Cambia,70,70,0
94,2B,212000525,2B052,Campana,20,20,0
94,2B,212000533,2B053,Campi,19,19,0
94,2B,212000541,2B054,Campile,189,185,4
94,2B,212000558,2B055,Campitello,117,116,1
94,2B,212000574,2B057,Canale-di-Verde,314,312,2
94,2B,212000582,2B058,Canari,317,316,1
94,2B,212000590,2B059,Canavaggia,113,112,1
94,2B,212000632,2B063,Carcheto-Brustico,39,39,0
94,2B,212000673,2B067,Carpineto,35,35,0
94,2B,212000681,2B068,Carticasi,25,25,0
94,2B,212000699,2B069,Casabianca,117,116,1
94,2B,212000723,2B072,Casalta,56,55,1
94,2B,212000731,2B073,Casamaccioli,111,109,2
94,2B,212000749,2B074,Casanova,398,395,3
94,2B,212000756,2B075,Casevecchie,74,72,2
94,2B,212000772,2B077,Castellare-di-Casinca,703,697,6
94,2B,212000780,2B078,Castellare-di-Mercurio,29,28,1
94,2B,212000798,2B079,Castello-di-Rostino,500,499,1
94,2B,212000806,2B080,Castifao,140,139,1
94,2B,212000814,2B081,Castiglione,42,42,0
94,2B,212000822,2B082,Castineta,38,38,0
94,2B,212000830,2B083,Castirla,156,154,2
94,2B,212000848,2B084,Cateri,245,244,1
94,2B,212000863,2B086,Centuri,186,185,1
94,2B,212000871,2B087,Cervione,2208,2182,26
94,2B,212000889,2B088,Chiatra,217,214,3
94,2B,212000939,2B093,Corbara,933,901,32
94,2B,212000954,2B095,Corscia,130,127,3
94,2B,212000962,2B096,Corte,7665,7549,116
94,2B,212000970,2B097,Costa,52,51,1
94,2B,212001010,2B101,Croce,83,80,3
94,2B,212001028,2B102,Crocicchia,80,80,0
94,2B,212001051,2B105,Erbajolo,108,108,0
94,2B,212001069,2B106,Érone,12,12,0
94,2B,212001077,2B107,Ersa,145,145,0
94,2B,212001093,2B109,Farinole,238,236,2
94,2B,212001101,2B110,Favalello,68,67,1
94,2B,212001119,2B111,Felce,51,51,0
94,2B,212001127,2B112,Feliceto,240,236,4
94,2B,212001135,2B113,Ficaja,57,56,1
94,2B,212001168,2B116,Focicchia,30,29,1
94,2B,212001200,2B120,Furiani,5901,5772,129
94,2B,212001218,2B121,Galéria,378,373,5
94,2B,212001226,2B122,Gavignano,59,59,0
94,2B,212001234,2B123,Ghisonaccia,4269,4215,54
94,2B,212001242,2B124,Ghisoni,213,207,6
94,2B,212001259,2B125,Giocatojo,53,53,0
94,2B,212001267,2B126,Giuncaggio,70,70,0
94,2B,212001341,2B134,L'Île-Rousse,3291,3224,67
94,2B,212001358,2B135,Isolaccio-di-Fiumorbo,319,315,4
94,2B,212001366,2B136,Lama,151,149,2
94,2B,212001374,2B137,Lano,22,22,0
94,2B,212001382,2B138,Lavatoggio,151,149,2
94,2B,212001408,2B140,Lento,107,107,0
94,2B,212001432,2B143,Linguizzetta,1112,1104,8
94,2B,212001457,2B145,Loreto-di-Casinca,214,208,6
94,2B,212001473,2B147,Lozzi,112,111,1
94,2B,212001481,2B148,Lucciana,6087,6036,51
94,2B,212001499,2B149,Lugo-di-Nazza,85,84,1
94,2B,212001507,2B150,Lumio,1273,1237,36
94,2B,212001523,2B152,Luri,857,848,9
94,2B,212001531,2B153,Manso,121,119,2
94,2B,212001556,2B155,Matra,49,49,0
94,2B,212001564,2B156,Mausoléo,26,26,0
94,2B,212001572,2B157,Mazzola,30,30,0
94,2B,212001598,2B159,Meria,81,80,1
94,2B,212001614,2B161,Moïta,64,64,0
94,2B,212001622,2B162,Moltifao,720,709,11
94,2B,212001648,2B164,Monacia-d'Orezza,22,22,0
94,2B,212001655,2B165,Moncale,343,337,6
94,2B,212001663,2B166,Monte,649,644,5
94,2B,212001671,2B167,Montegrosso,439,425,14
94,2B,212001689,2B168,Monticello,2044,2000,44
94,2B,212001697,2B169,Morosaglia,981,971,10
94,2B,212001705,2B170,Morsiglia,109,107,2
94,2B,212001713,2B171,Muracciole,35,34,1
94,2B,212001721,2B172,Murato,571,565,6
94,2B,212001739,2B173,Muro,260,257,3
94,2B,212001754,2B175,Nessa,117,114,3
94,2B,212001762,2B176,Nocario,78,76,2
94,2B,212001770,2B177,Noceta,61,59,2
94,2B,212001788,2B178,Nonza,72,71,1
94,2B,212001796,2B179,Novale,63,62,1
94,2B,212001804,2B180,Novella,80,79,1
94,2B,212001820,2B182,Occhiatana,266,264,2
94,2B,212001838,2B183,Ogliastro,95,93,2
94,2B,212001846,2B184,Olcani,94,93,1
94,2B,212001853,2B185,Oletta,1810,1795,15
94,2B,212001879,2B187,Olmeta-di-Capocorso,132,131,1
94,2B,212001887,2B188,Olmeta-di-Tuda,546,538,8
94,2B,212001903,2B190,Olmi-Cappella,189,185,4
94,2B,212001929,2B192,Olmo,150,147,3
94,2B,212001937,2B193,Omessa,606,600,6
94,2B,212001945,2B194,Ortale,26,26,0
94,2B,212001952,2B195,Ortiporio,124,123,1
94,2B,212001994,2B199,Palasca,190,185,5
94,2B,212002018,2B201,Pancheraccia,198,197,1
94,2B,212002026,2B202,Parata,24,24,0
94,2B,212002059,2B205,Patrimonio,893,881,12
94,2B,212002067,2B206,Penta-Acquatella,38,38,0
94,2B,212002075,2B207,Penta-di-Casinca,3404,3366,38
94,2B,212002083,2B208,Perelli,109,108,1
94,2B,212002109,2B210,Pero-Casevecchie,114,114,0
94,2B,212002133,2B213,Pianello,59,59,0
94,2B,212002141,2B214,Piano,19,19,0
94,2B,212002166,2B216,Piazzali,19,19,0
94,2B,212002174,2B217,Piazzole,44,44,0
94,2B,212002182,2B218,Piedicorte-di-Gaggio,102,99,3
94,2B,212002190,2B219,Piedicroce,84,83,1
94,2B,212002208,2B220,Piedigriggio,135,132,3
94,2B,212002216,2B221,Piedipartino,16,16,0
94,2B,212002224,2B222,Pie-d'Orezza,38,38,0
94,2B,212002232,2B223,Pietralba,499,496,3
94,2B,212002240,2B224,Pietracorbara,668,658,10
94,2B,212002257,2B225,Pietra-di-Verde,101,99,2
94,2B,212002265,2B226,Pietraserena,60,59,1
94,2B,212002273,2B227,Pietricaggio,34,33,1
94,2B,212002299,2B229,Pietroso,349,349,0
94,2B,212002307,2B230,Piève,111,111,0
94,2B,212002315,2B231,Pigna,115,109,6
94,2B,212002331,2B233,Pino,169,167,2
94,2B,212002349,2B234,Piobetta,17,17,0
94,2B,212002356,2B235,Pioggiola,85,85,0
94,2B,212002364,2B236,Poggio-di-Nazza,186,183,3
94,2B,212002380,2B238,Poggio-di-Venaco,215,208,7
94,2B,212002398,2B239,Poggio-d'Oletta,225,214,11
94,2B,212002414,2B241,Poggio-Marinaccio,33,32,1
94,2B,212002422,2B242,Poggio-Mezzana,712,699,13
94,2B,212002430,2B243,Polveroso,42,42,0
94,2B,212002448,2B244,Popolasca,42,42,0
94,2B,212002455,2B245,Porri,44,43,1
94,2B,212002463,2B246,La Porta,193,191,2
94,2B,212002489,2B248,Prato-di-Giovellina,47,45,2
94,2B,212002505,2B250,Prunelli-di-Casacconi,149,149,0
94,2B,212002513,2B251,Prunelli-di-Fiumorbo,3762,3719,43
94,2B,212002521,2B252,Pruno,184,181,3
94,2B,212002554,2B255,Quercitello,40,40,0
94,2B,212002562,2B256,Rapaggio,29,28,1
94,2B,212002570,2B257,Rapale,164,160,4
94,2B,212002604,2B260,Riventosa,155,152,3
94,2B,212002612,2B261,Rogliano,549,538,11
94,2B,212002638,2B263,Rospigliani,74,69,5
94,2B,212002646,2B264,Rusio,60,59,1
94,2B,212002653,2B265,Rutali,418,413,5
94,2B,212002679,2B267,Saliceto,48,45,3
94,2B,212002737,2B273,Scata,48,43,5
94,2B,212002745,2B274,Scolca,91,90,1
94,2B,212002752,2B275,Sermano,75,73,2
94,2B,212002778,2B277,Serra-di-Fiumorbo,337,334,3
94,2B,212002802,2B280,Silvareccio,106,106,0
94,2B,212002810,2B281,Sisco,1160,1151,9
94,2B,212002836,2B283,Solaro,742,730,12
94,2B,212002869,2B286,Sorbo-Ocagnano,901,882,19
94,2B,212002877,2B287,Sorio,142,142,0
94,2B,212002893,2B289,Soveria,116,116,0
94,2B,212002901,2B290,Speloncato,285,277,8
94,2B,212002919,2B291,Stazzona,35,34,1
94,2B,212002927,2B292,Sant'Andréa-di-Bozio,67,66,1
94,2B,212002935,2B293,Sant'Andréa-di-Cotone,208,206,2
94,2B,212002968,2B296,Sant'Antonino,141,136,5
94,2B,212002976,2B297,San-Damiano,55,55,0
94,2B,212002984,2B298,Saint-Florent,1706,1688,18
94,2B,212002992,2B299,San-Gavino-d'Ampugnani,106,105,1
94,2B,212003016,2B301,San-Gavino-di-Tenda,58,57,1
94,2B,212003024,2B302,San-Giovanni-di-Moriani,90,88,2
94,2B,212003032,2B303,San-Giuliano,764,758,6
94,2B,212003040,2B304,San-Lorenzo,144,142,2
94,2B,212003057,2B305,San-Martino-di-Lota,2962,2920,42
94,2B,212003065,2B306,Santa-Lucia-di-Mercurio,118,118,0
94,2B,212003073,2B307,Santa-Lucia-di-Moriani,1549,1519,30
94,2B,212003099,2B309,Santa-Maria-di-Lota,2073,1971,102
94,2B,212003115,2B311,Santa-Maria-Poggio,798,787,11
94,2B,212003131,2B313,San-Nicolao,2055,2037,18
94,2B,212003149,2B314,Santo-Pietro-di-Tenda,339,338,1
94,2B,212003156,2B315,Santo-Pietro-di-Venaco,289,284,5
94,2B,212003164,2B316,Santa-Reparata-di-Balagna,1014,1000,14
94,2B,212003172,2B317,Santa-Reparata-di-Moriani,59,59,0
94,2B,212003180,2B318,Taglio-Isolaccio,591,581,10
94,2B,212003198,2B319,Talasani,817,811,6
94,2B,212003206,2B320,Tallone,285,283,2
94,2B,212003214,2B321,Tarrano,15,15,0
94,2B,212003271,2B327,Tomino,187,184,3
94,2B,212003289,2B328,Tox,97,97,0
94,2B,212003297,2B329,Tralonca,112,111,1
94,2B,212003321,2B332,Urtaca,244,238,6
94,2B,212003339,2B333,Vallecalle,150,146,4
94,2B,212003347,2B334,Valle-d'Alesani,108,107,1
94,2B,212003354,2B335,Valle-di-Campoloro,359,352,7
94,2B,212003370,2B337,Valle-di-Rostino,143,141,2
94,2B,212003388,2B338,Valle-d'Orezza,28,28,0
94,2B,212003396,2B339,Vallica,28,28,0
94,2B,212003404,2B340,Velone-Orneto,119,117,2
94,2B,212003412,2B341,Venaco,698,690,8
94,2B,212003420,2B342,Ventiseri,2568,2520,48
94,2B,212003438,2B343,Venzolasca,1809,1795,14
94,2B,212003446,2B344,Verdèse,44,42,2
94,2B,212003461,2B346,Vescovato,3053,3032,21
94,2B,212003479,2B347,Vezzani,268,268,0
94,2B,212003503,2B350,Vignale,216,212,4
94,2B,212003529,2B352,Ville-di-Paraso,212,207,5
94,2B,212003537,2B353,Ville-di-Pietrabugno,3342,3278,64
94,2B,212003545,2B354,Vivario,433,428,5
94,2B,212003552,2B355,Volpajola,358,352,6
94,2B,212003560,2B356,Zalana,147,146,1
94,2B,212003610,2B361,Zilia,302,298,4
94,2B,212003644,2B364,Zuani,36,36,0
94,2B,212003651,2B365,San-Gavino-di-Fiumorbo,104,102,2
94,2B,212003669,2B366,Chisa,106,104,2
76,30,213000011,30001,Aigaliers,539,525,14
76,30,213000029,30002,Aigremont,786,770,16
76,30,213000037,30003,Aigues-Mortes,8742,8664,78
76,30,213000045,30004,Aigues-Vives,3399,3339,60
76,30,213000052,30005,Aiguèze,221,218,3
76,30,213000060,30006,Aimargues,5784,5729,55
76,30,213000078,30007,Alès,43492,42867,625
76,30,213000086,30008,Allègre-les-Fumades,1001,984,17
76,30,213000094,30009,Alzon,175,173,2
76,30,213000102,30010,Anduze,3374,3335,39
76,30,213000110,30011,Les Angles,8714,8507,207
76,30,213000128,30012,Aramon,4229,4172,57
76,30,213000136,30013,Argilliers,469,448,21
76,30,213000144,30014,Arpaillargues-et-Aureillac,1062,1044,18
76,30,213000151,30015,Arphy,148,143,5
76,30,213000169,30016,Arre,289,278,11
76,30,213000177,30017,Arrigas,214,212,2
76,30,213000185,30018,Aspères,546,530,16
76,30,213000193,30019,Aubais,3012,2952,60
76,30,213000201,30020,Aubord,2390,2347,43
76,30,213000219,30021,Aubussargues,325,321,4
76,30,213000227,30022,Aujac,184,178,6
76,30,213000235,30023,Aujargues,802,788,14
76,30,213000243,30024,Aulas,458,451,7
76,30,213000250,30025,Aumessas,233,230,3
76,30,213000268,30026,Avèze,1089,1067,22
76,30,213000276,30027,Bagard,2631,2570,61
76,30,213000284,30028,Bagnols-sur-Cèze,18405,18072,333
76,30,213000292,30029,Barjac,1645,1616,29
76,30,213000300,30030,Baron,368,358,10
76,30,213000318,30031,La Bastide-d'Engras,204,202,2
76,30,213000326,30032,Beaucaire,15800,15659,141
76,30,213000334,30033,Beauvoisin,5378,5323,55
76,30,213000342,30034,Bellegarde,7624,7550,74
76,30,213000359,30035,Belvézet,241,240,1
76,30,213000367,30036,Bernis,3478,3452,26
76,30,213000375,30037,Bessèges,2793,2766,27
76,30,213000383,30038,Bez-et-Esparon,337,326,11
76,30,213000391,30039,Bezouce,2341,2315,26
76,30,213000409,30040,Blandas,129,127,2
76,30,213000417,30041,Blauzac,1254,1233,21
76,30,213000425,30042,Boisset-et-Gaujac,2613,2568,45
76,30,213000433,30043,Boissières,601,585,16
76,30,213000441,30044,Bonnevaux,87,84,3
76,30,213000458,30045,Bordezac,395,392,3
76,30,213000466,30046,Boucoiran-et-Nozières,1003,989,14
76,30,213000474,30047,Bouillargues,6374,6238,136
76,30,213000482,30048,Bouquet,186,183,3
76,30,213000490,30049,Bourdic,388,371,17
76,30,213000508,30050,Bragassargues,168,167,1
76,30,213000516,30051,Branoux-les-Taillades,1371,1336,35
76,30,200082428,30052,Bréau-Mars,677,658,19
76,30,213000532,30053,Brignon,772,762,10
76,30,213000540,30054,Brouzet-lès-Quissac,307,303,4
76,30,213000557,30055,Brouzet-lès-Alès,691,678,13
76,30,213000565,30056,La Bruguière,336,329,7
76,30,213000573,30057,Cabrières,1740,1710,30
76,30,213000581,30058,La Cadière-et-Cambo,224,218,6
76,30,213000599,30059,Le Cailar,2486,2467,19
76,30,213000607,30060,Caissargues,4198,4118,80
76,30,213000615,30061,La Calmette,2460,2432,28
76,30,213000623,30062,Calvisson,6013,5914,99
76,30,213000649,30064,Campestre-et-Luc,136,134,2
76,30,213000656,30065,Canaules-et-Argentières,469,466,3
76,30,213000664,30066,Cannes-et-Clairan,572,559,13
76,30,213000672,30067,La Capelle-et-Masmolène,422,416,6
76,30,213000680,30068,Cardet,928,905,23
76,30,213000698,30069,Carnas,528,516,12
76,30,213000706,30070,Carsan,795,770,25
76,30,213000714,30071,Cassagnoles,421,413,8
76,30,213000722,30072,Castelnau-Valence,491,481,10
76,30,213000730,30073,Castillon-du-Gard,1765,1679,86
76,30,213000748,30074,Causse-Bégon,26,26,0
76,30,213000755,30075,Caveirac,4487,4372,115
76,30,213000763,30076,Cavillargues,881,849,32
76,30,213000771,30077,Cendras,1683,1652,31
76,30,213000797,30079,Chambon,260,257,3
76,30,213000805,30080,Chamborigaud,896,891,5
76,30,213000813,30081,Chusclan,995,966,29
76,30,213000821,30082,Clarensac,4287,4190,97
76,30,213000839,30083,Codognan,2456,2419,37
76,30,213000847,30084,Codolet,618,607,11
76,30,213000854,30085,Collias,1081,1066,15
76,30,213000862,30086,Collorgues,677,666,11
76,30,213000870,30087,Colognac,232,226,6
76,30,213000888,30088,Combas,690,677,13
76,30,213000896,30089,Comps,1767,1736,31
76,30,213000904,30090,Concoules,266,263,3
76,30,213000912,30091,Congénies,1700,1666,34
76,30,213000920,30092,Connaux,1750,1701,49
76,30,213000938,30093,Conqueyrac,101,101,0
76,30,213000946,30094,Corbès,151,150,1
76,30,213000953,30095,Corconne,621,609,12
76,30,213000961,30096,Cornillon,952,935,17
76,30,213000979,30097,Courry,284,280,4
76,30,213000987,30098,Crespian,440,436,4
76,30,213000995,30099,Cros,245,237,8
76,30,213001001,30100,Cruviers-Lascours,715,705,10
76,30,213001019,30101,Deaux,673,656,17
76,30,213001027,30102,Dions,548,539,9
76,30,213001035,30103,Domazan,962,951,11
76,30,213001043,30104,Domessargues,771,752,19
76,30,213001050,30105,Dourbies,143,138,5
76,30,213001068,30106,Durfort-et-Saint-Martin-de-Sossenac,767,750,17
76,30,213001076,30107,Estézargues,617,605,12
76,30,213001084,30108,L'Estréchure,160,155,5
76,30,213001092,30109,Euzet,477,470,7
76,30,213001100,30110,Flaux,374,365,9
76,30,213001118,30111,Foissac,455,446,9
76,30,213001126,30112,Fons,1749,1733,16
76,30,213001134,30113,Fons-sur-Lussan,236,233,3
76,30,213001142,30114,Fontanès,692,682,10
76,30,213001159,30115,Fontarèches,255,247,8
76,30,213001167,30116,Fournès,1086,1073,13
76,30,213001175,30117,Fourques,2800,2748,52
76,30,213001191,30119,Fressac,162,157,5
76,30,213001209,30120,Gagnières,1104,1088,16
76,30,213001217,30121,Gailhan,268,264,4
76,30,213001225,30122,Gajan,736,723,13
76,30,213001233,30123,Gallargues-le-Montueux,3709,3596,113
76,30,213001241,30124,Le Garn,214,212,2
76,30,213001258,30125,Garons,5085,5035,50
76,30,213001266,30126,Garrigues-Sainte-Eulalie,753,734,19
76,30,213001274,30127,Gaujac,1096,1071,25
76,30,213001282,30128,Générac,4117,4048,69
76,30,213001290,30129,Générargues,712,692,20
76,30,213001308,30130,Génolhac,833,824,9
76,30,213001316,30131,Goudargues,1140,1108,32
76,30,213001324,30132,La Grand-Combe,5029,4955,74
76,30,213001332,30133,Le Grau-du-Roi,8426,8356,70
76,30,213001340,30134,Issirac,314,310,4
76,30,213001357,30135,Jonquières-Saint-Vincent,3848,3811,37
76,30,213001365,30136,Junas,1169,1152,17
76,30,213001373,30137,Lamelouze,141,138,3
76,30,213001381,30138,Langlade,2295,2239,56
76,30,213001399,30139,Lanuéjols,368,339,29
76,30,213001407,30140,Lasalle,1104,1093,11
76,30,213001415,30141,Laudun-l'Ardoise,6447,6327,120
76,30,213001423,30142,Laval-Pradel,1137,1116,21
76,30,213001431,30143,Laval-Saint-Roman,219,214,5
76,30,213001449,30144,Lecques,467,458,9
76,30,213001456,30145,Lédenon,1675,1651,24
76,30,213001464,30146,Lédignan,1515,1491,24
76,30,213001472,30147,Lézan,1561,1535,26
76,30,213001480,30148,Liouc,336,329,7
76,30,213001498,30149,Lirac,942,922,20
76,30,213001506,30150,Logrian-Florian,270,264,6
76,30,213001514,30151,Lussan,506,499,7
76,30,213001522,30152,Les Mages,2094,2061,33
76,30,213001530,30153,Malons-et-Elze,124,124,0
76,30,213001548,30154,Mandagout,399,389,10
76,30,213001555,30155,Manduel,7185,7092,93
76,30,213001563,30156,Marguerittes,8713,8564,149
76,30,213001589,30158,Martignargues,445,436,9
76,30,213001597,30159,Le Martinet,783,779,4
76,30,213001605,30160,Maruéjols-lès-Gardon,270,266,4
76,30,213001613,30161,Massanes,210,204,6
76,30,213001621,30162,Massillargues-Attuech,684,669,15
76,30,213001639,30163,Mauressargues,177,171,6
76,30,213001647,30164,Méjannes-le-Clap,734,725,9
76,30,213001654,30165,Méjannes-lès-Alès,1232,1195,37
76,30,213001662,30166,Meynes,2693,2542,151
76,30,213001670,30167,Meyrannes,807,791,16
76,30,213001688,30168,Mialet,640,623,17
76,30,213001696,30169,Milhaud,5957,5821,136
76,30,213001704,30170,Molières-Cavaillac,943,912,31
76,30,213001712,30171,Molières-sur-Cèze,1222,1209,13
76,30,213001720,30172,Monoblet,775,767,8
76,30,213001738,30173,Mons,1792,1760,32
76,30,213001746,30174,Montaren-et-Saint-Médiers,1426,1389,37
76,30,213001753,30175,Montclus,189,188,1
76,30,213001761,30176,Montdardier,194,191,3
76,30,213001779,30177,Monteils,657,647,10
76,30,213001787,30178,Montfaucon,1559,1521,38
76,30,213001795,30179,Montfrin,3199,3149,50
76,30,213001803,30180,Montignargues,575,566,9
76,30,213001811,30181,Montmirat,476,471,5
76,30,213001829,30182,Montpezat,1412,1388,24
76,30,213001837,30183,Moulézan,665,656,9
76,30,213001845,30184,Moussac,1546,1534,12
76,30,213001852,30185,Mus,1511,1486,25
76,30,213001860,30186,Nages-et-Solorgues,2072,2021,51
76,30,213001878,30187,Navacelles,312,304,8
76,30,213001886,30188,Ners,725,712,13
76,30,213001894,30189,Nîmes,149761,147496,2265
76,30,213001910,30191,Orsan,1211,1183,28
76,30,213001928,30192,Orthoux-Sérignac-Quilhan,447,435,12
76,30,213001936,30193,Parignargues,717,711,6
76,30,213001944,30194,Peyremale,280,277,3
76,30,213001951,30195,Peyrolles,37,34,3
76,30,213001969,30196,Le Pin,479,468,11
76,30,213001977,30197,Les Plans,292,284,8
76,30,213001985,30198,Les Plantiers,255,249,6
76,30,213001993,30199,Pommiers,56,55,1
76,30,213002009,30200,Pompignan,958,943,15
76,30,213002017,30201,Ponteils-et-Brésis,377,372,5
76,30,213002025,30202,Pont-Saint-Esprit,10660,10482,178
76,30,213002033,30203,Portes,333,330,3
76,30,213002041,30204,Potelières,363,358,5
76,30,213002058,30205,Pougnadoresse,252,248,4
76,30,213002066,30206,Poulx,4293,4171,122
76,30,213002074,30207,Pouzilhac,754,739,15
76,30,213002082,30208,Puechredon,46,46,0
76,30,213002090,30209,Pujaut,4014,3883,131
76,30,213002108,30210,Quissac,3366,3333,33
76,30,213002116,30211,Redessan,4196,4135,61
76,30,213002124,30212,Remoulins,2298,2255,43
76,30,213002132,30213,Revens,20,20,0
76,30,213002140,30214,Ribaute-les-Tavernes,2113,2066,47
76,30,213002157,30215,Rivières,409,406,3
76,30,213002165,30216,Robiac-Rochessadoule,848,834,14
76,30,213002173,30217,Rochefort-du-Gard,7983,7775,208
76,30,213002181,30218,Rochegude,258,253,5
76,30,213002199,30219,Rogues,108,106,2
76,30,213002207,30220,Roquedur,270,264,6
76,30,213002215,30221,Roquemaure,5598,5531,67
76,30,213002223,30222,La Roque-sur-Cèze,184,177,7
76,30,213002231,30223,Rousson,4440,4325,115
76,30,213002249,30224,La Rouvière,622,607,15
76,30,213002256,30225,Sabran,1662,1610,52
76,30,213002264,30226,Saint-Alexandre,1276,1245,31
76,30,213002272,30227,Saint-Ambroix,3366,3324,42
76,30,213002280,30228,Sainte-Anastasie,1773,1740,33
76,30,213002298,30229,Saint-André-de-Majencoules,612,603,9
76,30,213002306,30230,Saint-André-de-Roquepertuis,599,590,9
76,30,213002314,30231,Saint-André-de-Valborgne,372,361,11
76,30,213002322,30232,Saint-André-d'Olérargues,453,438,15
76,30,213002330,30233,Saint-Bauzély,670,660,10
76,30,213002348,30234,Saint-Bénézet,290,284,6
76,30,213002355,30235,Saint-Bonnet-du-Gard,863,851,12
76,30,213002363,30236,Saint-Bonnet-de-Salendrinque,118,115,3
76,30,213002371,30237,Saint-Brès,658,648,10
76,30,213002389,30238,Saint-Bresson,66,66,0
76,30,213002397,30239,Sainte-Cécile-d'Andorge,581,572,9
76,30,213002405,30240,Saint-Césaire-de-Gauzignan,391,388,3
76,30,213002413,30241,Saint-Chaptes,2010,1979,31
76,30,213002421,30242,Saint-Christol-de-Rodières,162,160,2
76,30,213002439,30243,Saint-Christol-lez-Alès,7291,7106,185
76,30,213002447,30244,Saint-Clément,360,354,6
76,30,213002454,30245,Saint-Côme-et-Maruéjols,814,800,14
76,30,213002462,30246,Sainte-Croix-de-Caderle,114,107,7
76,30,213002470,30247,Saint-Denis,301,292,9
76,30,213002488,30248,Saint-Dézéry,466,462,4
76,30,213002496,30249,Saint-Dionisy,1086,1073,13
76,30,213002504,30250,Saint-Étienne-de-l'Olm,408,401,7
76,30,213002512,30251,Saint-Étienne-des-Sorts,551,540,11
76,30,213002520,30252,Saint-Félix-de-Pallières,221,214,7
76,30,213002538,30253,Saint-Florent-sur-Auzonnet,1186,1169,17
76,30,213002546,30254,Saint-Geniès-de-Comolas,2038,1999,39
76,30,213002553,30255,Saint-Geniès-de-Malgoirès,3100,3067,33
76,30,213002561,30256,Saint-Gervais,797,781,16
76,30,213002579,30257,Saint-Gervasy,2023,1997,26
76,30,213002587,30258,Saint-Gilles,14313,14197,116
76,30,213002595,30259,Saint-Hilaire-de-Brethmas,4679,4598,81
76,30,213002603,30260,Saint-Hilaire-d'Ozilhan,1118,1096,22
76,30,213002611,30261,Saint-Hippolyte-de-Caton,254,249,5
76,30,213002629,30262,Saint-Hippolyte-de-Montaigu,265,253,12
76,30,213002637,30263,Saint-Hippolyte-du-Fort,3886,3752,134
76,30,213002645,30264,Saint-Jean-de-Ceyrargues,176,175,1
76,30,213002652,30265,Saint-Jean-de-Crieulon,243,241,2
76,30,213002660,30266,Saint-Jean-de-Maruéjols-et-Avéjan,863,852,11
76,30,213002678,30267,Saint-Jean-de-Serres,534,523,11
76,30,213002686,30268,Saint-Jean-de-Valériscle,620,605,15
76,30,213002694,30269,Saint-Jean-du-Gard,2605,2436,169
76,30,213002702,30270,Saint-Jean-du-Pin,1579,1539,40
76,30,213002710,30271,Saint-Julien-de-Cassagnas,742,727,15
76,30,213002728,30272,Saint-Julien-de-la-Nef,146,144,2
76,30,213002736,30273,Saint-Julien-de-Peyrolas,1467,1440,27
76,30,213002744,30274,Saint-Julien-les-Rosiers,3482,3417,65
76,30,213002751,30275,Saint-Just-et-Vacquières,327,322,5
76,30,213002769,30276,Saint-Laurent-d'Aigouze,3620,3576,44
76,30,213002777,30277,Saint-Laurent-de-Carnols,509,500,9
76,30,213002785,30278,Saint-Laurent-des-Arbres,3034,2968,66
76,30,213002793,30279,Saint-Laurent-la-Vernède,688,672,16
76,30,213002801,30280,Saint-Laurent-le-Minier,380,369,11
76,30,213002819,30281,Saint-Mamert-du-Gard,1673,1641,32
76,30,213002827,30282,Saint-Marcel-de-Careiret,886,867,19
76,30,213002835,30283,Saint-Martial,185,183,2
76,30,213002843,30284,Saint-Martin-de-Valgalgues,4654,4592,62
76,30,213002850,30285,Saint-Maurice-de-Cazevieille,775,756,19
76,30,213002868,30286,Saint-Maximin,796,778,18
76,30,213002876,30287,Saint-Michel-d'Euzet,675,664,11
76,30,213002884,30288,Saint-Nazaire,1289,1269,20
76,30,213002892,30289,Saint-Nazaire-des-Gardies,87,87,0
76,30,213002900,30290,Saint-Paulet-de-Caisson,1901,1840,61
76,30,213002918,30291,Saint-Paul-la-Coste,310,303,7
76,30,213002926,30292,Saint-Pons-la-Calm,480,467,13
76,30,213002934,30293,Saint-Privat-de-Champclos,354,349,5
76,30,213002942,30294,Saint-Privat-des-Vieux,5500,5373,127
76,30,213002959,30295,Saint-Quentin-la-Poterie,3111,3049,62
76,30,213002967,30296,Saint-Roman-de-Codières,162,156,6
76,30,213002975,30297,Saint-Sauveur-Camprieu,232,221,11
76,30,213002983,30298,Saint-Sébastien-d'Aigrefeuille,524,505,19
76,30,213002991,30299,Saint-Siffret,1161,1112,49
76,30,213003007,30300,Saint-Théodorit,552,541,11
76,30,213003015,30301,Saint-Victor-des-Oules,317,313,4
76,30,213003023,30302,Saint-Victor-la-Coste,2213,2166,47
76,30,213003031,30303,Saint-Victor-de-Malcap,865,844,21
76,30,213003049,30304,Salazac,191,188,3
76,30,213003056,30305,Salindres,3695,3651,44
76,30,213003064,30306,Salinelles,562,553,9
76,30,213003072,30307,Les Salles-du-Gardon,2532,2507,25
76,30,213003080,30308,Sanilhac-Sagriès,842,793,49
76,30,213003098,30309,Sardan,349,348,1
76,30,213003106,30310,Saumane,288,282,6
76,30,213003114,30311,Sauve,1915,1893,22
76,30,213003122,30312,Sauveterre,2091,2045,46
76,30,213003130,30313,Sauzet,783,776,7
76,30,213003148,30314,Savignargues,243,239,4
76,30,213003155,30315,Saze,2151,2112,39
76,30,213003163,30316,Sénéchas,248,242,6
76,30,213003171,30317,Sernhac,1798,1782,16
76,30,213003189,30318,Servas,211,207,4
76,30,213003197,30319,Serviers-et-Labaume,651,627,24
76,30,213003205,30320,Seynes,159,157,2
76,30,213003213,30321,Sommières,5109,5053,56
76,30,213003221,30322,Soudorgues,268,262,6
76,30,213003239,30323,Soustelle,123,121,2
76,30,213003247,30324,Souvignargues,898,883,15
76,30,213003254,30325,Sumène,1341,1308,33
76,30,213003262,30326,Tavel,2076,2029,47
76,30,213003270,30327,Tharaux,57,55,2
76,30,213003288,30328,Théziers,1054,1035,19
76,30,213003296,30329,Thoiras,446,438,8
76,30,213003304,30330,Tornac,973,947,26
76,30,213003312,30331,Tresques,1843,1803,40
76,30,213003320,30332,Trèves,112,111,1
76,30,213003338,30333,Uchaud,4586,4542,44
76,30,213003346,30334,Uzès,8721,8390,331
76,30,213003353,30335,Vabres,141,137,4
76,30,213003361,30336,Vallabrègues,1395,1375,20
76,30,213003379,30337,Vallabrix,423,417,6
76,30,213003387,30338,Vallérargues,141,139,2
76,30,200082725,30339,Val-d'Aigoual,1447,1419,28
76,30,213003403,30340,Valliguières,621,611,10
76,30,213003411,30341,Vauvert,11573,11465,108
76,30,213003429,30342,Vénéjan,1301,1261,40
76,30,213003437,30343,Verfeuil,608,600,8
76,30,213003445,30344,Vergèze,5536,5465,71
76,30,213003452,30345,La Vernarède,348,347,1
76,30,213003460,30346,Vers-Pont-du-Gard,1818,1785,33
76,30,213003478,30347,Vestric-et-Candiac,1381,1360,21
76,30,213003486,30348,Vézénobres,1927,1824,103
76,30,213003494,30349,Vic-le-Fesq,564,561,3
76,30,213003502,30350,Le Vigan,3824,3708,116
76,30,213003510,30351,Villeneuve-lès-Avignon,13249,12848,401
76,30,213003528,30352,Villevieille,1869,1832,37
76,30,213003536,30353,Vissec,68,67,1
76,30,213003544,30354,Montagnac,200,196,4
76,30,213003551,30355,Saint-Paul-les-Fonts,1050,1029,21
76,30,213003569,30356,Rodilhan,3000,2836,164
76,31,213100019,31001,Agassac,122,120,2
76,31,213100027,31002,Aignes,247,242,5
76,31,213100035,31003,Aigrefeuille,1300,1271,29
76,31,213100043,31004,Ayguesvives,2788,2721,67
76,31,213100050,31005,Alan,299,291,8
76,31,213100068,31006,Albiac,232,226,6
76,31,213100076,31007,Ambax,62,62,0
76,31,213100084,31008,Anan,261,258,3
76,31,213100092,31009,Antichan-de-Frontignes,189,187,2
76,31,213100100,31010,Antignac,91,90,1
76,31,213100118,31011,Arbas,282,273,9
76,31,213100126,31012,Arbon,99,97,2
76,31,213100134,31013,Ardiège,365,354,11
76,31,213100142,31014,Arguenos,90,86,4
76,31,213100159,31015,Argut-Dessous,23,22,1
76,31,213100175,31017,Arlos,104,102,2
76,31,213100183,31018,Arnaud-Guilhem,233,228,5
76,31,213100191,31019,Artigue,32,31,1
76,31,213100209,31020,Aspet,950,888,62
76,31,213100217,31021,Aspret-Sarrat,127,124,3
76,31,213100225,31022,Aucamville,9340,9245,95
76,31,213100233,31023,Aulon,318,311,7
76,31,213100241,31024,Auragne,423,418,5
76,31,213100258,31025,Aureville,985,969,16
76,31,213100266,31026,Auriac-sur-Vendinelle,1083,1062,21
76,31,213100274,31027,Auribail,203,198,5
76,31,213100282,31028,Aurignac,1312,1242,70
76,31,213100290,31029,Aurin,350,344,6
76,31,213100308,31030,Ausseing,81,80,1
76,31,213100316,31031,Ausson,610,592,18
76,31,213100324,31032,Aussonne,7348,7265,83
76,31,213100332,31033,Auterive,10062,9966,96
76,31,213100340,31034,Auzas,236,227,9
76,31,213100357,31035,Auzeville-Tolosane,4322,4075,247
76,31,213100365,31036,Auzielle,1635,1587,48
76,31,213100373,31037,Avignonet-Lauragais,1627,1615,12
76,31,213100381,31038,Azas,675,664,11
76,31,213100399,31039,Bachas,88,86,2
76,31,213100407,31040,Bachos,36,35,1
76,31,213100415,31041,Bagiry,114,112,2
76,31,213100423,31042,Bagnères-de-Luchon,2368,2222,146
76,31,213100431,31043,Balesta,143,137,6
76,31,213100449,31044,Balma,17300,17006,294
76,31,213100456,31045,Barbazan,508,498,10
76,31,213100464,31046,Baren,12,12,0
76,31,213100472,31047,Bax,94,93,1
76,31,213100480,31048,Baziège,3502,3456,46
76,31,213100498,31049,Bazus,606,592,14
76,31,213100506,31050,Beauchalot,652,645,7
76,31,213100514,31051,Beaufort,482,472,10
76,31,213100522,31052,Beaumont-sur-Lèze,1622,1590,32
76,31,213100530,31053,Beaupuy,1332,1302,30
76,31,213100548,31054,Beauteville,187,186,1
76,31,213100555,31055,Beauville,176,173,3
76,31,213100563,31056,Beauzelle,7216,7127,89
76,31,213100571,31057,Belberaud,1573,1520,53
76,31,213100589,31058,Belbèze-de-Lauragais,130,129,1
76,31,213100597,31059,Belbèze-en-Comminges,120,114,6
76,31,213100605,31060,Bélesta-en-Lauragais,114,109,5
76,31,213100613,31061,Bellegarde-Sainte-Marie,204,195,9
76,31,213100621,31062,Bellesserre,109,105,4
76,31,213100639,31063,Benque,170,168,2
76,31,213100647,31064,Benque-Dessous-et-Dessus,28,28,0
76,31,213100654,31065,Bérat,3123,3063,60
76,31,213100662,31066,Bessières,4258,4194,64
76,31,213100670,31067,Bezins-Garraux,41,41,0
76,31,213100688,31068,Billière,29,29,0
76,31,213100696,31069,Blagnac,26600,26101,499
76,31,213100704,31070,Blajan,454,446,8
76,31,213100712,31071,Bois-de-la-Pierre,456,447,9
76,31,213100720,31072,Boissède,70,68,2
76,31,213100738,31073,Bondigoux,741,720,21
76,31,213100746,31074,Bonrepos-Riquet,297,289,8
76,31,213100753,31075,Bonrepos-sur-Aussonnelle,1272,1249,23
76,31,213100761,31076,Bordes-de-Rivière,483,470,13
76,31,213100779,31077,Le Born,635,619,16
76,31,213100787,31078,Boudrac,149,147,2
76,31,213100795,31079,Bouloc,4845,4754,91
76,31,213100803,31080,Boulogne-sur-Gesse,1688,1654,34
76,31,213100811,31081,Bourg-d'Oueil,7,7,0
76,31,213100829,31082,Bourg-Saint-Bernard,1124,1110,14
76,31,213100837,31083,Boussan,236,234,2
76,31,213100845,31084,Boussens,1077,1054,23
76,31,213100852,31085,Boutx,256,253,3
76,31,213100860,31086,Bouzin,90,86,4
76,31,213100878,31087,Bragayrac,319,317,2
76,31,213100886,31088,Brax,2983,2887,96
76,31,213100894,31089,Bretx,693,675,18
76,31,213100902,31090,Brignemont,374,369,5
76,31,213100910,31091,Bruguières,6111,6005,106
76,31,213100928,31092,Burgalays,119,119,0
76,31,213100936,31093,Le Burgaud,954,943,11
76,31,213100944,31094,Buzet-sur-Tarn,2910,2859,51
76,31,213100951,31095,Cabanac-Cazaux,131,129,2
76,31,213100969,31096,Cabanac-Séguenville,181,179,2
76,31,213100977,31097,Le Cabanial,476,463,13
76,31,213100985,31098,Cadours,1121,1102,19
76,31,213100993,31099,Caignac,413,409,4
76,31,213101009,31100,Calmont,2403,2371,32
76,31,213101017,31101,Cambernard,481,477,4
76,31,213101025,31102,Cambiac,230,227,3
76,31,213101033,31103,Canens,58,58,0
76,31,213101041,31104,Capens,690,677,13
76,31,213101058,31105,Caragoudes,236,231,5
76,31,213101066,31106,Caraman,2586,2524,62
76,31,213101074,31107,Carbonne,5954,5841,113
76,31,213101082,31108,Cardeilhac,272,265,7
76,31,213101090,31109,Cassagnabère-Tournas,471,467,4
76,31,213101108,31110,Cassagne,659,645,14
76,31,213101116,31111,Castagnac,297,293,4
76,31,213101124,31112,Castagnède,194,189,5
76,31,213101132,31113,Castanet-Tolosan,14636,14377,259
76,31,213101140,31114,Castelbiague,244,241,3
76,31,213101157,31115,Castelgaillard,59,58,1
76,31,213101165,31116,Castelginest,10901,10784,117
76,31,213101173,31117,Castelmaurou,4508,4406,102
76,31,213101181,31118,Castelnau-d'Estrétefonds,6796,6689,107
76,31,213101199,31119,Castelnau-Picampeau,214,209,5
76,31,213101207,31120,Le Castéra,763,745,18
76,31,213101215,31121,Castéra-Vignoles,62,61,1
76,31,213101223,31122,Casties-Labrande,109,107,2
76,31,213101231,31123,Castillon-de-Larboust,77,76,1
76,31,213101249,31124,Castillon-de-Saint-Martory,401,392,9
76,31,213101256,31125,Cathervielle,36,36,0
76,31,213101264,31126,Caubiac,421,411,10
76,31,213101272,31127,Caubous,5,4,1
76,31,213101280,31128,Caujac,878,856,22
76,31,213101298,31129,Cazarilh-Laspènes,20,16,4
76,31,213101306,31130,Cazaril-Tambourès,88,85,3
76,31,213101314,31131,Cazaunous,70,69,1
76,31,213101322,31132,Cazaux-Layrisse,67,66,1
76,31,213101330,31133,Cazeaux-de-Larboust,106,102,4
76,31,213101348,31134,Cazeneuve-Montaut,85,85,0
76,31,213101355,31135,Cazères,4824,4753,71
76,31,213101363,31136,Cépet,2252,2224,28
76,31,213101371,31137,Cessales,158,158,0
76,31,213101389,31138,Charlas,255,250,5
76,31,213101397,31139,Chaum,201,195,6
76,31,213101405,31140,Chein-Dessus,191,187,4
76,31,213101413,31141,Ciadoux,222,220,2
76,31,213101421,31142,Cier-de-Luchon,240,234,6
76,31,213101439,31143,Cier-de-Rivière,279,274,5
76,31,213101447,31144,Cierp-Gaud,733,719,14
76,31,213101454,31145,Cintegabelle,3024,2959,65
76,31,213101462,31146,Cirès,14,14,0
76,31,213101470,31147,Clarac,680,668,12
76,31,213101488,31148,Clermont-le-Fort,535,518,17
76,31,213101496,31149,Colomiers,40342,39866,476
76,31,213101504,31150,Cornebarrieu,7827,7715,112
76,31,213101512,31151,Corronsac,899,871,28
76,31,213101520,31152,Coueilles,100,95,5
76,31,213101538,31153,Couladère,424,412,12
76,31,213101553,31155,Couret,232,229,3
76,31,213101561,31156,Cox,378,366,12
76,31,213101579,31157,Cugnaux,20358,20100,258
76,31,213101587,31158,Cuguron,181,174,7
76,31,213101595,31159,Le Cuing,480,476,4
76,31,213101603,31160,Daux,2468,2440,28
76,31,213101611,31161,Deyme,1324,1300,24
76,31,213101629,31162,Donneville,1203,1117,86
76,31,213101637,31163,Drémil-Lafage,2714,2649,65
76,31,213101645,31164,Drudas,207,201,6
76,31,213101652,31165,Eaunes,6547,6448,99
76,31,213101660,31166,Empeaux,295,291,4
76,31,213101678,31167,Encausse-les-Thermes,713,699,14
76,31,213101686,31168,Eoux,130,130,0
76,31,213101694,31169,Escalquens,7111,6982,129
76,31,213101702,31170,Escanecrabe,234,232,2
76,31,213101710,31171,Espanès,299,290,9
76,31,213101728,31172,Esparron,43,42,1
76,31,213101736,31173,Esperce,270,266,4
76,31,213101744,31174,Estadens,538,534,4
76,31,213101751,31175,Estancarbon,620,610,10
76,31,213101769,31176,Esténos,197,192,5
76,31,213101777,31177,Eup,137,135,2
76,31,213101785,31178,Fabas,204,200,4
76,31,213101793,31179,Le Faget,331,312,19
76,31,213101801,31180,Falga,149,143,6
76,31,213101819,31181,Le Fauga,2206,2178,28
76,31,213101827,31182,Fenouillet,5509,5462,47
76,31,213101835,31183,Figarol,323,315,8
76,31,213101843,31184,Flourens,2086,2048,38
76,31,213101850,31185,Folcarde,116,115,1
76,31,213101868,31186,Fonbeauzard,3022,2993,29
76,31,213101876,31187,Fonsorbes,12454,12119,335
76,31,213101884,31188,Fontenilles,6032,5872,160
76,31,213101892,31189,Forgues,227,223,4
76,31,213101900,31190,Fos,232,232,0
76,31,213101918,31191,Fougaron,101,100,1
76,31,213101926,31192,Fourquevaux,796,774,22
76,31,213101934,31193,Le Fousseret,1928,1895,33
76,31,213101942,31194,Francarville,176,174,2
76,31,213101959,31195,Francazal,30,30,0
76,31,213101967,31196,Francon,245,242,3
76,31,213101975,31197,Franquevielle,339,331,8
76,31,213101983,31198,Le Fréchet,106,103,3
76,31,213101991,31199,Fronsac,203,195,8
76,31,213102007,31200,Frontignan-de-Comminges,82,78,4
76,31,213102015,31201,Frontignan-Savès,73,71,2
76,31,213102023,31202,Fronton,6535,6413,122
76,31,213102031,31203,Frouzins,9546,9382,164
76,31,213102049,31204,Fustignac,81,79,2
76,31,213102056,31205,Gagnac-sur-Garonne,3192,3161,31
76,31,213102064,31206,Gaillac-Toulza,1335,1320,15
76,31,213102072,31207,Galié,87,81,6
76,31,213102080,31208,Ganties,325,320,5
76,31,213102098,31209,Garac,159,153,6
76,31,213102106,31210,Gardouch,1344,1312,32
76,31,213102114,31211,Gargas,711,703,8
76,31,213102122,31212,Garidech,1944,1918,26
76,31,213102130,31213,Garin,163,158,5
76,31,213102155,31215,Gauré,480,465,15
76,31,213102163,31216,Gémil,289,279,10
76,31,213102171,31217,Génos,72,71,1
76,31,213102189,31218,Gensac-de-Boulogne,117,113,4
76,31,213102197,31219,Gensac-sur-Garonne,452,448,4
76,31,213102205,31220,Gibel,388,383,5
76,31,213102213,31221,Gouaux-de-Larboust,57,56,1
76,31,213102221,31222,Gouaux-de-Luchon,46,45,1
76,31,213102239,31223,Goudex,42,41,1
76,31,213102247,31224,Gourdan-Polignan,1365,1182,183
76,31,213102254,31225,Goutevernisse,188,185,3
76,31,213102262,31226,Gouzens,86,81,5
76,31,213102270,31227,Goyrans,880,843,37
76,31,213102288,31228,Gragnague,2189,2141,48
76,31,213102296,31229,Gratens,724,706,18
76,31,213102304,31230,Gratentour,4583,4501,82
76,31,213102312,31231,Grazac,752,743,9
76,31,213102320,31232,Grenade,9016,8846,170
76,31,213102338,31233,Grépiac,1036,1003,33
76,31,213102346,31234,Le Grès,451,443,8
76,31,213102353,31235,Guran,49,49,0
76,31,213102361,31236,Herran,72,71,1
76,31,213102379,31237,His,265,236,29
76,31,213102387,31238,Huos,492,482,10
76,31,213102395,31239,L'Isle-en-Dodon,1662,1636,26
76,31,213102403,31240,Issus,628,620,8
76,31,213102411,31241,Izaut-de-l'Hôtel,300,295,5
76,31,213102429,31242,Jurvielle,19,17,2
76,31,213102437,31243,Juzes,71,67,4
76,31,213102445,31244,Juzet-de-Luchon,395,378,17
76,31,213102452,31245,Juzet-d'Izaut,193,188,5
76,31,213102460,31246,Labarthe-Inard,882,867,15
76,31,213102478,31247,Labarthe-Rivière,1327,1299,28
76,31,213102486,31248,Labarthe-sur-Lèze,6479,6364,115
76,31,213102494,31249,Labastide-Beauvoir,1274,1248,26
76,31,213102502,31250,Labastide-Clermont,697,680,17
76,31,213102510,31251,Labastide-Paumès,148,147,1
76,31,213102528,31252,Labastide-Saint-Sernin,2000,1954,46
76,31,213102536,31253,Labastidette,2981,2940,41
76,31,213102544,31254,Labège,4268,4122,146
76,31,213102551,31255,Labroquère,332,322,10
76,31,213102569,31256,Labruyère-Dorsa,299,293,6
76,31,213102585,31258,Lacaugne,248,242,6
76,31,213102593,31259,Lacroix-Falgarde,2138,2089,49
76,31,213102601,31260,Laffite-Toupière,99,98,1
76,31,213102619,31261,Lafitte-Vigordane,1245,1201,44
76,31,213102627,31262,Lagarde,440,429,11
76,31,213102635,31263,Lagardelle-sur-Lèze,3288,3231,57
76,31,213102643,31264,Lagrâce-Dieu,570,563,7
76,31,213102650,31265,Lagraulet-Saint-Nicolas,262,256,6
76,31,213102668,31266,Lahage,197,196,1
76,31,213102676,31267,Lahitère,64,62,2
76,31,213102684,31268,Lalouret-Laffiteau,138,135,3
76,31,213102692,31269,Lamasquère,1581,1558,23
76,31,213102700,31270,Landorthe,1047,1018,29
76,31,213102718,31271,Lanta,2239,2197,42
76,31,213102726,31272,Lapeyrère,66,63,3
76,31,213102734,31273,Lapeyrouse-Fossat,2989,2919,70
76,31,213102742,31274,Larcan,190,185,5
76,31,213102759,31275,Laréole,166,161,5
76,31,213102767,31276,Larroque,294,289,5
76,31,200077451,31277,Lasserre-Pradère,1666,1622,44
76,31,213102783,31278,Latoue,317,313,4
76,31,213102791,31279,Latour,77,76,1
76,31,213102809,31280,Latrape,403,395,8
76,31,213102817,31281,Launac,1355,1323,32
76,31,213102825,31282,Launaguet,9425,9309,116
76,31,213102833,31283,Lautignac,263,260,3
76,31,213102841,31284,Lauzerville,1709,1653,56
76,31,213102858,31285,Lavalette,786,773,13
76,31,213102866,31286,Lavelanet-de-Comminges,635,628,7
76,31,213102874,31287,Lavernose-Lacasse,3482,3394,88
76,31,213102882,31288,Layrac-sur-Tarn,326,317,9
76,31,213102890,31289,Lécussan,287,284,3
76,31,213102908,31290,Lège,36,33,3
76,31,213102916,31291,Léguevin,9615,9361,254
76,31,213102924,31292,Lescuns,74,73,1
76,31,213102932,31293,Lespinasse,2884,2862,22
76,31,213102940,31294,Lespiteau,86,85,1
76,31,213102957,31295,Lespugue,86,86,0
76,31,213102965,31296,Lestelle-de-Saint-Martory,446,435,11
76,31,213102973,31297,Lévignac,2249,2206,43
76,31,213102999,31299,Lherm,3887,3804,83
76,31,200014512,31300,Lieoux,130,127,3
76,31,213103013,31301,Lilhac,130,129,1
76,31,213103021,31302,Lodes,302,295,7
76,31,213103039,31303,Longages,3250,3213,37
76,31,213103047,31304,Loubens-Lauragais,463,452,11
76,31,213103054,31305,Loudet,205,199,6
76,31,213103062,31306,Lourde,93,93,0
76,31,213103088,31308,Luscan,47,47,0
76,31,213103096,31309,Lussan-Adeilhac,234,232,2
76,31,213103104,31310,Lux,345,340,5
76,31,213103112,31311,La Magdelaine-sur-Tarn,1222,1200,22
76,31,213103120,31312,Mailholas,36,35,1
76,31,213103138,31313,Malvezie,110,108,2
76,31,213103146,31314,Mancioux,385,378,7
76,31,213103153,31315,Mane,1006,958,48
76,31,213103161,31316,Marignac,503,497,6
76,31,213103179,31317,Marignac-Lasclares,474,465,9
76,31,213103187,31318,Marignac-Laspeyres,205,200,5
76,31,213103195,31319,Marliac,136,135,1
76,31,213103203,31320,Marquefave,992,951,41
76,31,213103211,31321,Marsoulas,137,130,7
76,31,213103229,31322,Martisserre,68,66,2
76,31,213103237,31323,Martres-de-Rivière,383,373,10
76,31,213103245,31324,Martres-Tolosane,2450,2407,43
76,31,213103252,31325,Mascarville,190,185,5
76,31,213103260,31326,Massabrac,98,98,0
76,31,213103278,31327,Mauran,206,205,1
76,31,213103286,31328,Mauremont,332,322,10
76,31,213103294,31329,Maurens,211,208,3
76,31,213103302,31330,Mauressac,511,500,11
76,31,213103310,31331,Maureville,317,305,12
76,31,213103328,31332,Mauvaisin,218,214,4
76,31,213103336,31333,Mauvezin,90,87,3
76,31,213103344,31334,Mauzac,1351,1327,24
76,31,213103351,31335,Mayrègne,27,27,0
76,31,213103369,31336,Mazères-sur-Salat,649,637,12
76,31,213103377,31337,Melles,91,90,1
76,31,213103385,31338,Menville,811,788,23
76,31,213103393,31339,Mérenvielle,497,491,6
76,31,213103401,31340,Mervilla,299,290,9
76,31,213103419,31341,Merville,6329,6241,88
76,31,213103427,31342,Milhas,182,179,3
76,31,213103435,31343,Mirambeau,61,61,0
76,31,213103443,31344,Miramont-de-Comminges,772,759,13
76,31,213103450,31345,Miremont,2724,2687,37
76,31,213103468,31346,Mirepoix-sur-Tarn,1133,1114,19
76,31,213103476,31347,Molas,169,166,3
76,31,213103484,31348,Moncaup,36,36,0
76,31,213103492,31349,Mondavezan,928,911,17
76,31,213103500,31350,Mondilhan,82,81,1
76,31,213103518,31351,Mondonville,5582,5483,99
76,31,213103526,31352,Mondouzil,230,219,11
76,31,213103534,31353,Monès,84,84,0
76,31,213103542,31354,Monestrol,51,51,0
76,31,213103559,31355,Mons,1833,1789,44
76,31,213103567,31356,Montaigut-sur-Save,1945,1897,48
76,31,213103575,31357,Montastruc-de-Salies,314,310,4
76,31,213103583,31358,Montastruc-la-Conseillère,3720,3616,104
76,31,213103591,31359,Montastruc-Savès,68,66,2
76,31,213103609,31360,Montauban-de-Luchon,529,521,8
76,31,213103617,31361,Montaut,517,512,5
76,31,213103625,31362,Montberaud,205,199,6
76,31,213103633,31363,Montbernard,220,215,5
76,31,213103641,31364,Montberon,3156,3099,57
76,31,213103658,31365,Montbrun-Bocage,515,506,9
76,31,213103666,31366,Montbrun-Lauragais,701,679,22
76,31,213103674,31367,Montclar-de-Comminges,79,74,5
76,31,213103682,31368,Montclar-Lauragais,253,240,13
76,31,213103690,31369,Mont-de-Galié,40,36,4
76,31,213103708,31370,Montégut-Bourjac,138,138,0
76,31,213103716,31371,Montégut-Lauragais,433,418,15
76,31,213103724,31372,Montespan,469,460,9
76,31,213103732,31373,Montesquieu-Guittaut,182,177,5
76,31,213103740,31374,Montesquieu-Lauragais,1038,1025,13
76,31,213103757,31375,Montesquieu-Volvestre,3160,3109,51
76,31,213103765,31376,Montgaillard-de-Salies,108,105,3
76,31,213103773,31377,Montgaillard-Lauragais,704,695,9
76,31,213103781,31378,Montgaillard-sur-Save,81,77,4
76,31,213103799,31379,Montgazin,171,169,2
76,31,213103807,31380,Montgeard,533,525,8
76,31,213103815,31381,Montgiscard,2623,2561,62
76,31,213103823,31382,Montgras,113,111,2
76,31,213103831,31383,Montjoire,1325,1299,26
76,31,213103849,31384,Montlaur,1827,1791,36
76,31,213103856,31385,Montmaurin,202,197,5
76,31,213103864,31386,Montoulieu-Saint-Bernard,223,217,6
76,31,213103872,31387,Montoussin,129,129,0
76,31,213103880,31388,Montpitol,383,371,12
76,31,213103898,31389,Montrabé,4176,4099,77
76,31,213103906,31390,Montréjeau,2758,2726,32
76,31,213103914,31391,Montsaunès,485,454,31
76,31,213103922,31392,Mourvilles-Basses,84,80,4
76,31,213103930,31393,Mourvilles-Hautes,171,166,5
76,31,213103948,31394,Moustajon,129,126,3
76,31,213103955,31395,Muret,25336,24762,574
76,31,213103963,31396,Nailloux,4019,3955,64
76,31,213103971,31397,Nénigan,53,52,1
76,31,213103989,31398,Nizan-Gesse,97,96,1
76,31,213103997,31399,Noé,3001,2938,63
76,31,213104003,31400,Nogaret,93,93,0
76,31,213104011,31401,Noueilles,395,389,6
76,31,213104029,31402,Odars,939,908,31
76,31,213104037,31403,Ondes,908,775,133
76,31,213104045,31404,Oô,106,102,4
76,31,213104052,31405,Ore,124,121,3
76,31,213104060,31406,Palaminy,824,814,10
76,31,213104078,31407,Paulhac,1270,1241,29
76,31,213104086,31408,Payssous,86,86,0
76,31,213104094,31409,Péchabou,2418,2363,55
76,31,213104102,31410,Pechbonnieu,4714,4624,90
76,31,213104110,31411,Pechbusque,1020,996,24
76,31,200064210,31412,Péguilhan,271,263,8
76,31,213104136,31413,Pelleport,538,520,18
76,31,213104144,31414,Peyrissas,79,77,2
76,31,213104151,31415,Peyrouzet,82,80,2
76,31,213104169,31416,Peyssies,627,619,8
76,31,213104177,31417,Pibrac,8776,8523,253
76,31,213104185,31418,Pin-Balma,987,954,33
76,31,213104193,31419,Le Pin-Murelet,176,172,4
76,31,213104201,31420,Pinsaguel,2866,2829,37
76,31,213104219,31421,Pins-Justaret,4411,4335,76
76,31,213104227,31422,Plagne,94,94,0
76,31,213104235,31423,Plagnole,321,318,3
76,31,213104243,31424,Plaisance-du-Touch,19904,19462,442
76,31,213104250,31425,Le Plan,449,439,10
76,31,213104268,31426,Pointis-de-Rivière,869,857,12
76,31,213104276,31427,Pointis-Inard,953,934,19
76,31,213104284,31428,Polastron,55,53,2
76,31,213104292,31429,Pompertuzat,2333,2298,35
76,31,213104300,31430,Ponlat-Taillebourg,616,600,16
76,31,213104318,31431,Portet-d'Aspet,60,59,1
76,31,213104326,31432,Portet-de-Luchon,42,39,3
76,31,213104334,31433,Portet-sur-Garonne,9955,9832,123
76,31,213104342,31434,Poubeau,83,79,4
76,31,213104359,31435,Poucharramet,970,956,14
76,31,213104367,31436,Pouy-de-Touges,424,419,5
76,31,213104375,31437,Pouze,87,83,4
76,31,213104391,31439,Préserville,740,723,17
76,31,213104409,31440,Proupiary,70,69,1
76,31,213104417,31441,Prunet,153,149,4
76,31,213104425,31442,Puydaniel,565,555,10
76,31,213104433,31443,Puymaurin,304,297,7
76,31,213104441,31444,Puysségur,139,135,4
76,31,213104458,31445,Quint-Fonsegrives,6038,5950,88
76,31,213104466,31446,Ramonville-Saint-Agne,15017,14730,287
76,31,213104474,31447,Razecueillé,35,34,1
76,31,213104482,31448,Rebigue,500,475,25
76,31,213104490,31449,Régades,141,137,4
76,31,213104508,31450,Renneville,556,543,13
76,31,213104516,31451,Revel,9947,9652,295
76,31,213104524,31452,Rieucazé,58,58,0
76,31,213104532,31453,Rieumajou,142,137,5
76,31,213104540,31454,Rieumes,3746,3659,87
76,31,213104557,31455,Rieux-Volvestre,2684,2627,57
76,31,213104565,31456,Riolas,53,52,1
76,31,213104573,31457,Roquefort-sur-Garonne,807,794,13
76,31,213104581,31458,Roques,4993,4939,54
76,31,213104599,31459,Roquesérière,782,763,19
76,31,213104607,31460,Roquettes,4365,4294,71
76,31,213104615,31461,Rouède,291,288,3
76,31,213104623,31462,Rouffiac-Tolosan,2031,1989,42
76,31,213104631,31463,Roumens,254,250,4
76,31,213104649,31464,Sabonnères,336,327,9
76,31,213104656,31465,Saccourvielle,20,20,0
76,31,213104664,31466,Saiguède,824,807,17
76,31,213104672,31467,Saint-Alban,6319,6269,50
76,31,213104680,31468,Saint-André,245,237,8
76,31,213104698,31469,Saint-Araille,132,129,3
76,31,213104706,31470,Saint-Aventin,66,62,4
76,31,200081198,31471,Saint-Béat-Lez,386,383,3
76,31,213104722,31472,Saint-Bertrand-de-Comminges,242,237,5
76,31,213104730,31473,Saint-Cézert,437,436,1
76,31,213104748,31474,Saint-Christaud,242,237,5
76,31,213104755,31475,Saint-Clar-de-Rivière,1526,1495,31
76,31,213104763,31476,Saint-Élix-le-Château,942,921,21
76,31,213104771,31477,Saint-Élix-Séglan,43,43,0
76,31,213104789,31478,Saint-Félix-Lauragais,1297,1261,36
76,31,213104797,31479,Saint-Ferréol-de-Comminges,62,61,1
76,31,213104805,31480,Sainte-Foy-d'Aigrefeuille,2381,2312,69
76,31,213104813,31481,Sainte-Foy-de-Peyrolières,2149,2101,48
76,31,213104821,31482,Saint-Frajou,216,214,2
76,31,213104839,31483,Saint-Gaudens,12204,11664,540
76,31,213104847,31484,Saint-Geniès-Bellevue,2571,2512,59
76,31,213104854,31485,Saint-Germier,120,118,2
76,31,213104862,31486,Saint-Hilaire,1596,1571,25
76,31,213104870,31487,Saint-Ignan,234,229,5
76,31,213104888,31488,Saint-Jean,11259,11114,145
76,31,213104896,31489,Saint-Jean-Lherm,406,394,12
76,31,213104904,31490,Saint-Jory,6853,6777,76
76,31,213104912,31491,Saint-Julia,424,413,11
76,31,213104920,31492,Saint-Julien-sur-Garonne,558,551,7
76,31,213104938,31493,Saint-Lary-Boujean,133,127,6
76,31,213104946,31494,Saint-Laurent,179,178,1
76,31,213104953,31495,Saint-Léon,1313,1300,13
76,31,213104961,31496,Sainte-Livrade,271,258,13
76,31,213104979,31497,Saint-Loup-Cammas,2363,2315,48
76,31,213104987,31498,Saint-Loup-en-Comminges,38,38,0
76,31,213104995,31499,Saint-Lys,9737,9555,182
76,31,213105000,31500,Saint-Mamet,572,554,18
76,31,213105018,31501,Saint-Marcel-Paulel,446,439,7
76,31,213105026,31502,Saint-Marcet,371,362,9
76,31,213105034,31503,Saint-Martory,1067,1056,11
76,31,213105042,31504,Saint-Médard,240,224,16
76,31,213105059,31505,Saint-Michel,322,316,6
76,31,213105067,31506,Saint-Orens-de-Gameville,13401,13163,238
76,31,213105075,31507,Saint-Paul-sur-Save,1640,1615,25
76,31,213105083,31508,Saint-Paul-d'Oueil,36,34,2
76,31,213105091,31509,Saint-Pé-d'Ardet,162,159,3
76,31,213105109,31510,Saint-Pé-Delbosc,143,143,0
76,31,213105117,31511,Saint-Pierre,255,247,8
76,31,213105125,31512,Saint-Pierre-de-Lages,923,896,27
76,31,213105133,31513,Saint-Plancard,401,393,8
76,31,213105141,31514,Saint-Rome,60,59,1
76,31,213105158,31515,Saint-Rustice,440,431,9
76,31,213105166,31516,Saint-Sauveur,1974,1940,34
76,31,213105174,31517,Saint-Sulpice-sur-Lèze,2354,2293,61
76,31,213105182,31518,Saint-Thomas,608,592,16
76,31,213105190,31519,Saint-Vincent,214,206,8
76,31,213105208,31520,Sajas,118,116,2
76,31,213105216,31521,Saleich,353,338,15
76,31,213105224,31522,Salerm,62,60,2
76,31,213105232,31523,Salies-du-Salat,1860,1755,105
76,31,213105240,31524,Salles-et-Pratviel,129,127,2
76,31,213105257,31525,Salles-sur-Garonne,606,592,14
76,31,213105265,31526,La Salvetat-Saint-Gilles,8694,8497,197
76,31,213105273,31527,La Salvetat-Lauragais,154,151,3
76,31,213105281,31528,Saman,131,130,1
76,31,213105299,31529,Samouillan,113,111,2
76,31,213105307,31530,Sana,250,245,5
76,31,213105315,31531,Sarrecave,78,78,0
76,31,213105323,31532,Sarremezan,91,91,0
76,31,213105331,31533,Saubens,2377,2324,53
76,31,213105349,31534,Saussens,211,211,0
76,31,213105356,31535,Sauveterre-de-Comminges,724,706,18
76,31,213105364,31536,Saux-et-Pomarède,257,249,8
76,31,213105372,31537,Savarthès,189,185,4
76,31,213105380,31538,Savères,226,222,4
76,31,213105398,31539,Sédeilhac,66,63,3
76,31,213105406,31540,Ségreville,339,331,8
76,31,213105414,31541,Seilh,3361,3287,74
76,31,213105422,31542,Seilhan,216,209,7
76,31,213105430,31543,Sénarens,120,118,2
76,31,213105448,31544,Sengouagnet,221,219,2
76,31,213105455,31545,Sepx,211,207,4
76,31,213105463,31546,Seyre,130,128,2
76,31,213105471,31547,Seysses,9854,9725,129
76,31,213105489,31548,Signac,47,47,0
76,31,213105497,31549,Sode,21,21,0
76,31,213105505,31550,Soueich,535,520,15
76,31,213105513,31551,Tarabel,597,579,18
76,31,213105521,31552,Terrebasse,143,139,4
76,31,213105539,31553,Thil,1166,1141,25
76,31,213105547,31554,Touille,247,241,6
76,31,213105554,31555,Toulouse,503020,498003,5017
76,31,213105562,31556,Les Tourreilles,386,377,9
76,31,213105570,31557,Tournefeuille,29405,28763,642
76,31,213105588,31558,Toutens,409,402,7
76,31,213105596,31559,Trébons-de-Luchon,7,7,0
76,31,213105604,31560,Trébons-sur-la-Grasse,478,470,8
76,31,213105612,31561,L'Union,12511,12339,172
76,31,213105620,31562,Urau,119,118,1
76,31,213105638,31563,Vacquiers,1370,1334,36
76,31,213105646,31564,Valcabrère,147,144,3
76,31,213105653,31565,Valentine,892,878,14
76,31,213105661,31566,Vallègue,521,517,4
76,31,213105679,31567,Vallesvilles,447,441,6
76,31,213105687,31568,Varennes,274,267,7
76,31,213105695,31569,Vaudreuille,394,384,10
76,31,213105703,31570,Vaux,313,308,5
76,31,213105711,31571,Vendine,294,290,4
76,31,213105729,31572,Venerque,2836,2747,89
76,31,213105737,31573,Verfeil,3792,3727,65
76,31,213105745,31574,Vernet,3175,3138,37
76,31,213105752,31575,Vieille-Toulouse,1250,1211,39
76,31,213105760,31576,Vieillevigne,365,358,7
76,31,213105778,31577,Vignaux,146,146,0
76,31,213105786,31578,Vigoulet-Auzil,999,967,32
76,31,213105794,31579,Villariès,809,796,13
76,31,213105802,31580,Villate,1117,1094,23
76,31,213105810,31581,Villaudric,1631,1599,32
76,31,213105828,31582,Villefranche-de-Lauragais,4916,4848,68
76,31,213105836,31583,Villematier,1115,1090,25
76,31,213105844,31584,Villemur-sur-Tarn,6184,6105,79
76,31,213105851,31585,Villeneuve-de-Rivière,1786,1756,30
76,31,213105869,31586,Villeneuve-Lécussan,566,562,4
76,31,213105877,31587,Villeneuve-lès-Bouloc,1640,1629,11
76,31,213105885,31588,Villeneuve-Tolosane,10238,10112,126
76,31,213105893,31589,Villenouvelle,1457,1438,19
76,31,213105901,31590,Binos,45,45,0
76,31,213105919,31591,Escoulis,80,79,1
76,31,213105927,31592,Larra,2152,2114,38
76,31,213105935,31593,Cazac,85,85,0
76,32,213200017,32001,Aignan,769,722,47
76,32,213200025,32002,Ansan,82,77,5
76,32,213200033,32003,Antras,47,44,3
76,32,213200041,32004,Arblade-le-Bas,136,133,3
76,32,213200058,32005,Arblade-le-Haut,334,328,6
76,32,213200074,32007,Ardizas,226,221,5
76,32,213200082,32008,Armentieux,73,73,0
76,32,213200090,32009,Armous-et-Cau,93,92,1
76,32,213200108,32010,Arrouède,89,89,0
76,32,213200124,32012,Aubiet,1147,1119,28
76,32,213200132,32013,Auch,23624,22518,1106
76,32,213200140,32014,Augnax,119,114,5
76,32,213200157,32015,Aujan-Mournède,91,90,1
76,32,213200165,32016,Auradé,689,673,16
76,32,213200173,32017,Aurensan,138,133,5
76,32,213200181,32018,Aurimont,217,214,3
76,32,213200199,32019,Auterive,537,521,16
76,32,213200207,32020,Aux-Aussat,284,275,9
76,32,213200215,32021,Avensac,76,75,1
76,32,213200223,32022,Avéron-Bergelle,183,176,7
76,32,213200231,32023,Avezan,105,104,1
76,32,213200249,32024,Ayguetinte,162,159,3
76,32,213200256,32025,Ayzieu,162,160,2
76,32,213200264,32026,Bajonnette,111,111,0
76,32,213200272,32027,Barcelonne-du-Gers,1406,1367,39
76,32,213200280,32028,Barcugnan,107,104,3
76,32,213200298,32029,Barran,684,664,20
76,32,213200306,32030,Bars,132,129,3
76,32,213200314,32031,Bascous,174,172,2
76,32,213200322,32032,Bassoues,333,323,10
76,32,213200330,32033,Bazian,109,109,0
76,32,213200348,32034,Bazugues,56,56,0
76,32,213200355,32035,Beaucaire,242,239,3
76,32,213200363,32036,Beaumarchés,697,657,40
76,32,213200371,32037,Beaumont,135,128,7
76,32,213200389,32038,Beaupuy,216,208,8
76,32,213200397,32039,Beccas,123,120,3
76,32,213200405,32040,Bédéchan,138,137,1
76,32,213200413,32041,Bellegarde,169,165,4
76,32,213200421,32042,Belloc-Saint-Clamens,143,139,4
76,32,213200439,32043,Belmont,155,151,4
76,32,213200447,32044,Béraut,310,302,8
76,32,213200454,32045,Berdoues,435,416,19
76,32,213200462,32046,Bernède,205,199,6
76,32,213200470,32047,Berrac,113,112,1
76,32,213200488,32048,Betcave-Aguin,90,90,0
76,32,213200496,32049,Bétous,76,73,3
76,32,213200504,32050,Betplan,100,95,5
76,32,213200512,32051,Bézéril,129,122,7
76,32,213200520,32052,Bezolles,142,138,4
76,32,213200538,32053,Bézues-Bajon,192,192,0
76,32,213200546,32054,Biran,390,381,9
76,32,213200553,32055,Bivès,136,134,2
76,32,213200561,32056,Blanquefort,49,45,4
76,32,213200579,32057,Blaziert,132,130,2
76,32,213200587,32058,Blousson-Sérian,41,39,2
76,32,213200595,32059,Bonas,138,136,2
76,32,213200603,32060,Boucagnères,218,215,3
76,32,213200611,32061,Boulaur,190,187,3
76,32,213200629,32062,Bourrouillan,170,166,4
76,32,213200637,32063,Bouzon-Gellenave,173,165,8
76,32,213200645,32064,Bretagne-d'Armagnac,408,397,11
76,32,213200652,32065,Le Brouilh-Monbert,250,244,6
76,32,213200660,32066,Brugnens,255,253,2
76,32,213200678,32067,Cabas-Loumassès,51,50,1
76,32,213200686,32068,Cadeilhan,139,136,3
76,32,213200694,32069,Cadeillan,71,68,3
76,32,213200702,32070,Cahuzac-sur-Adour,210,207,3
76,32,213200710,32071,Caillavet,187,178,9
76,32,213200728,32072,Callian,51,50,1
76,32,213200736,32073,Campagne-d'Armagnac,218,214,4
76,32,213200751,32075,Cassaigne,236,232,4
76,32,213200769,32076,Castelnau-Barbarens,557,547,10
76,32,213200777,32077,Castelnau-d'Anglès,88,86,2
76,32,213200785,32078,Castelnau-d'Arbieu,240,231,9
76,32,200057586,32079,Castelnau d'Auzan Labarrère,1217,1197,20
76,32,213200801,32080,Castelnau-sur-l'Auvignon,147,145,2
76,32,213200819,32081,Castelnavet,133,131,2
76,32,213200827,32082,Castéra-Lectourois,360,354,6
76,32,213200835,32083,Castéra-Verduzan,1038,1015,23
76,32,213200843,32084,Castéron,54,52,2
76,32,213200850,32085,Castet-Arrouy,180,173,7
76,32,213200868,32086,Castex,79,77,2
76,32,213200876,32087,Castex-d'Armagnac,131,127,4
76,32,213200884,32088,Castillon-Debats,324,324,0
76,32,213200892,32089,Castillon-Massas,245,240,5
76,32,213200900,32090,Castillon-Savès,347,339,8
76,32,213200918,32091,Castin,378,361,17
76,32,213200926,32092,Catonvielle,97,96,1
76,32,213200934,32093,Caumont,110,103,7
76,32,213200942,32094,Caupenne-d'Armagnac,446,435,11
76,32,213200959,32095,Caussens,605,592,13
76,32,213200967,32096,Cazaubon,1705,1670,35
76,32,213200975,32097,Cazaux-d'Anglès,119,114,5
76,32,213200983,32098,Cazaux-Savès,333,328,5
76,32,213200991,32099,Cazaux-Villecomtal,74,72,2
76,32,213201007,32100,Cazeneuve,166,162,4
76,32,213201015,32101,Céran,232,229,3
76,32,213201023,32102,Cézan,223,219,4
76,32,213201031,32103,Chélan,176,168,8
76,32,213201049,32104,Clermont-Pouyguillès,163,160,3
76,32,213201056,32105,Clermont-Savès,425,414,11
76,32,213201064,32106,Cologne,997,928,69
76,32,213201072,32107,Condom,6670,6478,192
76,32,213201080,32108,Corneillan,164,154,10
76,32,213201098,32109,Couloumé-Mondebat,201,196,5
76,32,213201106,32110,Courrensan,402,397,5
76,32,213201114,32111,Courties,49,49,0
76,32,213201122,32112,Crastes,259,255,4
76,32,213201130,32113,Cravencères,91,89,2
76,32,213201148,32114,Cuélas,127,124,3
76,32,213201155,32115,Dému,328,325,3
76,32,213201163,32116,Duffort,154,150,4
76,32,213201171,32117,Duran,882,854,28
76,32,213201189,32118,Durban,141,137,4
76,32,213201197,32119,Eauze,4069,3998,71
76,32,213201205,32120,Encausse,438,431,7
76,32,213201213,32121,Endoufielle,521,505,16
76,32,213201221,32122,Esclassan-Labastide,357,346,11
76,32,213201239,32123,Escorneboeuf,578,566,12
76,32,213201247,32124,Espaon,186,186,0
76,32,213201254,32125,Espas,126,125,1
76,32,213201262,32126,Estampes,163,162,1
76,32,213201270,32127,Estang,678,665,13
76,32,213201288,32128,Estipouy,219,207,12
76,32,213201296,32129,Estramiac,140,140,0
76,32,213201304,32130,Faget-Abbatial,219,218,1
76,32,213201312,32131,Flamarens,152,150,2
76,32,213201320,32132,Fleurance,6001,5890,111
76,32,213201338,32133,Fourcès,264,262,2
76,32,213201346,32134,Frégouville,346,339,7
76,32,213201353,32135,Fustérouau,140,135,5
76,32,213201361,32136,Galiax,182,177,5
76,32,213201387,32138,Garravet,156,152,4
76,32,213201395,32139,Gaudonville,111,110,1
76,32,213201403,32140,Gaujac,72,72,0
76,32,213201411,32141,Gaujan,114,114,0
76,32,213201429,32142,Gavarret-sur-Aulouste,142,139,3
76,32,213201437,32143,Gazaupouy,275,264,11
76,32,213201445,32144,Gazax-et-Baccarisse,72,72,0
76,32,213201452,32145,Gée-Rivière,48,46,2
76,32,213201460,32146,Gimbrède,276,272,4
76,32,213201478,32147,Gimont,3078,3008,70
76,32,213201486,32148,Giscaro,104,104,0
76,32,213201494,32149,Gondrin,1233,1201,32
76,32,213201502,32150,Goutz,219,213,6
76,32,213201510,32151,Goux,63,62,1
76,32,213201528,32152,Haget,343,332,11
76,32,213201536,32153,Haulies,169,163,6
76,32,213201544,32154,Homps,111,110,1
76,32,213201551,32155,Le Houga,1209,1158,51
76,32,213201569,32156,Idrac-Respaillès,220,215,5
76,32,213201577,32157,L'Isle-Arné,196,193,3
76,32,213201585,32158,L'Isle-Bouzon,251,241,10
76,32,213201593,32159,L'Isle-de-Noé,566,552,14
76,32,213201601,32160,L'Isle-Jourdain,9454,9227,227
76,32,213201619,32161,Izotges,93,89,4
76,32,213201627,32162,Jegun,1210,1164,46
76,32,213201635,32163,Jû-Belloc,301,291,10
76,32,213201643,32164,Juillac,119,117,2
76,32,213201650,32165,Juilles,226,222,4
76,32,213201668,32166,Justian,121,116,5
76,32,213201676,32167,Laas,317,312,5
76,32,213201692,32169,Labarthe,152,148,4
76,32,213201700,32170,Labarthète,144,141,3
76,32,213201718,32171,Labastide-Savès,182,180,2
76,32,213201726,32172,Labéjan,310,294,16
76,32,213201734,32173,Labrihe,223,215,8
76,32,213201742,32174,Ladevèze-Rivière,224,220,4
76,32,213201759,32175,Ladevèze-Ville,224,217,7
76,32,213201767,32176,Lagarde,127,122,5
76,32,213201775,32177,Lagarde-Hachan,172,167,5
76,32,213201783,32178,Lagardère,79,77,2
76,32,213201809,32180,Lagraulet-du-Gers,565,555,10
76,32,213201817,32181,Laguian-Mazous,248,246,2
76,32,213201825,32182,Lahas,186,180,6
76,32,213201833,32183,Lahitte,239,228,11
76,32,213201841,32184,Lalanne,133,130,3
76,32,213201858,32185,Lalanne-Arqué,154,150,4
76,32,213201866,32186,Lamaguère,80,80,0
76,32,213201874,32187,Lamazère,125,123,2
76,32,213201882,32188,Lamothe-Goas,83,80,3
76,32,213201890,32189,Lannemaignan,109,106,3
76,32,213201908,32190,Lannepax,519,512,7
76,32,213201916,32191,Lanne-Soubiran,145,145,0
76,32,213201924,32192,Lannux,236,229,7
76,32,213201932,32193,Larée,241,238,3
76,32,213201940,32194,Larressingle,215,210,5
76,32,213201957,32195,Larroque-Engalin,46,45,1
76,32,213201965,32196,Larroque-Saint-Sernin,166,164,2
76,32,213201973,32197,Larroque-sur-l'Osse,227,221,6
76,32,213201981,32198,Lartigue,202,198,4
76,32,213201999,32199,Lasserrade,196,187,9
76,32,213202005,32200,Lasséran,377,366,11
76,32,213202013,32201,Lasseube-Propre,353,338,15
76,32,213202021,32202,Laujuzan,297,282,15
76,32,213202039,32203,Lauraët,256,253,3
76,32,213202047,32204,Lavardens,379,368,11
76,32,213202054,32205,Laveraët,106,105,1
76,32,213202062,32206,Laymont,221,219,2
76,32,213202070,32207,Leboulin,357,340,17
76,32,213202088,32208,Lectoure,4049,3687,362
76,32,213202096,32209,Lelin-Lapujolle,287,280,7
76,32,213202104,32210,Lias,759,744,15
76,32,213202112,32211,Lias-d'Armagnac,200,197,3
76,32,213202120,32212,Ligardes,216,212,4
76,32,213202138,32213,Lombez,2189,2152,37
76,32,213202146,32214,Loubédat,102,98,4
76,32,213202153,32215,Loubersan,158,151,7
76,32,213202161,32216,Lourties-Monbrun,169,168,1
76,32,213202179,32217,Louslitges,60,58,2
76,32,213202187,32218,Loussous-Débat,67,66,1
76,32,213202195,32219,Lupiac,322,311,11
76,32,213202203,32220,Luppé-Violles,141,138,3
76,32,213202211,32221,Lussan,239,236,3
76,32,213202229,32222,Magnan,240,233,7
76,32,213202237,32223,Magnas,91,60,31
76,32,213202245,32224,Maignaut-Tauzia,230,228,2
76,32,213202252,32225,Malabat,106,101,5
76,32,213202260,32226,Manas-Bastanous,87,82,5
76,32,213202278,32227,Manciet,807,789,18
76,32,213202286,32228,Manent-Montané,92,91,1
76,32,213202294,32229,Mansempuy,71,63,8
76,32,213202302,32230,Mansencôme,49,45,4
76,32,213202310,32231,Marambat,447,433,14
76,32,213202328,32232,Maravat,39,39,0
76,32,213202336,32233,Marciac,1288,1203,85
76,32,213202344,32234,Marestaing,339,332,7
76,32,213202351,32235,Margouët-Meymes,166,157,9
76,32,213202369,32236,Marguestau,63,60,3
76,32,213202377,32237,Marsan,486,477,9
76,32,213202385,32238,Marseillan,88,85,3
76,32,213202393,32239,Marsolan,459,448,11
76,32,213202401,32240,Mascaras,67,63,4
76,32,213202419,32241,Mas-d'Auvignon,176,170,6
76,32,213202427,32242,Masseube,1897,1501,396
76,32,213202435,32243,Mauléon-d'Armagnac,269,266,3
76,32,213202443,32244,Maulichères,164,161,3
76,32,213202450,32245,Maumusson-Laguian,152,145,7
76,32,213202468,32246,Maupas,201,199,2
76,32,213202476,32247,Maurens,323,308,15
76,32,213202484,32248,Mauroux,147,143,4
76,32,213202492,32249,Mauvezin,2287,2237,50
76,32,213202500,32250,Meilhan,80,77,3
76,32,213202518,32251,Mérens,69,69,0
76,32,213202526,32252,Miélan,1135,1117,18
76,32,213202534,32253,Miradoux,549,537,12
76,32,213202542,32254,Miramont-d'Astarac,355,347,8
76,32,213202559,32255,Miramont-Latour,156,151,5
76,32,213202567,32256,Mirande,3733,3445,288
76,32,213202575,32257,Mirannes,63,59,4
76,32,213202583,32258,Mirepoix,237,232,5
76,32,213202609,32260,Monbardon,77,73,4
76,32,213202617,32261,Monblanc,386,379,7
76,32,213202625,32262,Monbrun,418,404,14
76,32,213202633,32263,Moncassin,129,126,3
76,32,213202641,32264,Monclar,222,218,4
76,32,213202658,32265,Monclar-sur-Losse,111,109,2
76,32,213202666,32266,Moncorneil-Grazan,145,144,1
76,32,213202674,32267,Monferran-Plavès,113,111,2
76,32,213202682,32268,Monferran-Savès,853,825,28
76,32,213202690,32269,Monfort,511,504,7
76,32,213202708,32270,Mongausy,89,88,1
76,32,213202716,32271,Monguilhem,302,292,10
76,32,213202724,32272,Monlaur-Bernet,167,164,3
76,32,213202732,32273,Monlezun,183,171,12
76,32,213202740,32274,Monlezun-d'Armagnac,199,199,0
76,32,213202757,32275,Monpardiac,45,44,1
76,32,213202765,32276,Montadet,70,69,1
76,32,213202773,32277,Montamat,117,114,3
76,32,213202781,32278,Montaut,122,120,2
76,32,213202799,32279,Montaut-les-Créneaux,729,711,18
76,32,213202807,32280,Mont-d'Astarac,95,93,2
76,32,213202815,32281,Mont-de-Marrast,110,105,5
76,32,213202823,32282,Montégut,663,645,18
76,32,213202831,32283,Montégut-Arros,289,282,7
76,32,213202849,32284,Montégut-Savès,66,65,1
76,32,213202856,32285,Montesquiou,589,571,18
76,32,213202864,32286,Montestruc-sur-Gers,717,701,16
76,32,213202872,32287,Monties,80,79,1
76,32,213202880,32288,Montiron,144,143,1
76,32,213202898,32289,Montpezat,243,240,3
76,32,213202906,32290,Montréal,1213,1178,35
76,32,213202914,32291,Mormès,119,116,3
76,32,213202922,32292,Mouchan,402,393,9
76,32,213202930,32293,Mouchès,75,73,2
76,32,213202948,32294,Mourède,76,73,3
76,32,213202955,32295,Nizas,145,137,8
76,32,213202963,32296,Nogaro,2238,2097,141
76,32,213202971,32297,Noilhan,394,383,11
76,32,213202989,32298,Nougaroulet,384,376,8
76,32,213202997,32299,Noulens,101,101,0
76,32,213203003,32300,Orbessan,290,286,4
76,32,213203011,32301,Ordan-Larroque,908,884,24
76,32,213203029,32302,Ornézan,226,219,7
76,32,213203037,32303,Pallanne,65,63,2
76,32,213203045,32304,Panassac,297,289,8
76,32,213203052,32305,Panjas,426,418,8
76,32,213203060,32306,Pauilhac,658,610,48
76,32,213203078,32307,Pavie,2632,2513,119
76,32,213203086,32308,Pébées,111,109,2
76,32,213203094,32309,Pellefigue,120,115,5
76,32,213203102,32310,Perchède,119,117,2
76,32,213203110,32311,Pergain-Taillac,342,336,6
76,32,213203128,32312,Pessan,687,672,15
76,32,213203136,32313,Pessoulens,143,139,4
76,32,213203144,32314,Peyrecave,78,73,5
76,32,213203151,32315,Peyrusse-Grande,153,151,2
76,32,213203169,32316,Peyrusse-Massas,112,109,3
76,32,213203177,32317,Peyrusse-Vieille,67,65,2
76,32,213203185,32318,Pis,108,106,2
76,32,213203193,32319,Plaisance,1446,1416,30
76,32,213203201,32320,Plieux,163,153,10
76,32,213203219,32321,Polastron,279,273,6
76,32,213203227,32322,Pompiac,213,210,3
76,32,213203235,32323,Ponsampère,109,104,5
76,32,213203243,32324,Ponsan-Soubiran,80,78,2
76,32,213203250,32325,Pouydraguin,132,129,3
76,32,213203268,32326,Pouylebon,150,147,3
76,32,213203276,32327,Pouy-Loubrin,86,85,1
76,32,213203284,32328,Pouy-Roquelaure,123,118,5
76,32,213203292,32329,Préchac,164,161,3
76,32,213203300,32330,Préchac-sur-Adour,199,194,5
76,32,213203318,32331,Preignan,1272,1237,35
76,32,213203326,32332,Préneron,122,121,1
76,32,213203334,32333,Projan,182,182,0
76,32,213203342,32334,Pujaudran,1657,1616,41
76,32,213203359,32335,Puycasquier,454,444,10
76,32,213203367,32336,Puylausic,168,160,8
76,32,213203375,32337,Puységur,76,73,3
76,32,213203383,32338,Ramouzens,177,173,4
76,32,213203391,32339,Razengues,259,251,8
76,32,213203409,32340,Réans,285,283,2
76,32,213203417,32341,Réjaumont,251,247,4
76,32,213203425,32342,Ricourt,54,52,2
76,32,213203433,32343,Riguepeu,178,171,7
76,32,200086908,32344,Riscle,1883,1761,122
76,32,213203458,32345,La Romieu,576,562,14
76,32,213203466,32346,Roquebrune,217,211,6
76,32,213203474,32347,Roquefort,283,276,7
76,32,213203482,32348,Roquelaure,594,571,23
76,32,213203490,32349,Roquelaure-Saint-Aubin,106,102,4
76,32,213203508,32350,Roquepine,33,31,2
76,32,213203516,32351,Roques,111,110,1
76,32,213203524,32352,Rozès,114,110,4
76,32,213203532,32353,Sabaillan,151,148,3
76,32,213203540,32354,Sabazan,138,134,4
76,32,213203557,32355,Sadeillan,86,85,1
76,32,213203565,32356,Saint-André,130,129,1
76,32,213203573,32357,Sainte-Anne,133,127,6
76,32,213203581,32358,Saint-Antoine,192,188,4
76,32,213203599,32359,Saint-Antonin,159,154,5
76,32,213203607,32360,Saint-Arailles,144,141,3
76,32,213203615,32361,Saint-Arroman,140,132,8
76,32,213203623,32362,Saint-Aunix-Lengros,145,143,2
76,32,213203631,32363,Sainte-Aurence-Cazaux,95,92,3
76,32,213203649,32364,Saint-Avit-Frandat,96,93,3
76,32,213203656,32365,Saint-Blancard,338,332,6
76,32,213203664,32366,Saint-Brès,74,73,1
76,32,213203672,32367,Saint-Christaud,64,62,2
76,32,213203680,32368,Sainte-Christie,557,546,11
76,32,213203698,32369,Sainte-Christie-d'Armagnac,387,374,13
76,32,213203706,32370,Saint-Clar,1115,1049,66
76,32,213203714,32371,Saint-Créac,87,83,4
76,32,213203722,32372,Saint-Cricq,290,285,5
76,32,213203730,32373,Sainte-Dode,216,212,4
76,32,213203748,32374,Saint-Élix-d'Astarac,189,183,6
76,32,213203755,32375,Saint-Élix-Theux,93,89,4
76,32,213203763,32376,Sainte-Gemme,116,113,3
76,32,213203771,32377,Saint-Georges,191,184,7
76,32,213203789,32378,Saint-Germé,505,498,7
76,32,213203797,32379,Saint-Germier,214,210,4
76,32,213203805,32380,Saint-Griède,149,140,9
76,32,213203813,32381,Saint-Jean-le-Comtal,413,403,10
76,32,213203821,32382,Saint-Jean-Poutge,326,312,14
76,32,213203839,32383,Saint-Justin,132,126,6
76,32,213203847,32384,Saint-Lary,284,278,6
76,32,213203854,32385,Saint-Léonard,188,187,1
76,32,213203862,32386,Saint-Lizier-du-Planté,147,146,1
76,32,213203870,32387,Saint-Loube,105,103,2
76,32,213203888,32388,Sainte-Marie,433,423,10
76,32,213203896,32389,Saint-Martin,478,458,20
76,32,213203904,32390,Saint-Martin-d'Armagnac,241,237,4
76,32,213203912,32391,Saint-Martin-de-Goyne,126,119,7
76,32,213203920,32392,Saint-Martin-Gimois,88,87,1
76,32,213203938,32393,Saint-Maur,141,136,5
76,32,213203946,32394,Saint-Médard,348,343,5
76,32,213203953,32395,Sainte-Mère,213,209,4
76,32,213203961,32396,Saint-Mézard,242,239,3
76,32,213203979,32397,Saint-Michel,260,244,16
76,32,213203987,32398,Saint-Mont,320,310,10
76,32,213203995,32399,Saint-Orens,87,84,3
76,32,213204001,32400,Saint-Orens-Pouy-Petit,221,212,9
76,32,213204019,32401,Saint-Ost,88,87,1
76,32,213204027,32402,Saint-Paul-de-Baïse,110,107,3
76,32,213204035,32403,Saint-Pierre-d'Aubézies,61,60,1
76,32,213204043,32404,Saint-Puy,602,588,14
76,32,213204050,32405,Sainte-Radegonde,182,176,6
76,32,213204068,32406,Saint-Sauvy,361,351,10
76,32,213204076,32407,Saint-Soulan,165,162,3
76,32,213204084,32408,Salles-d'Armagnac,141,136,5
76,32,213204092,32409,Samaran,91,86,5
76,32,213204100,32410,Samatan,2484,2380,104
76,32,213204118,32411,Sansan,102,99,3
76,32,213204126,32412,Saramon,866,853,13
76,32,213204134,32413,Sarcos,84,82,2
76,32,213204142,32414,Sarragachies,234,228,6
76,32,213204159,32415,Sarraguzan,90,89,1
76,32,213204167,32416,Sarrant,371,361,10
76,32,213204175,32417,La Sauvetat,421,408,13
76,32,213204183,32418,Sauveterre,320,291,29
76,32,213204191,32419,Sauviac,109,107,2
76,32,213204209,32420,Sauvimont,69,67,2
76,32,213204217,32421,Savignac-Mona,144,144,0
76,32,213204225,32422,Scieurac-et-Flourès,43,42,1
76,32,213204233,32423,Séailles,66,63,3
76,32,213204241,32424,Ségos,232,224,8
76,32,213204258,32425,Ségoufielle,1187,1160,27
76,32,213204266,32426,Seissan,1108,1097,11
76,32,213204274,32427,Sembouès,60,59,1
76,32,213204282,32428,Sémézies-Cachan,64,62,2
76,32,213204290,32429,Sempesserre,300,294,6
76,32,213204308,32430,Sère,79,79,0
76,32,213204316,32431,Sérempuy,46,42,4
76,32,213204324,32432,Seysses-Savès,248,246,2
76,32,213204332,32433,Simorre,724,707,17
76,32,213204340,32434,Sion,100,97,3
76,32,213204357,32435,Sirac,173,164,9
76,32,213204365,32436,Solomiac,496,488,8
76,32,213204373,32437,Sorbets,220,219,1
76,32,213204381,32438,Tachoires,106,106,0
76,32,213204399,32439,Tarsac,167,165,2
76,32,213204407,32440,Tasque,254,248,6
76,32,213204415,32441,Taybosc,61,61,0
76,32,213204423,32442,Terraube,382,378,4
76,32,213204431,32443,Termes-d'Armagnac,186,182,4
76,32,213204449,32444,Thoux,266,259,7
76,32,213204456,32445,Tieste-Uragnoux,158,153,5
76,32,213204464,32446,Tillac,291,283,8
76,32,213204472,32447,Tirent-Pontéjac,93,92,1
76,32,213204480,32448,Touget,519,503,16
76,32,213204498,32449,Toujouse,285,282,3
76,32,213204506,32450,Tourdun,135,131,4
76,32,213204514,32451,Tournan,184,181,3
76,32,213204522,32452,Tournecoupe,268,260,8
76,32,213204530,32453,Tourrenquets,116,110,6
76,32,213204548,32454,Traversères,72,70,2
76,32,213204555,32455,Troncens,187,176,11
76,32,213204563,32456,Tudelle,54,54,0
76,32,213204571,32457,Urdens,290,277,13
76,32,213204589,32458,Urgosse,239,234,5
76,32,213204597,32459,Valence-sur-Baïse,1141,1118,23
76,32,213204605,32460,Vergoignan,315,307,8
76,32,213204613,32461,Verlus,121,118,3
76,32,213204621,32462,Vic-Fezensac,3640,3583,57
76,32,213204639,32463,Viella,521,509,12
76,32,213204647,32464,Villecomtal-sur-Arros,857,837,20
76,32,213204654,32465,Villefranche-d'Astarac,138,138,0
76,32,213204662,32466,Viozan,108,107,1
76,32,213204670,32467,Saint-Caprais,147,143,4
76,32,213204688,32468,Aussos,77,77,0
75,33,213300015,33001,Abzac,2023,1998,25
75,33,213300023,33002,Aillas,854,840,14
75,33,213300031,33003,Ambarès-et-Lagrave,16753,16591,162
75,33,213300049,33004,Ambès,3144,3123,21
75,33,213300056,33005,Andernos-les-Bains,12569,12284,285
75,33,213300064,33006,Anglade,928,915,13
75,33,213300072,33007,Arbanats,1367,1359,8
75,33,200083772,33008,Porte-de-Benauge,502,494,8
75,33,213300098,33009,Arcachon,11391,11076,315
75,33,213300106,33010,Arcins,555,548,7
75,33,213300114,33011,Arès,6536,6413,123
75,33,213300122,33012,Arsac,3923,3873,50
75,33,213300130,33013,Artigues-près-Bordeaux,8740,8663,77
75,33,213300148,33014,Les Artigues-de-Lussac,1133,1111,22
75,33,213300155,33015,Arveyres,2037,2000,37
75,33,213300163,33016,Asques,448,439,9
75,33,213305568,33017,Aubiac,289,278,11
75,33,200058071,33018,Val de Virvée,3744,3701,43
75,33,213300197,33019,Audenge,9267,9136,131
75,33,213300205,33020,Auriolles,146,141,5
75,33,213300213,33021,Auros,1071,1048,23
75,33,213300221,33022,Avensan,3091,3049,42
75,33,213300239,33023,Ayguemorte-les-Graves,1372,1357,15
75,33,213300247,33024,Bagas,302,297,5
75,33,213300254,33025,Baigneaux,453,447,6
75,33,213300262,33026,Balizac,512,505,7
75,33,213300270,33027,Barie,294,285,9
75,33,213300288,33028,Baron,1197,1181,16
75,33,213300296,33029,Le Barp,5706,5625,81
75,33,213300304,33030,Barsac,2092,2069,23
75,33,213300312,33031,Bassanne,133,131,2
75,33,213300320,33032,Bassens,7486,7425,61
75,33,213300338,33033,Baurech,946,939,7
75,33,213300346,33034,Bayas,465,461,4
75,33,213300353,33035,Bayon-sur-Gironde,731,729,2
75,33,213300361,33036,Bazas,5064,4806,258
75,33,213300379,33037,Beautiran,2444,2404,40
75,33,213300387,33038,Bégadan,914,906,8
75,33,213300395,33039,Bègles,30890,30543,347
75,33,213300403,33040,Béguey,1219,1206,13
75,33,213300429,33042,Belin-Béliet,5929,5831,98
75,33,213300437,33043,Bellebat,296,295,1
75,33,213300445,33044,Bellefond,223,217,6
75,33,213300452,33045,Belvès-de-Castillon,341,334,7
75,33,213300460,33046,Bernos-Beaulac,1165,1135,30
75,33,213300478,33047,Berson,1838,1808,30
75,33,213300486,33048,Berthez,279,272,7
75,33,213300494,33049,Beychac-et-Caillau,2581,2554,27
75,33,213300502,33050,Bieujac,657,648,9
75,33,213300510,33051,Biganos,11186,11065,121
75,33,213300528,33052,Les Billaux,1200,1164,36
75,33,213300536,33053,Birac,230,229,1
75,33,213300544,33054,Blaignac,295,290,5
75,33,200083780,33055,Blaignan-Prignac,469,459,10
75,33,213300569,33056,Blanquefort,15862,15276,586
75,33,213300577,33057,Blasimon,943,924,19
75,33,213300585,33058,Blaye,5014,4897,117
75,33,213300593,33059,Blésignac,315,309,6
75,33,213300601,33060,Bommes,506,439,67
75,33,213300619,33061,Bonnetan,1030,1011,19
75,33,213300627,33062,Bonzac,771,759,12
75,33,213300635,33063,Bordeaux,263247,259809,3438
75,33,213300643,33064,Bossugan,38,38,0
75,33,213300650,33065,Bouliac,3818,3741,77
75,33,213300668,33066,Bourdelles,94,93,1
75,33,213300676,33067,Bourg,2342,2303,39
75,33,213300684,33068,Bourideys,98,95,3
75,33,213300692,33069,Le Bouscat,24288,24006,282
75,33,213300700,33070,Brach,830,817,13
75,33,213300718,33071,Branne,1333,1317,16
75,33,213300726,33072,Brannens,243,239,4
75,33,213300734,33073,Braud-et-Saint-Louis,1528,1500,28
75,33,213300742,33074,Brouqueyran,214,206,8
75,33,213300759,33075,Bruges,20066,19863,203
75,33,213300767,33076,Budos,827,812,15
75,33,213300775,33077,Cabanac-et-Villagrains,2448,2409,39
75,33,213300783,33078,Cabara,515,503,12
75,33,213300791,33079,Cadarsac,362,355,7
75,33,213300809,33080,Cadaujac,6695,6623,72
75,33,213300817,33081,Cadillac-sur-Garonne,2877,2846,31
75,33,213300825,33082,Cadillac-en-Fronsadais,1366,1350,16
75,33,213300833,33083,Camarsac,1039,1025,14
75,33,213300841,33084,Cambes,1783,1766,17
75,33,213300858,33085,Camblanes-et-Meynac,3180,3040,140
75,33,213300866,33086,Camiac-et-Saint-Denis,365,360,5
75,33,213300874,33087,Camiran,418,415,3
75,33,213300882,33088,Camps-sur-l'Isle,615,605,10
75,33,213300890,33089,Campugnan,510,504,6
75,33,213300908,33090,Canéjan,6074,5997,77
75,33,213300932,33093,Capian,788,771,17
75,33,213300940,33094,Caplong,231,227,4
75,33,213300957,33095,Captieux,1364,1344,20
75,33,213300965,33096,Carbon-Blanc,8355,8272,83
75,33,213300973,33097,Carcans,2455,2420,35
75,33,213300981,33098,Cardan,519,514,5
75,33,213300999,33099,Carignan-de-Bordeaux,4207,4161,46
75,33,213301005,33100,Cars,1234,1213,21
75,33,213301013,33101,Cartelègue,1277,1254,23
75,33,213301021,33102,Casseuil,381,376,5
75,33,213301039,33103,Castelmoron-d'Albret,53,53,0
75,33,213301047,33104,Castelnau-de-Médoc,4885,4820,65
75,33,213301054,33105,Castelviel,222,214,8
75,33,200064301,33106,Castets et Castillon,1519,1487,32
75,33,213301088,33108,Castillon-la-Bataille,3265,3238,27
75,33,213301096,33109,Castres-Gironde,2496,2462,34
75,33,213301112,33111,Caudrot,1126,1111,15
75,33,213301120,33112,Caumont,142,140,2
75,33,213301138,33113,Cauvignac,150,147,3
75,33,213301146,33114,Cavignac,2308,2292,16
75,33,213301153,33115,Cazalis,240,239,1
75,33,213301161,33116,Cazats,405,400,5
75,33,213301179,33117,Cazaugitat,220,217,3
75,33,213301187,33118,Cénac,2153,2118,35
75,33,213301195,33119,Cenon,26278,26047,231
75,33,213301203,33120,Cérons,2175,2133,42
75,33,213301211,33121,Cessac,195,193,2
75,33,213301229,33122,Cestas,17219,16932,287
75,33,213301237,33123,Cézac,2711,2678,33
75,33,213301245,33124,Chamadelle,739,724,15
75,33,213301252,33125,Cissac-Médoc,2242,2213,29
75,33,213301260,33126,Civrac-de-Blaye,863,845,18
75,33,213301278,33127,Civrac-sur-Dordogne,227,222,5
75,33,213301286,33128,Civrac-en-Médoc,656,642,14
75,33,213301294,33129,Cleyrac,153,153,0
75,33,213301302,33130,Coimères,1084,1057,27
75,33,213301310,33131,Coirac,214,212,2
75,33,213301328,33132,Comps,561,553,8
75,33,213301336,33133,Coubeyrac,71,71,0
75,33,213301344,33134,Couquèques,276,269,7
75,33,213301351,33135,Courpiac,126,126,0
75,33,213301369,33136,Cours-de-Monségur,272,269,3
75,33,213301377,33137,Cours-les-Bains,222,218,4
75,33,213301385,33138,Coutras,8746,8623,123
75,33,213301393,33139,Coutures,99,97,2
75,33,213301401,33140,Créon,4998,4899,99
75,33,213301419,33141,Croignon,724,715,9
75,33,213301427,33142,Cubnezais,1743,1726,17
75,33,213301435,33143,Cubzac-les-Ponts,2558,2531,27
75,33,213301443,33144,Cudos,919,789,130
75,33,213301450,33145,Cursan,681,663,18
75,33,213301468,33146,Cussac-Fort-Médoc,2392,2363,29
75,33,213301476,33147,Daignac,471,465,6
75,33,213301484,33148,Dardenac,95,90,5
75,33,213301492,33149,Daubèze,156,155,1
75,33,213301500,33150,Dieulivol,340,338,2
75,33,213301518,33151,Donnezac,935,925,10
75,33,213301526,33152,Donzac,125,120,5
75,33,213301534,33153,Doulezon,267,263,4
75,33,213301542,33154,Les Églisottes-et-Chalaures,2247,2145,102
75,33,213301559,33155,Escaudes,163,160,3
75,33,213301567,33156,Escoussans,291,283,8
75,33,213301575,33157,Espiet,791,780,11
75,33,213301583,33158,Les Esseintes,248,241,7
75,33,213301591,33159,Étauliers,1484,1470,14
75,33,213301609,33160,Eynesse,610,594,16
75,33,213301617,33161,Eyrans,767,761,6
75,33,213301625,33162,Eysines,24483,24202,281
75,33,213301633,33163,Faleyras,439,430,9
75,33,213301641,33164,Fargues,1680,1647,33
75,33,213301658,33165,Fargues-Saint-Hilaire,3331,3303,28
75,33,213301666,33166,Le Fieu,505,501,4
75,33,213301674,33167,Floirac,18130,18013,117
75,33,213301682,33168,Flaujagues,603,594,9
75,33,213301690,33169,Floudès,114,110,4
75,33,213301708,33170,Fontet,788,769,19
75,33,213301716,33171,Fossès-et-Baleyssac,234,228,6
75,33,213301724,33172,Fours,284,273,11
75,33,213301732,33173,Francs,190,184,6
75,33,213301740,33174,Fronsac,1166,1132,34
75,33,213301757,33175,Frontenac,759,749,10
75,33,213301765,33176,Gabarnac,363,356,7
75,33,213301773,33177,Gaillan-en-Médoc,2397,2355,42
75,33,213301781,33178,Gajac,378,372,6
75,33,213301799,33179,Galgon,3085,3030,55
75,33,213301807,33180,Gans,200,192,8
75,33,213301815,33181,Gardegan-et-Tourtirac,283,279,4
75,33,213301823,33182,Gauriac,737,721,16
75,33,213301831,33183,Gauriaguet,1448,1432,16
75,33,213301849,33184,Générac,559,544,15
75,33,213301856,33185,Génissac,2028,1992,36
75,33,213301864,33186,Gensac,714,701,13
75,33,213301872,33187,Gironde-sur-Dropt,1345,1321,24
75,33,213301880,33188,Giscos,187,184,3
75,33,213301898,33189,Gornac,446,436,10
75,33,213301906,33190,Goualade,87,86,1
75,33,213301914,33191,Gours,572,564,8
75,33,213301922,33192,Gradignan,26208,25871,337
75,33,213301930,33193,Grayan-et-l'Hôpital,1568,1543,25
75,33,213301948,33194,Grézillac,706,691,15
75,33,213301955,33195,Grignols,1200,1192,8
75,33,213301963,33196,Guillac,162,158,4
75,33,213301971,33197,Guillos,457,451,6
75,33,213301989,33198,Guîtres,1635,1606,29
75,33,213301997,33199,Gujan-Mestras,22485,22036,449
75,33,213302003,33200,Le Haillan,11756,11567,189
75,33,213302011,33201,Haux,854,836,18
75,33,213302029,33202,Hostens,1501,1482,19
75,33,213302037,33203,Hourtin,4037,3967,70
75,33,213302045,33204,Hure,564,557,7
75,33,213302052,33205,Illats,1399,1378,21
75,33,213302060,33206,Isle-Saint-Georges,524,521,3
75,33,213302078,33207,Izon,6365,6298,67
75,33,213302086,33208,Jau-Dignac-et-Loirac,963,954,9
75,33,213302094,33209,Jugazan,282,275,7
75,33,213302102,33210,Juillac,229,225,4
75,33,213302110,33211,Labarde,612,610,2
75,33,213302128,33212,Labescau,127,126,1
75,33,213302136,33213,La Brède,4955,4461,494
75,33,213302144,33214,Lacanau,5141,5064,77
75,33,213302151,33215,Ladaux,198,192,6
75,33,213302169,33216,Lados,176,173,3
75,33,213302185,33218,Lagorce,1666,1642,24
75,33,213302193,33219,La Lande-de-Fronsac,2604,2579,25
75,33,213302201,33220,Lamarque,1352,1340,12
75,33,213302219,33221,Lamothe-Landerron,1153,1132,21
75,33,213302227,33222,Lalande-de-Pomerol,671,656,15
75,33,213302235,33223,Landerrouat,225,222,3
75,33,213302243,33224,Landerrouet-sur-Ségur,101,101,0
75,33,213302250,33225,Landiras,2229,2190,39
75,33,213302268,33226,Langoiran,2211,2172,39
75,33,213302276,33227,Langon,7516,7366,150
75,33,213302284,33228,Lansac,692,682,10
75,33,213302292,33229,Lanton,7413,7273,140
75,33,213302300,33230,Lapouyade,521,516,5
75,33,213302318,33231,Laroque,295,291,4
75,33,213302326,33232,Lartigue,40,40,0
75,33,213302334,33233,Laruscade,2843,2821,22
75,33,213302342,33234,Latresne,3722,3578,144
75,33,213302359,33235,Lavazan,232,230,2
75,33,213302367,33236,Lège-Cap-Ferret,8504,8334,170
75,33,213302375,33237,Léogeats,864,843,21
75,33,213302383,33238,Léognan,10804,10641,163
75,33,213302391,33239,Lerm-et-Musset,481,476,5
75,33,213302409,33240,Lesparre-Médoc,5920,5826,94
75,33,213302417,33241,Lestiac-sur-Garonne,587,578,9
75,33,213302425,33242,Les Lèves-et-Thoumeyragues,571,561,10
75,33,213302433,33243,Libourne,24941,24432,509
75,33,213302441,33244,Lignan-de-Bazas,433,427,6
75,33,213302458,33245,Lignan-de-Bordeaux,845,830,15
75,33,213302466,33246,Ligueux,155,149,6
75,33,213302474,33247,Listrac-de-Durèze,167,163,4
75,33,213302482,33248,Listrac-Médoc,2826,2790,36
75,33,213302490,33249,Lormont,23231,22913,318
75,33,213302508,33250,Loubens,317,309,8
75,33,213302516,33251,Louchats,734,725,9
75,33,213302524,33252,Loupes,897,884,13
75,33,213302532,33253,Loupiac,1123,1106,17
75,33,213302540,33254,Loupiac-de-la-Réole,528,520,8
75,33,213302557,33255,Lucmau,248,245,3
75,33,213302565,33256,Ludon-Médoc,5298,5252,46
75,33,213302573,33257,Lugaignac,487,475,12
75,33,213302581,33258,Lugasson,314,308,6
75,33,213302599,33259,Lugon-et-l'Île-du-Carnay,1395,1369,26
75,33,213302607,33260,Lugos,1017,995,22
75,33,213302615,33261,Lussac,1233,1223,10
75,33,213302623,33262,Macau,4503,4478,25
75,33,213302631,33263,Madirac,297,293,4
75,33,213302649,33264,Maransin,1033,1021,12
75,33,213302664,33266,Marcenais,840,821,19
75,33,200068013,33268,Margaux-Cantenac,2861,2832,29
75,33,213302698,33269,Margueron,394,390,4
75,33,213302706,33270,Marimbault,189,181,8
75,33,213302714,33271,Marions,223,221,2
75,33,213302722,33272,Marsas,1244,1222,22
75,33,213302730,33273,Martignas-sur-Jalle,7872,7741,131
75,33,213302748,33274,Martillac,3447,3406,41
75,33,213302755,33275,Martres,105,103,2
75,33,213302763,33276,Masseilles,145,140,5
75,33,213302771,33277,Massugas,227,221,6
75,33,213302789,33278,Mauriac,238,232,6
75,33,213302797,33279,Mazères,788,778,10
75,33,213302805,33280,Mazion,558,554,4
75,33,213302813,33281,Mérignac,74775,74009,766
75,33,213302821,33282,Mérignas,339,333,6
75,33,213302839,33283,Mesterrieux,229,228,1
75,33,213302847,33284,Mios,11312,11180,132
75,33,213302854,33285,Mombrier,449,440,9
75,33,213302870,33287,Mongauzy,605,599,6
75,33,213302888,33288,Monprimblanc,285,281,4
75,33,213302896,33289,Monségur,1668,1598,70
75,33,213302904,33290,Montagne,1648,1519,129
75,33,213302912,33291,Montagoudin,180,177,3
75,33,213302920,33292,Montignac,142,136,6
75,33,213302938,33293,Montussan,3463,3412,51
75,33,213302946,33294,Morizès,547,543,4
75,33,213302953,33295,Mouillac,98,89,9
75,33,213302961,33296,Mouliets-et-Villemartin,1046,1031,15
75,33,213302979,33297,Moulis-en-Médoc,1926,1893,33
75,33,213302987,33298,Moulon,1040,1020,20
75,33,213302995,33299,Mourens,391,383,8
75,33,213303001,33300,Naujac-sur-Mer,1103,1080,23
75,33,213303019,33301,Naujan-et-Postiac,623,617,6
75,33,213303027,33302,Néac,350,340,10
75,33,213303035,33303,Nérigean,850,842,8
75,33,213303043,33304,Neuffons,145,141,4
75,33,213303050,33305,Le Nizan,508,503,5
75,33,213303068,33306,Noaillac,524,518,6
75,33,213303076,33307,Noaillan,1708,1671,37
75,33,213303084,33308,Omet,310,308,2
75,33,213303092,33309,Ordonnac,498,492,6
75,33,213303100,33310,Origne,189,187,2
75,33,213303118,33311,Paillet,1232,1208,24
75,33,213303126,33312,Parempuyre,9878,9786,92
75,33,213303142,33314,Pauillac,5164,5084,80
75,33,213303159,33315,Les Peintures,1655,1634,21
75,33,213303167,33316,Pellegrue,916,903,13
75,33,213303175,33317,Périssac,1208,1192,16
75,33,213303183,33318,Pessac,66606,65866,740
75,33,213303191,33319,Pessac-sur-Dordogne,450,441,9
75,33,213303209,33320,Petit-Palais-et-Cornemps,742,725,17
75,33,213303217,33321,Peujard,2189,2161,28
75,33,213303225,33322,Le Pian-Médoc,7138,6995,143
75,33,213303233,33323,Le Pian-sur-Garonne,959,940,19
75,33,213303241,33324,Pineuilh,4537,4421,116
75,33,213303258,33325,Plassac,957,938,19
75,33,213303266,33326,Pleine-Selve,223,218,5
75,33,213303274,33327,Podensac,3309,3258,51
75,33,213303282,33328,Pomerol,595,589,6
75,33,213303290,33329,Pompéjac,274,271,3
75,33,213303308,33330,Pompignac,3357,3301,56
75,33,213303316,33331,Pondaurat,464,460,4
75,33,213303324,33332,Porchères,881,871,10
75,33,213303332,33333,Le Porge,3371,3324,47
75,33,213303340,33334,Portets,2748,2713,35
75,33,213303357,33335,Le Pout,629,621,8
75,33,213303365,33336,Préchac,1041,1022,19
75,33,213303373,33337,Preignac,2207,2172,35
75,33,213303399,33339,Prignac-et-Marcamps,1412,1383,29
75,33,213303415,33341,Pugnac,2388,2354,34
75,33,213303423,33342,Puisseguin,839,818,21
75,33,213303431,33343,Pujols-sur-Ciron,881,865,16
75,33,213303449,33344,Pujols,532,526,6
75,33,213303456,33345,Le Puy,410,403,7
75,33,213303464,33346,Puybarban,422,411,11
75,33,213303472,33347,Puynormand,312,307,5
75,33,213303480,33348,Queyrac,1376,1360,16
75,33,213303498,33349,Quinsac,2237,2214,23
75,33,213303506,33350,Rauzan,1273,1248,25
75,33,213303514,33351,Reignac,1639,1613,26
75,33,213303522,33352,La Réole,4435,4351,84
75,33,213303530,33353,Rimons,198,197,1
75,33,213303548,33354,Riocaud,202,197,5
75,33,213303555,33355,Rions,1545,1509,36
75,33,213303563,33356,La Rivière,430,425,5
75,33,213303571,33357,Roaillan,1787,1760,27
75,33,213303589,33358,Romagne,479,471,8
75,33,213303597,33359,Roquebrune,286,283,3
75,33,213303605,33360,La Roquille,316,313,3
75,33,213303613,33361,Ruch,587,579,8
75,33,213303621,33362,Sablons,1324,1309,15
75,33,213303639,33363,Sadirac,4698,4626,72
75,33,213303647,33364,Saillans,383,376,7
75,33,213303654,33365,Saint-Aignan,208,199,9
75,33,213303662,33366,Saint-André-de-Cubzac,12924,12735,189
75,33,213303670,33367,Saint-André-du-Bois,434,431,3
75,33,213303696,33369,Saint-André-et-Appelles,682,669,13
75,33,213303704,33370,Saint-Androny,563,556,7
75,33,213303720,33372,Saint-Antoine-du-Queyret,57,55,2
75,33,213303738,33373,Saint-Antoine-sur-l'Isle,590,581,9
75,33,213303746,33374,Saint-Aubin-de-Blaye,857,846,11
75,33,213303753,33375,Saint-Aubin-de-Branne,384,376,8
75,33,213303761,33376,Saint-Aubin-de-Médoc,7789,7574,215
75,33,213303779,33377,Saint-Avit-de-Soulège,81,78,3
75,33,213303787,33378,Saint-Avit-Saint-Nazaire,1506,1485,21
75,33,213303795,33379,Saint-Brice,315,314,1
75,33,200083830,33380,Val-de-Livenne,1809,1786,23
75,33,213303811,33381,Saint-Caprais-de-Bordeaux,3467,3419,48
75,33,213303829,33382,Saint-Christoly-de-Blaye,1899,1870,29
75,33,213303837,33383,Saint-Christoly-Médoc,280,277,3
75,33,213303845,33384,Saint-Christophe-des-Bardes,413,406,7
75,33,213303852,33385,Saint-Christophe-de-Double,620,615,5
75,33,213303860,33386,Saint-Cibard,198,192,6
75,33,213303878,33387,Saint-Ciers-d'Abzac,1526,1502,24
75,33,213303886,33388,Saint-Ciers-de-Canesse,775,759,16
75,33,213303894,33389,Saint-Ciers-sur-Gironde,3071,3029,42
75,33,213303902,33390,Sainte-Colombe,431,423,8
75,33,213303910,33391,Saint-Côme,339,335,4
75,33,213303928,33392,Sainte-Croix-du-Mont,864,848,16
75,33,213303936,33393,Saint-Denis-de-Pile,5862,5791,71
75,33,213303944,33394,Saint-Émilion,1889,1844,45
75,33,213303951,33395,Saint-Estèphe,1641,1604,37
75,33,213303969,33396,Saint-Étienne-de-Lisse,194,190,4
75,33,213303977,33397,Sainte-Eulalie,5017,4932,85
75,33,213303985,33398,Saint-Exupéry,171,169,2
75,33,213303993,33399,Saint-Félix-de-Foncaude,297,290,7
75,33,213304009,33400,Saint-Ferme,345,340,5
75,33,213304017,33401,Sainte-Florence,151,149,2
75,33,213304025,33402,Sainte-Foy-la-Grande,2697,2665,32
75,33,213304033,33403,Sainte-Foy-la-Longue,139,136,3
75,33,213304041,33404,Sainte-Gemme,195,192,3
75,33,213304058,33405,Saint-Genès-de-Blaye,511,499,12
75,33,213304066,33406,Saint-Genès-de-Castillon,380,373,7
75,33,213304074,33407,Saint-Genès-de-Fronsac,907,889,18
75,33,213304082,33408,Saint-Genès-de-Lombaud,407,390,17
75,33,213304090,33409,Saint-Genis-du-Bois,87,86,1
75,33,213304116,33411,Saint-Germain-de-Grave,156,152,4
75,33,213304124,33412,Saint-Germain-d'Esteuil,1299,1286,13
75,33,213304132,33413,Saint-Germain-du-Puch,2295,2259,36
75,33,213304140,33414,Saint-Germain-de-la-Rivière,396,393,3
75,33,213304157,33415,Saint-Gervais,1939,1919,20
75,33,213304165,33416,Saint-Girons-d'Aiguevives,950,940,10
75,33,213304173,33417,Sainte-Hélène,2985,2939,46
75,33,213304181,33418,Saint-Hilaire-de-la-Noaille,384,376,8
75,33,213304199,33419,Saint-Hilaire-du-Bois,81,81,0
75,33,213304207,33420,Saint-Hippolyte,134,133,1
75,33,213304215,33421,Saint-Jean-de-Blaignac,464,459,5
75,33,213304223,33422,Saint-Jean-d'Illac,9271,9106,165
75,33,213304231,33423,Saint-Julien-Beychevelle,616,616,0
75,33,213304249,33424,Saint-Laurent-Médoc,4996,4905,91
75,33,213304256,33425,Saint-Laurent-d'Arce,1528,1500,28
75,33,213304264,33426,Saint-Laurent-des-Combes,249,245,4
75,33,213304272,33427,Saint-Laurent-du-Bois,255,250,5
75,33,213304280,33428,Saint-Laurent-du-Plan,83,83,0
75,33,213304298,33429,Saint-Léger-de-Balson,328,323,5
75,33,213304314,33431,Saint-Léon,336,327,9
75,33,213304322,33432,Saint-Loubert,243,241,2
75,33,213304330,33433,Saint-Loubès,10059,9953,106
75,33,213304348,33434,Saint-Louis-de-Montferrand,2164,2149,15
75,33,213304355,33435,Saint-Macaire,2137,2035,102
75,33,213304363,33436,Saint-Magne,1121,1109,12
75,33,213304371,33437,Saint-Magne-de-Castillon,2056,2030,26
75,33,213304389,33438,Saint-Maixant,2065,2014,51
75,33,213304397,33439,Saint-Mariens,1636,1619,17
75,33,213304405,33440,Saint-Martial,243,238,5
75,33,213304413,33441,Saint-Martin-Lacaussade,1257,1160,97
75,33,213304421,33442,Saint-Martin-de-Laye,558,551,7
75,33,213304439,33443,Saint-Martin-de-Lerm,158,155,3
75,33,213304447,33444,Saint-Martin-de-Sescas,581,571,10
75,33,213304454,33445,Saint-Martin-du-Bois,852,835,17
75,33,213304462,33446,Saint-Martin-du-Puy,165,164,1
75,33,213304470,33447,Saint-Médard-de-Guizières,2406,2386,20
75,33,213304488,33448,Saint-Médard-d'Eyrans,3196,3156,40
75,33,213304496,33449,Saint-Médard-en-Jalles,32866,32357,509
75,33,213304504,33450,Saint-Michel-de-Castelnau,248,245,3
75,33,213304512,33451,Saint-Michel-de-Fronsac,532,528,4
75,33,213304520,33452,Saint-Michel-de-Rieufret,878,864,14
75,33,213304538,33453,Saint-Michel-de-Lapujade,221,217,4
75,33,213304546,33454,Saint-Morillon,1798,1755,43
75,33,213304561,33456,Saint-Palais,506,499,7
75,33,213304579,33457,Saint-Pardon-de-Conques,619,610,9
75,33,213304587,33458,Saint-Paul,1016,996,20
75,33,213304595,33459,Saint-Pey-d'Armens,188,185,3
75,33,213304603,33460,Saint-Pey-de-Castets,615,603,12
75,33,213304611,33461,Saint-Philippe-d'Aiguille,381,376,5
75,33,213304629,33462,Saint-Philippe-du-Seignal,511,502,9
75,33,213304637,33463,Saint-Pierre-d'Aurillac,1332,1312,20
75,33,213304645,33464,Saint-Pierre-de-Bat,295,288,7
75,33,213304652,33465,Saint-Pierre-de-Mons,1257,1236,21
75,33,213304660,33466,Saint-Quentin-de-Baron,2652,2620,32
75,33,213304678,33467,Saint-Quentin-de-Caplong,239,235,4
75,33,213304686,33468,Sainte-Radegonde,443,434,9
75,33,213304702,33470,Saint-Romain-la-Virvée,912,897,15
75,33,213304710,33471,Saint-Sauveur,1292,1265,27
75,33,213304728,33472,Saint-Sauveur-de-Puynormand,372,366,6
75,33,213304736,33473,Saint-Savin,3352,3313,39
75,33,213304744,33474,Saint-Selve,3536,3488,48
75,33,213304751,33475,Saint-Seurin-de-Bourg,414,408,6
75,33,213304769,33476,Saint-Seurin-de-Cadourne,712,700,12
75,33,213304777,33477,Saint-Seurin-de-Cursac,779,766,13
75,33,213304785,33478,Saint-Seurin-sur-l'Isle,3155,3134,21
75,33,213304793,33479,Saint-Sève,251,249,2
75,33,213304801,33480,Saint-Sulpice-de-Faleyrens,1332,1304,28
75,33,213304819,33481,Saint-Sulpice-de-Guilleragues,236,233,3
75,33,213304827,33482,Saint-Sulpice-de-Pommiers,265,262,3
75,33,213304835,33483,Saint-Sulpice-et-Cameyrac,4916,4848,68
75,33,213304843,33484,Saint-Symphorien,1850,1819,31
75,33,213304850,33485,Sainte-Terre,1935,1904,31
75,33,213304868,33486,Saint-Trojan,372,364,8
75,33,213304876,33487,Saint-Vincent-de-Paul,985,978,7
75,33,213304884,33488,Saint-Vincent-de-Pertignas,354,342,12
75,33,213304892,33489,Saint-Vivien-de-Blaye,368,363,5
75,33,213304900,33490,Saint-Vivien-de-Médoc,1819,1795,24
75,33,213304918,33491,Saint-Vivien-de-Monségur,400,395,5
75,33,213304926,33492,Saint-Yzan-de-Soudiac,2508,2478,30
75,33,213304934,33493,Saint-Yzans-de-Médoc,369,345,24
75,33,213304942,33494,Salaunes,1222,1211,11
75,33,213304967,33496,Salleboeuf,2751,2710,41
75,33,213304983,33498,Salles,7764,7646,118
75,33,213304991,33499,Les Salles-de-Castillon,335,327,8
75,33,213305006,33500,Samonac,447,443,4
75,33,213305014,33501,Saucats,3415,3355,60
75,33,213305022,33502,Saugon,499,493,6
75,33,213305030,33503,Saumos,539,531,8
75,33,213305048,33504,Sauternes,834,824,10
75,33,213305055,33505,La Sauve,1627,1573,54
75,33,213305063,33506,Sauveterre-de-Guyenne,1877,1858,19
75,33,213305071,33507,Sauviac,335,324,11
75,33,213305089,33508,Savignac,643,630,13
75,33,213305097,33509,Savignac-de-l'Isle,536,535,1
75,33,213305105,33510,Semens,221,220,1
75,33,213305113,33511,Sendets,348,342,6
75,33,213305121,33512,Sigalens,361,353,8
75,33,213305139,33513,Sillas,121,121,0
75,33,213305147,33514,Soulac-sur-Mer,2860,2833,27
75,33,213305154,33515,Soulignac,425,419,6
75,33,213305162,33516,Soussac,197,193,4
75,33,213305170,33517,Soussans,1696,1673,23
75,33,213305188,33518,Tabanac,1105,1082,23
75,33,213305196,33519,Le Taillan-Médoc,10563,10416,147
75,33,213305204,33520,Taillecavat,280,277,3
75,33,213305212,33521,Talais,771,761,10
75,33,213305220,33522,Talence,45355,44359,996
75,33,213305238,33523,Targon,2067,2043,24
75,33,213305246,33524,Tarnès,327,324,3
75,33,213305253,33525,Tauriac,1328,1304,24
75,33,213305261,33526,Tayac,132,131,1
75,33,213305279,33527,Le Teich,8980,8794,186
75,33,213305287,33528,Le Temple,649,642,7
75,33,213305295,33529,La Teste-de-Buch,26648,26269,379
75,33,213305303,33530,Teuillac,886,877,9
75,33,213305311,33531,Tizac-de-Curton,362,356,6
75,33,213305329,33532,Tizac-de-Lapouyade,480,471,9
75,33,213305337,33533,Toulenne,2805,2779,26
75,33,213305345,33534,Le Tourne,824,813,11
75,33,213305352,33535,Tresses,5037,4981,56
75,33,213305360,33536,Le Tuzan,264,260,4
75,33,213305378,33537,Uzeste,476,466,10
75,33,213305386,33538,Valeyrac,550,540,10
75,33,213305394,33539,Vayres,4231,4177,54
75,33,213305402,33540,Vendays-Montalivet,2583,2548,35
75,33,213305410,33541,Vensac,1061,1043,18
75,33,213305428,33542,Vérac,968,954,14
75,33,213305436,33543,Verdelais,1042,1031,11
75,33,213305444,33544,Le Verdon-sur-Mer,1335,1323,12
75,33,213305451,33545,Vertheuil,1330,1308,22
75,33,213305469,33546,Vignonet,510,498,12
75,33,213305477,33547,Villandraut,1150,1125,25
75,33,213305485,33548,Villegouge,1312,1287,25
75,33,213305493,33549,Villenave-de-Rions,369,363,6
75,33,213305501,33550,Villenave-d'Ornon,38696,38444,252
75,33,213305519,33551,Villeneuve,409,403,6
75,33,213305527,33552,Virelade,1115,1101,14
75,33,213305535,33553,Virsac,1268,1262,6
75,33,213305543,33554,Yvrac,2894,2860,34
75,33,213305550,33555,Marcheprime,5206,5123,83
76,34,213400013,34001,Abeilhan,1829,1805,24
76,34,213400021,34002,Adissan,1329,1303,26
76,34,213400039,34003,Agde,29589,29201,388
76,34,213400047,34004,Agel,248,244,4
76,34,213400054,34005,Agonès,304,295,9
76,34,213400062,34006,Aigne,279,272,7
76,34,213400070,34007,Aigues-Vives,473,468,5
76,34,213400088,34008,Les Aires,621,610,11
76,34,213400096,34009,Alignan-du-Vent,1790,1764,26
76,34,213400104,34010,Aniane,2977,2939,38
76,34,213400112,34011,Arboras,112,108,4
76,34,213400120,34012,Argelliers,995,970,25
76,34,213400138,34013,Aspiran,1694,1670,24
76,34,213400146,34014,Assas,1526,1483,43
76,34,213400153,34015,Assignan,160,157,3
76,34,213400161,34016,Aumelas,571,552,19
76,34,213400179,34017,Aumes,515,499,16
76,34,213400187,34018,Autignac,937,922,15
76,34,213400195,34019,Avène,291,282,9
76,34,213400203,34020,Azillanet,370,358,12
76,34,213400211,34021,Babeau-Bouldoux,307,301,6
76,34,213400229,34022,Baillargues,7702,7600,102
76,34,213400237,34023,Balaruc-les-Bains,7207,7115,92
76,34,213400245,34024,Balaruc-le-Vieux,2731,2689,42
76,34,213400252,34025,Bassan,2252,2221,31
76,34,213400260,34026,Beaufort,222,220,2
76,34,213400278,34027,Beaulieu,2225,2176,49
76,34,213400286,34028,Bédarieux,5952,5736,216
76,34,213400294,34029,Bélarga,682,675,7
76,34,213400302,34030,Berlou,215,215,0
76,34,213400310,34031,Bessan,5445,5365,80
76,34,213400328,34032,Béziers,79873,78683,1190
76,34,213400336,34033,Boisseron,2156,2113,43
76,34,213400344,34034,Boisset,40,39,1
76,34,213400351,34035,La Boissière,1057,1038,19
76,34,213400369,34036,Le Bosc,1395,1371,24
76,34,213400377,34037,Boujan-sur-Libron,3426,3369,57
76,34,213400385,34038,Le Bousquet-d'Orb,1608,1584,24
76,34,213400393,34039,Bouzigues,1655,1633,22
76,34,213400401,34040,Brenas,55,55,0
76,34,213400419,34041,Brignac,978,961,17
76,34,213400427,34042,Brissac,615,601,14
76,34,213400435,34043,Buzignargues,368,363,5
76,34,213400443,34044,Cabrerolles,349,339,10
76,34,213400450,34045,Cabrières,567,549,18
76,34,213400468,34046,Cambon-et-Salvergues,50,50,0
76,34,213400476,34047,Campagnan,724,714,10
76,34,213400484,34048,Campagne,308,303,5
76,34,213400492,34049,Camplong,233,227,6
76,34,213400500,34050,Candillargues,2029,2003,26
76,34,213400518,34051,Canet,3614,3540,74
76,34,213400526,34052,Capestang,3356,3298,58
76,34,213400534,34053,Carlencas-et-Levas,126,126,0
76,34,213400542,34054,Cassagnoles,111,110,1
76,34,213400559,34055,Castanet-le-Haut,221,218,3
76,34,213400567,34056,Castelnau-de-Guers,1245,1231,14
76,34,213400575,34057,Castelnau-le-Lez,23875,23469,406
76,34,213400583,34058,Castries,6529,6423,106
76,34,213400591,34059,La Caunette,323,317,6
76,34,213400609,34060,Causse-de-la-Selle,423,416,7
76,34,213400617,34061,Causses-et-Veyran,637,627,10
76,34,213400625,34062,Caussiniojouls,157,156,1
76,34,213400633,34063,Caux,2624,2589,35
76,34,213400641,34064,Le Caylar,480,465,15
76,34,213400658,34065,Cazedarnes,630,619,11
76,34,213400666,34066,Cazevieille,233,230,3
76,34,213400674,34067,Cazilhac,1594,1554,40
76,34,213400682,34068,Cazouls-d'Hérault,418,409,9
76,34,213400690,34069,Cazouls-lès-Béziers,5220,5124,96
76,34,213400708,34070,Cébazan,644,632,12
76,34,213400716,34071,Ceilhes-et-Rocozels,308,302,6
76,34,213400724,34072,Celles,31,30,1
76,34,213400732,34073,Cers,2607,2557,50
76,34,213400740,34074,Cessenon-sur-Orb,2408,2358,50
76,34,213400757,34075,Cesseras,428,420,8
76,34,213400765,34076,Ceyras,1404,1378,26
76,34,213400773,34077,Clapiers,5701,5613,88
76,34,213400781,34078,Claret,1730,1692,38
76,34,213400799,34079,Clermont-l'Hérault,9285,9126,159
76,34,213400807,34080,Colombières-sur-Orb,494,480,14
76,34,213400815,34081,Colombiers,2724,2680,44
76,34,213400823,34082,Combaillaux,1913,1869,44
76,34,213400831,34083,Combes,325,322,3
76,34,213400849,34084,Corneilhan,1722,1694,28
76,34,213400856,34085,Coulobres,368,359,9
76,34,213400864,34086,Courniou,632,619,13
76,34,213400872,34087,Cournonsec,3549,3517,32
76,34,213400880,34088,Cournonterral,6568,6490,78
76,34,213400898,34089,Creissan,1372,1345,27
76,34,213400906,34090,Le Crès,9440,9305,135
76,34,213400914,34091,Le Cros,56,56,0
76,34,213400922,34092,Cruzy,975,960,15
76,34,213400930,34093,Dio-et-Valquières,150,147,3
76,34,213400948,34094,Espondeilhan,1171,1147,24
76,34,213400955,34095,Fabrègues,7277,7194,83
76,34,213400963,34096,Faugères,558,550,8
76,34,213400971,34097,Félines-Minervois,492,484,8
76,34,213400989,34098,Ferrals-les-Montagnes,156,151,5
76,34,213400997,34099,Ferrières-les-Verreries,48,47,1
76,34,213401003,34100,Ferrières-Poussarou,56,52,4
76,34,213401011,34101,Florensac,5116,5035,81
76,34,213401029,34102,Fontanès,359,350,9
76,34,213401037,34103,Fontès,1071,1052,19
76,34,213401045,34104,Fos,129,128,1
76,34,213401052,34105,Fouzilhon,258,251,7
76,34,213401060,34106,Fozières,195,186,9
76,34,213401078,34107,Fraisse-sur-Agout,341,338,3
76,34,213401086,34108,Frontignan,23705,23485,220
76,34,213401094,34109,Gabian,863,845,18
76,34,213401102,34110,Galargues,770,743,27
76,34,213401110,34111,Ganges,4216,4114,102
76,34,213401128,34112,Garrigues,227,222,5
76,34,213401136,34113,Gigean,6642,6563,79
76,34,213401144,34114,Gignac,6725,6609,116
76,34,213401151,34115,Gorniès,113,113,0
76,34,213401169,34116,Grabels,8981,8885,96
76,34,213401177,34117,Graissessac,595,585,10
76,34,213401185,34118,Guzargues,510,498,12
76,34,213401193,34119,Hérépian,1551,1526,25
76,34,213401201,34120,Jacou,6896,6794,102
76,34,213401219,34121,Joncels,285,271,14
76,34,213401227,34122,Jonquières,561,554,7
76,34,213401235,34123,Juvignac,12203,12104,99
76,34,213401243,34124,Lacoste,316,306,10
76,34,213401250,34125,Lagamas,115,111,4
76,34,213401268,34126,Lamalou-les-Bains,2501,2483,18
76,34,213401276,34127,Lansargues,3139,3096,43
76,34,213401284,34128,Laroque,1672,1640,32
76,34,213401292,34129,Lattes,17909,17674,235
76,34,213401300,34130,Laurens,1805,1776,29
76,34,213401318,34131,Lauret,652,632,20
76,34,213401326,34132,Lauroux,206,204,2
76,34,213401334,34133,Lavalette,54,54,0
76,34,213401342,34134,Lavérune,3382,3330,52
76,34,213401359,34135,Lespignan,3371,3318,53
76,34,213401367,34136,Lézignan-la-Cèbe,1594,1567,27
76,34,213401375,34137,Liausson,156,149,7
76,34,213401383,34138,Lieuran-Cabrières,342,335,7
76,34,213401391,34139,Lieuran-lès-Béziers,1419,1380,39
76,34,213401409,34140,Lignan-sur-Orb,3275,3221,54
76,34,213401417,34141,La Livinière,529,521,8
76,34,213401425,34142,Lodève,7618,7382,236
76,34,213401433,34143,Loupian,2245,2206,39
76,34,213401441,34144,Lunas,689,668,21
76,34,213401458,34145,Lunel,26626,26356,270
76,34,213401466,34146,Lunel-Viel,4530,4484,46
76,34,213401474,34147,Magalas,3490,3424,66
76,34,213401482,34148,Maraussan,4727,4650,77
76,34,213401490,34149,Margon,726,724,2
76,34,213401508,34150,Marseillan,7797,7692,105
76,34,213401516,34151,Marsillargues,6472,6395,77
76,34,213401524,34152,Mas-de-Londres,682,672,10
76,34,213401532,34153,Les Matelles,2076,2026,50
76,34,213401540,34154,Mauguio,16912,16714,198
76,34,213401557,34155,Maureilhan,2389,2342,47
76,34,213401565,34156,Mérifons,50,47,3
76,34,213401573,34157,Mèze,12549,12385,164
76,34,213401581,34158,Minerve,102,101,1
76,34,213401599,34159,Mireval,3355,3304,51
76,34,213401607,34160,Mons,667,650,17
76,34,213401615,34161,Montady,4063,3990,73
76,34,213401623,34162,Montagnac,4378,4318,60
76,34,213401631,34163,Montarnaud,4194,4145,49
76,34,213401649,34164,Montaud,1051,1039,12
76,34,213401656,34165,Montbazin,2992,2933,59
76,34,213401664,34166,Montblanc,2919,2868,51
76,34,213401672,34167,Montels,253,249,4
76,34,213401680,34168,Montesquieu,75,75,0
76,34,213401698,34169,Montferrier-sur-Lez,4178,4014,164
76,34,213401706,34170,Montouliers,216,211,5
76,34,213401714,34171,Montoulieu,177,173,4
76,34,213401722,34172,Montpellier,302425,299096,3329
76,34,213401730,34173,Montpeyroux,1398,1374,24
76,34,213401748,34174,Moulès-et-Baucels,887,861,26
76,34,213401755,34175,Mourèze,220,215,5
76,34,213401763,34176,Mudaison,2856,2825,31
76,34,213401771,34177,Murles,354,343,11
76,34,213401789,34178,Murviel-lès-Béziers,3167,3112,55
76,34,213401797,34179,Murviel-lès-Montpellier,1885,1856,29
76,34,213401805,34180,Nébian,1475,1451,24
76,34,213401813,34181,Neffiès,1055,1030,25
76,34,213401821,34182,Nézignan-l'Évêque,1828,1795,33
76,34,213401839,34183,Nissan-lez-Enserune,4094,4020,74
76,34,213401847,34184,Nizas,684,669,15
76,34,213401854,34185,Notre-Dame-de-Londres,534,522,12
76,34,213401862,34186,Octon,532,520,12
76,34,213401870,34187,Olargues,618,608,10
76,34,213401888,34188,Olmet-et-Villecun,191,187,4
76,34,213401896,34189,Olonzac,1703,1684,19
76,34,213401904,34190,Oupia,257,250,7
76,34,213401912,34191,Pailhès,583,571,12
76,34,213401920,34192,Palavas-les-Flots,5785,5748,37
76,34,213401938,34193,Pardailhan,180,174,6
76,34,213401946,34194,Paulhan,4076,4024,52
76,34,213401953,34195,Pégairolles-de-Buèges,57,56,1
76,34,213401961,34196,Pégairolles-de-l'Escalette,160,156,4
76,34,213401979,34197,Péret,1086,1070,16
76,34,213401987,34198,Pérols,9562,9438,124
76,34,213401995,34199,Pézenas,8110,7857,253
76,34,213402001,34200,Pézènes-les-Mines,244,234,10
76,34,213402019,34201,Pierrerue,299,292,7
76,34,213402027,34202,Pignan,8333,8218,115
76,34,213402035,34203,Pinet,2011,1987,24
76,34,213402043,34204,Plaissan,1501,1482,19
76,34,213402050,34205,Les Plans,300,293,7
76,34,213402068,34206,Poilhes,548,537,11
76,34,213402076,34207,Pomérols,2194,2151,43
76,34,213402084,34208,Popian,371,356,15
76,34,213402092,34209,Portiragnes,3154,3090,64
76,34,213402100,34210,Le Pouget,2143,2096,47
76,34,213402118,34211,Le Poujol-sur-Orb,1003,970,33
76,34,213402126,34212,Poujols,186,181,5
76,34,213402134,34213,Poussan,6087,6008,79
76,34,213402142,34214,Pouzolles,1191,1173,18
76,34,213402159,34215,Pouzols,971,958,13
76,34,213402167,34216,Le Pradal,336,331,5
76,34,213402175,34217,Prades-le-Lez,6111,6007,104
76,34,213402183,34218,Prades-sur-Vernazobre,334,328,6
76,34,213402191,34219,Prémian,508,499,9
76,34,213402209,34220,Le Puech,260,255,5
76,34,213402217,34221,Puéchabon,517,506,11
76,34,213402225,34222,Puilacher,648,635,13
76,34,213402233,34223,Puimisson,1193,1174,19
76,34,213402241,34224,Puissalicon,1368,1349,19
76,34,213402258,34225,Puisserguier,3073,3026,47
76,34,213402266,34226,Quarante,1830,1804,26
76,34,213402274,34227,Restinclières,2213,2183,30
76,34,213402282,34228,Rieussec,87,82,5
76,34,213402290,34229,Riols,750,725,25
76,34,213402308,34230,Les Rives,151,147,4
76,34,213402316,34231,Romiguières,23,21,2
76,34,213402324,34232,Roquebrun,617,606,11
76,34,213402332,34233,Roqueredonde,213,210,3
76,34,213402340,34234,Roquessels,95,94,1
76,34,213402357,34235,Rosis,275,269,6
76,34,213402365,34236,Rouet,68,68,0
76,34,213402373,34237,Roujan,2263,2223,40
76,34,213402381,34238,Saint-André-de-Buèges,40,40,0
76,34,213402399,34239,Saint-André-de-Sangonis,6441,6334,107
76,34,213402407,34240,Saint-Aunès,4061,4026,35
76,34,213402415,34241,Saint-Bauzille-de-la-Sylve,917,903,14
76,34,213402423,34242,Saint-Bauzille-de-Montmel,1174,1147,27
76,34,213402431,34243,Saint-Bauzille-de-Putois,2045,2014,31
76,34,213402449,34244,Saint-Brès,3334,3293,41
76,34,213402456,34245,Saint-Chinian,1738,1704,34
76,34,200086296,34246,Entre-Vignes,2170,2133,37
76,34,213402472,34247,Saint-Clément-de-Rivière,5294,5048,246
76,34,213402480,34248,Sainte-Croix-de-Quintillargues,967,950,17
76,34,213402498,34249,Saint-Drézéry,2901,2839,62
76,34,213402506,34250,Saint-Étienne-d'Albagnan,306,299,7
76,34,213402514,34251,Saint-Étienne-de-Gourgas,537,523,14
76,34,213402522,34252,Saint-Étienne-Estréchoux,260,254,6
76,34,213402530,34253,Saint-Félix-de-l'Héras,34,33,1
76,34,213402548,34254,Saint-Félix-de-Lodez,1187,1156,31
76,34,213402555,34255,Saint-Gély-du-Fesc,10670,10397,273
76,34,213402563,34256,Saint-Geniès-des-Mourgues,2075,2041,34
76,34,213402571,34257,Saint-Geniès-de-Varensal,218,216,2
76,34,213402589,34258,Saint-Geniès-de-Fontedit,1704,1676,28
76,34,213402597,34259,Saint-Georges-d'Orques,5697,5628,69
76,34,213402605,34260,Saint-Gervais-sur-Mare,862,849,13
76,34,213402613,34261,Saint-Guilhem-le-Désert,251,243,8
76,34,213402621,34262,Saint-Guiraud,259,259,0
76,34,213402639,34263,Saint-Hilaire-de-Beauvoir,442,439,3
76,34,213402647,34264,Saint-Jean-de-Buèges,208,208,0
76,34,213402654,34265,Saint-Jean-de-Cornies,795,780,15
76,34,213402662,34266,Saint-Jean-de-Cuculles,521,514,7
76,34,213402670,34267,Saint-Jean-de-Fos,1776,1742,34
76,34,213402688,34268,Saint-Jean-de-la-Blaquière,672,654,18
76,34,213402696,34269,Saint-Jean-de-Minervois,144,141,3
76,34,213402704,34270,Saint-Jean-de-Védas,11984,11843,141
76,34,213402712,34271,Saint-Julien,219,216,3
76,34,213402720,34272,Saint-Just,3320,3290,30
76,34,213402738,34273,Saint-Martin-de-l'Arçon,129,129,0
76,34,213402746,34274,Saint-Martin-de-Londres,2817,2791,26
76,34,213402761,34276,Saint-Mathieu-de-Tréviers,4989,4893,96
76,34,213402779,34277,Saint-Maurice-Navacelles,190,184,6
76,34,213402787,34278,Saint-Michel,57,57,0
76,34,213402795,34279,Saint-Nazaire-de-Ladarez,325,322,3
76,34,213402803,34280,Saint-Nazaire-de-Pézan,618,610,8
76,34,213402811,34281,Saint-Pargoire,2393,2356,37
76,34,213402829,34282,Saint-Paul-et-Valmalle,1330,1310,20
76,34,213402837,34283,Saint-Pierre-de-la-Fage,133,131,2
76,34,213402845,34284,Saint-Pons-de-Thomières,1939,1749,190
76,34,213402852,34285,Saint-Pons-de-Mauchiens,649,638,11
76,34,213402860,34286,Saint-Privat,432,418,14
76,34,213402878,34287,Saint-Saturnin-de-Lucian,268,262,6
76,34,213402886,34288,Saint-Sériès,995,973,22
76,34,213402894,34289,Saint-Thibéry,2913,2875,38
76,34,213402902,34290,Saint-Vincent-de-Barbeyrargues,753,742,11
76,34,213402910,34291,Saint-Vincent-d'Olargues,363,358,5
76,34,213402928,34292,Salasc,316,310,6
76,34,213402936,34293,La Salvetat-sur-Agout,1148,1128,20
76,34,213402944,34294,Saturargues,1042,1022,20
76,34,213402951,34295,Saussan,1673,1640,33
76,34,213402969,34296,Saussines,1011,989,22
76,34,213402977,34297,Sauteyrargues,436,428,8
76,34,213402985,34298,Sauvian,5580,5483,97
76,34,213402993,34299,Sérignan,7985,7809,176
76,34,213403009,34300,Servian,5395,5301,94
76,34,213403017,34301,Sète,45175,44576,599
76,34,213403025,34302,Siran,754,748,6
76,34,213403033,34303,Sorbs,40,39,1
76,34,213403041,34304,Soubès,961,932,29
76,34,213403058,34305,Le Soulié,124,124,0
76,34,213403066,34306,Soumont,200,200,0
76,34,213403074,34307,Sussargues,2875,2818,57
76,34,213403082,34308,Taussac-la-Billière,468,455,13
76,34,213403090,34309,Teyran,4721,4640,81
76,34,213403108,34310,Thézan-lès-Béziers,3116,3040,76
76,34,213403116,34311,Tourbes,1940,1782,158
76,34,213403124,34312,La Tour-sur-Orb,1325,1301,24
76,34,213403132,34313,Tressan,709,685,24
76,34,213403140,34314,Le Triadou,647,633,14
76,34,213403157,34315,Usclas-d'Hérault,442,437,5
76,34,213403165,34316,Usclas-du-Bosc,238,236,2
76,34,213403173,34317,La Vacquerie-et-Saint-Martin-de-Castries,194,187,7
76,34,213403181,34318,Vacquières,747,735,12
76,34,213403199,34319,Vailhan,149,148,1
76,34,213403207,34320,Vailhauquès,2663,2609,54
76,34,213403215,34321,Valergues,2076,2049,27
76,34,213403223,34322,Valflaunès,789,775,14
76,34,213403231,34323,Valmascle,46,46,0
76,34,213403249,34324,Valras-Plage,4251,4188,63
76,34,213403256,34325,Valros,1675,1643,32
76,34,213403264,34326,Vélieux,93,93,0
76,34,213403272,34327,Vendargues,6857,6771,86
76,34,213403280,34328,Vendémian,1179,1154,25
76,34,213403298,34329,Vendres,2806,2728,78
76,34,213403314,34331,Verreries-de-Moussans,97,95,2
76,34,213403322,34332,Vias,5881,5804,77
76,34,213403330,34333,Vic-la-Gardiole,3459,3429,30
76,34,213403348,34334,Vieussan,270,270,0
76,34,213403355,34335,Villemagne-l'Argentière,437,424,13
76,34,213403363,34336,Villeneuve-lès-Béziers,4153,4099,54
76,34,213403371,34337,Villeneuve-lès-Maguelone,10582,10463,119
76,34,213403389,34338,Villeneuvette,71,68,3
76,34,213403397,34339,Villespassans,183,178,5
76,34,213403405,34340,Villetelle,1604,1558,46
76,34,213403413,34341,Villeveyrac,3978,3909,69
76,34,213403421,34342,Viols-en-Laval,216,212,4
76,34,213403439,34343,Viols-le-Fort,1271,1242,29
76,34,213403447,34344,La Grande-Motte,8721,8638,83
53,35,213500010,35001,Acigné,7029,6865,164
53,35,213500028,35002,Amanlis,1794,1759,35
53,35,213500036,35003,Andouillé-Neuville,984,976,8
53,35,200082980,35004,Val-Couesnon,4206,4119,87
53,35,213500051,35005,Arbrissel,305,299,6
53,35,213500069,35006,Argentré-du-Plessis,4662,4533,129
53,35,213500077,35007,Aubigné,491,489,2
53,35,213500085,35008,Availles-sur-Seiche,689,671,18
53,35,213500093,35009,Baguer-Morvan,1728,1702,26
53,35,213500101,35010,Baguer-Pican,1795,1779,16
53,35,213500127,35012,Bain-de-Bretagne,7583,7435,148
53,35,213500135,35013,Bains-sur-Oust,3662,3500,162
53,35,213500143,35014,Bais,2498,2466,32
53,35,213500150,35015,Balazé,2272,2224,48
53,35,213500168,35016,Baulon,2251,2191,60
53,35,213500176,35017,La Baussaine,684,675,9
53,35,213500184,35018,La Bazouge-du-Désert,1088,1067,21
53,35,213500192,35019,Bazouges-la-Pérouse,1892,1860,32
53,35,213500218,35021,Beaucé,1390,1355,35
53,35,213500226,35022,Bécherel,714,698,16
53,35,213500234,35023,Bédée,4533,4460,73
53,35,213500242,35024,Betton,12935,12637,298
53,35,213500259,35025,Billé,1073,1057,16
53,35,213500267,35026,Bléruais,107,101,6
53,35,213500275,35027,Boisgervilly,1769,1734,35
53,35,213500283,35028,Boistrudan,736,722,14
53,35,213500291,35029,Bonnemain,1551,1526,25
53,35,213500309,35030,La Bosse-de-Bretagne,707,690,17
53,35,213500317,35031,La Bouëxière,4651,4546,105
53,35,213500325,35032,Bourgbarré,4644,4579,65
53,35,213500333,35033,Bourg-des-Comptes,3390,3327,63
53,35,213500341,35034,La Boussac,1237,1215,22
53,35,213500358,35035,Bovel,605,595,10
53,35,213500374,35037,Bréal-sous-Montfort,6589,6506,83
53,35,213500382,35038,Bréal-sous-Vitré,647,626,21
53,35,213500390,35039,Brécé,2083,2040,43
53,35,213500408,35040,Breteil,3711,3632,79
53,35,213500416,35041,Brie,1030,1010,20
53,35,213500424,35042,Brielles,696,666,30
53,35,213500440,35044,Broualan,396,391,5
53,35,213500457,35045,Bruc-sur-Aff,878,862,16
53,35,213500465,35046,Les Brulais,542,534,8
53,35,213500473,35047,Bruz,19561,19090,471
53,35,213500499,35049,Cancale,5405,5313,92
53,35,213500507,35050,Cardroc,611,602,9
53,35,213500515,35051,Cesson-Sévigné,17799,17316,483
53,35,213500523,35052,Champeaux,522,511,11
53,35,213500549,35054,Chanteloup,1894,1847,47
53,35,213500556,35055,Chantepie,10411,10236,175
53,35,213500564,35056,La Chapelle-aux-Filtzméens,840,818,22
53,35,213500572,35057,La Chapelle-Bouëxic,1530,1505,25
53,35,213500580,35058,La Chapelle-Chaussée,1317,1302,15
53,35,213500598,35059,La Chapelle-des-Fougeretz,4722,4628,94
53,35,200054880,35060,La Chapelle du Lou du Lac,1036,1017,19
53,35,213500614,35061,La Chapelle-Erbrée,738,722,16
53,35,213500622,35062,La Chapelle-Janson,1510,1483,27
53,35,213500630,35063,La Chapelle-Saint-Aubert,462,455,7
53,35,213500648,35064,La Chapelle-de-Brain,1036,1023,13
53,35,213500655,35065,La Chapelle-Thouarault,2287,2244,43
53,35,213500663,35066,Chartres-de-Bretagne,8327,8190,137
53,35,213500671,35067,Chasné-sur-Illet,1656,1628,28
53,35,213500689,35068,Châteaubourg,7673,7516,157
53,35,200064483,35069,Châteaugiron,10808,10541,267
53,35,213500705,35070,Châteauneuf-d'Ille-et-Vilaine,1729,1704,25
53,35,213500713,35071,Le Châtellier,443,433,10
53,35,213500721,35072,Châtillon-en-Vendelais,1700,1664,36
53,35,213500754,35075,Chauvigné,830,807,23
53,35,213500762,35076,Chavagne,4350,4268,82
53,35,213500770,35077,Chelun,356,346,10
53,35,213500788,35078,Cherrueix,1111,1089,22
53,35,213500796,35079,Chevaigné,2408,2355,53
53,35,213500804,35080,Cintré,2540,2476,64
53,35,213500812,35081,Clayes,940,910,30
53,35,213500820,35082,Coësmes,1491,1456,35
53,35,213500846,35084,Comblessac,699,689,10
53,35,213500853,35085,Combourg,6206,6082,124
53,35,213500861,35086,Combourtillé,621,612,9
53,35,213500879,35087,Cornillé,1001,969,32
53,35,213500887,35088,Corps-Nuds,3581,3526,55
53,35,213500895,35089,La Couyère,464,453,11
53,35,213500903,35090,Crevin,2891,2838,53
53,35,213500911,35091,Le Crouais,602,595,7
53,35,213500929,35092,Cuguen,846,832,14
53,35,213500937,35093,Dinard,10755,10235,520
53,35,213500945,35094,Dingé,1688,1660,28
53,35,213500952,35095,Dol-de-Bretagne,6110,5761,349
53,35,213500960,35096,Domagné,2477,2422,55
53,35,213500978,35097,Domalain,2070,2020,50
53,35,213500986,35098,La Dominelais,1427,1397,30
53,35,213500994,35099,Domloup,3823,3756,67
53,35,213501018,35101,Dourdain,1234,1212,22
53,35,213501026,35102,Drouges,515,505,10
53,35,213501034,35103,Eancé,438,428,10
53,35,213501042,35104,Epiniac,1453,1426,27
53,35,213501059,35105,Erbrée,1788,1734,54
53,35,213501067,35106,Ercé-en-Lamée,1553,1532,21
53,35,213501075,35107,Ercé-près-Liffré,2001,1965,36
53,35,213501083,35108,Essé,1071,1050,21
53,35,213501091,35109,Étrelles,2677,2610,67
53,35,213501109,35110,Feins,1046,1026,20
53,35,213501117,35111,Le Ferré,728,722,6
53,35,213501125,35112,Fleurigné,953,927,26
53,35,213501141,35114,Forges-la-Forêt,265,259,6
53,35,213501158,35115,Fougères,21121,20505,616
53,35,213501166,35116,La Fresnais,2597,2546,51
53,35,213501174,35117,Gaël,1642,1620,22
53,35,213501182,35118,Gahard,1559,1524,35
53,35,213501190,35119,Gennes-sur-Seiche,963,943,20
53,35,213501208,35120,Gévezé,5796,5685,111
53,35,213501216,35121,Gosné,2061,2025,36
53,35,213501224,35122,La Gouesnière,2015,1968,47
53,35,213501232,35123,Goven,4410,4323,87
53,35,213501240,35124,Grand-Fougeray,2493,2455,38
53,35,213501257,35125,La Guerche-de-Bretagne,4392,4245,147
53,35,213501265,35126,Guichen,8968,8763,205
53,35,213501273,35127,Guignen,4120,4027,93
53,35,213501281,35128,Guipel,1754,1714,40
53,35,213501307,35130,Hédé-Bazouges,2335,2283,52
53,35,213501315,35131,L'Hermitage,4726,4647,79
53,35,213501323,35132,Hirel,1425,1391,34
53,35,213501331,35133,Iffendic,4667,4567,100
53,35,213501349,35134,Les Iffs,285,273,12
53,35,213501356,35135,Irodouër,2300,2263,37
53,35,213501364,35136,Janzé,8687,8523,164
53,35,213501372,35137,Javené,2187,2116,71
53,35,213501380,35138,Laignelet,1220,1190,30
53,35,213501398,35139,Laillé,5311,5162,149
53,35,213501406,35140,Lalleu,565,557,8
53,35,213501414,35141,Landavran,712,691,21
53,35,213501422,35142,Landéan,1198,1176,22
53,35,213501430,35143,Landujan,953,924,29
53,35,213501448,35144,Langan,1084,1064,20
53,35,213501455,35145,Langon,1397,1372,25
53,35,213501463,35146,Langouet,612,610,2
53,35,213501489,35148,Lanrigan,159,159,0
53,35,213501497,35149,Lassy,1812,1772,40
53,35,213501505,35150,Lécousse,3378,3279,99
53,35,213501513,35151,Lieuron,806,787,19
53,35,213501521,35152,Liffré,8265,8129,136
53,35,213501539,35153,Lillemer,381,370,11
53,35,213501547,35154,Livré-sur-Changeon,1765,1723,42
53,35,213501554,35155,Lohéac,676,665,11
53,35,213501562,35156,Longaulnay,620,610,10
53,35,213501570,35157,Le Loroux,657,635,22
53,35,213501596,35159,Lourmais,327,324,3
53,35,213501604,35160,Loutehel,248,243,5
53,35,213501612,35161,Louvigné-de-Bais,1939,1900,39
53,35,213501620,35162,Louvigné-du-Désert,3397,3335,62
53,35,200084002,35163,Luitré-Dompierre,1848,1818,30
53,35,213501646,35164,Marcillé-Raoul,749,735,14
53,35,213501653,35165,Marcillé-Robert,970,947,23
53,35,213501661,35166,Marpiré,1049,1022,27
53,35,213501679,35167,Martigné-Ferchaud,2659,2604,55
53,35,200064475,35168,Val d'Anast,4025,3943,82
53,35,213501695,35169,Maxent,1484,1467,17
53,35,213501703,35170,Mecé,620,606,14
53,35,213501711,35171,Médréac,1870,1822,48
53,35,213501729,35172,Meillac,1959,1936,23
53,35,213501737,35173,Melesse,7218,7111,107
53,35,213501745,35174,Mellé,661,649,12
53,35,213501752,35175,Mernel,1021,1006,15
53,35,200054864,35176,Guipry-Messac,7323,7181,142
53,35,213501778,35177,La Mézière,5055,4935,120
53,35,213501786,35178,Mézières-sur-Couesnon,1794,1778,16
53,35,213501794,35179,Miniac-Morvan,4340,4257,83
53,35,213501802,35180,Miniac-sous-Bécherel,812,795,17
53,35,213501810,35181,Le Minihic-sur-Rance,1524,1488,36
53,35,213501836,35183,Mondevert,838,817,21
53,35,200085876,35184,Montauban-de-Bretagne,6487,6246,241
53,35,213501851,35185,Montautour,267,267,0
53,35,213501869,35186,Mont-Dol,1112,1082,30
53,35,213501877,35187,Monterfil,1379,1334,45
53,35,213501885,35188,Montfort-sur-Meu,6917,6743,174
53,35,213501893,35189,Montgermont,3630,3564,66
53,35,213501901,35190,Monthault,256,248,8
53,35,200065621,35191,Les Portes du Coglais,2329,2283,46
53,35,213501927,35192,Montreuil-des-Landes,238,233,5
53,35,213501935,35193,Montreuil-le-Gast,2025,1983,42
53,35,213501943,35194,Montreuil-sous-Pérouse,1064,1018,46
53,35,213501950,35195,Montreuil-sur-Ille,2453,2419,34
53,35,213501968,35196,Mordelles,7612,7485,127
53,35,213501976,35197,Mouazé,1780,1761,19
53,35,213501984,35198,Moulins,739,713,26
53,35,213501992,35199,Moussé,353,344,9
53,35,213502008,35200,Moutiers,943,914,29
53,35,213502016,35201,Muel,891,884,7
53,35,213502024,35202,La Noë-Blanche,1037,1017,20
53,35,213502032,35203,La Nouaye,358,353,5
53,35,213502040,35204,Nouvoitou,3440,3378,62
53,35,213502057,35205,Noyal-sous-Bazouges,384,376,8
53,35,213503642,35206,Noyal-Châtillon-sur-Seiche,7453,7318,135
53,35,213502073,35207,Noyal-sur-Vilaine,6281,6131,150
53,35,213502081,35208,Orgères,5471,5341,130
53,35,213502107,35210,Pacé,12358,12004,354
53,35,213502115,35211,Paimpont,1827,1784,43
53,35,213502123,35212,Pancé,1227,1196,31
53,35,213502149,35214,Parcé,655,650,5
53,35,213502156,35215,Parigné,1371,1328,43
53,35,213502164,35216,Parthenay-de-Bretagne,1821,1794,27
53,35,213502172,35217,Le Pertre,1405,1377,28
53,35,213502180,35218,Le Petit-Fougeray,903,885,18
53,35,213502198,35219,Pipriac,3923,3847,76
53,35,200085884,35220,Piré-Chancé,3152,3096,56
53,35,213502214,35221,Pléchâtel,2833,2780,53
53,35,213502222,35222,Pleine-Fougères,2001,1971,30
53,35,213502230,35223,Plélan-le-Grand,4116,4030,86
53,35,213502248,35224,Plerguer,2880,2826,54
53,35,213502255,35225,Plesder,795,780,15
53,35,213502263,35226,Pleugueneuc,2010,1972,38
53,35,213502271,35227,Pleumeleuc,3562,3499,63
53,35,213502289,35228,Pleurtuit,7085,6959,126
53,35,213502297,35229,Pocé-les-Bois,1377,1324,53
53,35,213502305,35230,Poilley,374,370,4
53,35,213502313,35231,Poligné,1244,1212,32
53,35,213502321,35232,Princé,403,397,6
53,35,213502339,35233,Québriac,1619,1581,38
53,35,213502347,35234,Quédillac,1243,1218,25
53,35,213502354,35235,Rannée,1119,1073,46
53,35,213502362,35236,Redon,10060,9315,745
53,35,213502370,35237,Renac,1063,1040,23
53,35,213502388,35238,Rennes,226654,222485,4169
53,35,213502396,35239,Retiers,4599,4503,96
53,35,213502404,35240,Le Rheu,9482,9247,235
53,35,213502412,35241,La Richardais,2564,2476,88
53,35,213502420,35242,Rimou,351,347,4
53,35,213502438,35243,Romagné,2505,2446,59
53,35,213502446,35244,Romazy,262,257,5
53,35,213502453,35245,Romillé,4157,4085,72
53,35,213502461,35246,Roz-Landrieux,1397,1368,29
53,35,213502479,35247,Roz-sur-Couesnon,1012,1000,12
53,35,213502487,35248,Sains,466,458,8
53,35,213502495,35249,Sainte-Anne-sur-Vilaine,1051,1034,17
53,35,213502503,35250,Saint-Armel,2259,2219,40
53,35,213502511,35251,Saint-Aubin-d'Aubigné,4166,4085,81
53,35,213502529,35252,Saint-Aubin-des-Landes,944,910,34
53,35,213502537,35253,Saint-Aubin-du-Cormier,4240,4052,188
53,35,213502552,35255,Saint-Benoît-des-Ondes,1007,972,35
53,35,213502560,35256,Saint-Briac-sur-Mer,2269,2205,64
53,35,200064517,35257,Maen Roch,5126,5033,93
53,35,213502586,35258,Saint-Brieuc-des-Iffs,337,328,9
53,35,213502594,35259,Saint-Broladre,1163,1143,20
53,35,213502602,35260,Saint-Christophe-des-Bois,566,560,6
53,35,213502610,35261,Saint-Christophe-de-Valains,237,235,2
53,35,213502628,35262,Sainte-Colombe,361,356,5
53,35,213502636,35263,Saint-Coulomb,2952,2870,82
53,35,213502644,35264,Saint-Didier,2070,2025,45
53,35,213502651,35265,Saint-Domineuc,2600,2553,47
53,35,213502669,35266,Saint-Erblon,3504,3428,76
53,35,213502685,35268,Saint-Ganton,435,424,11
53,35,213502701,35270,Saint-Georges-de-Gréhaigne,376,371,5
53,35,213502719,35271,Saint-Georges-de-Reintembault,1512,1487,25
53,35,213502727,35272,Saint-Germain-du-Pinel,991,969,22
53,35,213502735,35273,Saint-Germain-en-Coglès,2102,2071,31
53,35,213502743,35274,Saint-Germain-sur-Ille,999,982,17
53,35,213502750,35275,Saint-Gilles,5400,5312,88
53,35,213502768,35276,Saint-Gondran,596,586,10
53,35,213502776,35277,Saint-Gonlay,383,377,6
53,35,213502784,35278,Saint-Grégoire,10252,9881,371
53,35,213502792,35279,Saint-Guinoux,1233,1206,27
53,35,213502800,35280,Saint-Hilaire-des-Landes,1051,1030,21
53,35,213502818,35281,Saint-Jacques-de-la-Lande,14104,13955,149
53,35,200084010,35282,Rives-du-Couesnon,2959,2909,50
53,35,213502834,35283,Saint-Jean-sur-Vilaine,1392,1368,24
53,35,213502842,35284,Saint-Jouan-des-Guérets,2831,2759,72
53,35,213502859,35285,Saint-Just,1091,1070,21
53,35,213502867,35286,Saint-Léger-des-Prés,299,289,10
53,35,213502875,35287,Saint-Lunaire,2589,2500,89
53,35,213502883,35288,Saint-Malo,48328,46995,1333
53,35,213502891,35289,Saint-Malo-de-Phily,1090,1072,18
53,35,213502909,35290,Saint-Malon-sur-Mel,598,589,9
53,35,213502917,35291,Saint-Marcan,445,436,9
53,35,200084069,35292,Saint-Marc-le-Blanc,1648,1605,43
53,35,213502941,35294,Sainte-Marie,2338,2273,65
53,35,213502958,35295,Saint-Maugan,544,533,11
53,35,213502966,35296,Saint-Médard-sur-Ille,1335,1312,23
53,35,213502974,35297,Saint-Méen-le-Grand,4732,4576,156
53,35,213502990,35299,Saint-Méloir-des-Ondes,4555,4444,111
53,35,213503006,35300,Saint-M'Hervé,1397,1357,40
53,35,213503022,35302,Saint-Onen-la-Chapelle,1138,1113,25
53,35,213503048,35304,Saint-Ouen-des-Alleux,1350,1321,29
53,35,213503055,35305,Saint-Péran,426,418,8
53,35,213503063,35306,Saint-Père-Marc-en-Poulet,2510,2346,164
53,35,213503071,35307,Saint-Pern,1061,1042,19
53,35,200085868,35308,Mesnil-Roc'h,4463,4387,76
53,35,213503097,35309,Saint-Rémy-du-Plain,827,815,12
53,35,213503105,35310,Saint-Sauveur-des-Landes,1570,1543,27
53,35,213503113,35311,Saint-Séglin,590,587,3
53,35,213503121,35312,Saint-Senoux,1873,1824,49
53,35,213503147,35314,Saint-Suliac,1012,961,51
53,35,213503154,35315,Saint-Sulpice-la-Forêt,1479,1440,39
53,35,213503162,35316,Saint-Sulpice-des-Landes,849,842,7
53,35,200011062,35317,Saint-Symphorien,648,587,61
53,35,213503188,35318,Saint-Thual,996,973,23
53,35,213503196,35319,Saint-Thurial,2170,2128,42
53,35,213503204,35320,Saint-Uniac,540,531,9
53,35,213503212,35321,Saulnières,800,791,9
53,35,213503220,35322,Le Sel-de-Bretagne,1140,1110,30
53,35,213503246,35324,La Selle-en-Luitré,633,617,16
53,35,213503253,35325,La Selle-Guerchaise,158,152,6
53,35,213503261,35326,Sens-de-Bretagne,2643,2598,45
53,35,213503279,35327,Servon-sur-Vilaine,3909,3823,86
53,35,213503287,35328,Sixt-sur-Aff,2188,2144,44
53,35,213503295,35329,Sougeal,547,537,10
53,35,213503303,35330,Taillis,1030,1008,22
53,35,213503311,35331,Talensac,2568,2503,65
53,35,213503329,35332,Teillay,1085,1075,10
53,35,213503337,35333,Le Theil-de-Bretagne,1751,1718,33
53,35,213503345,35334,Thorigné-Fouillard,8796,8584,212
53,35,213503352,35335,Thourie,877,854,23
53,35,213503360,35336,Le Tiercent,190,186,4
53,35,213503378,35337,Tinténiac,3967,3774,193
53,35,213503386,35338,Torcé,1270,1241,29
53,35,213503394,35339,Trans-la-Forêt,617,606,11
53,35,213503402,35340,Treffendel,1343,1314,29
53,35,213503428,35342,Trémeheuc,358,346,12
53,35,213503436,35343,Tresboeuf,1257,1238,19
53,35,213503451,35345,Trévérien,916,903,13
53,35,213503469,35346,Trimer,210,206,4
53,35,213503477,35347,Val-d'Izé,2633,2576,57
53,35,213503501,35350,Vergéal,823,805,18
53,35,213503519,35351,Le Verger,1459,1435,24
53,35,213503527,35352,Vern-sur-Seiche,8442,8289,153
53,35,213503535,35353,Vezin-le-Coquet,6307,6234,73
53,35,213503543,35354,Vieux-Viel,322,320,2
53,35,213503550,35355,Vieux-Vy-sur-Couesnon,1276,1267,9
53,35,213503568,35356,Vignoc,2149,2115,34
53,35,213503576,35357,Villamée,306,300,6
53,35,213503584,35358,La Ville-ès-Nonais,1252,1221,31
53,35,213503592,35359,Visseiche,858,841,17
53,35,213503600,35360,Vitré,19171,18603,568
53,35,213503618,35361,Le Vivier-sur-Mer,1071,1063,8
53,35,213503626,35362,Le Tronchet,1203,1193,10
53,35,213503634,35363,Pont-Péan,4495,4389,106
24,36,213600018,36001,Aigurande,1412,1390,22
24,36,213600026,36002,Aize,118,116,2
24,36,213600034,36003,Ambrault,909,890,19
24,36,213600042,36004,Anjouin,327,318,9
24,36,213600059,36005,Ardentes,3905,3825,80
24,36,213600067,36006,Argenton-sur-Creuse,5077,4865,212
24,36,213600075,36007,Argy,613,604,9
24,36,213600083,36008,Arpheuilles,234,228,6
24,36,213600091,36009,Arthon,1263,1221,42
24,36,213600109,36010,Azay-le-Ferron,889,870,19
24,36,213600117,36011,Bagneux,176,174,2
24,36,213600125,36012,Baraize,366,366,0
24,36,213600133,36013,Baudres,427,419,8
24,36,213600141,36014,Bazaiges,204,198,6
24,36,213600158,36015,Beaulieu,54,53,1
24,36,213600166,36016,Bélâbre,953,934,19
24,36,213600174,36017,La Berthenoux,373,367,6
24,36,213600182,36018,Le Blanc,6449,6229,220
24,36,213600190,36019,Bommiers,317,312,5
24,36,213600208,36020,Bonneuil,74,74,0
24,36,213600216,36021,Les Bordes,908,888,20
24,36,213600224,36022,Bouesse,404,396,8
24,36,213600232,36023,Bouges-le-Château,266,261,5
24,36,213600240,36024,Bretagne,128,127,1
24,36,213600257,36025,Briantes,622,611,11
24,36,213600265,36026,Brion,614,604,10
24,36,213600273,36027,Brives,251,245,6
24,36,213600281,36028,La Buxerette,120,117,3
24,36,213600299,36029,Buxeuil,237,234,3
24,36,213600307,36030,Buxières-d'Aillac,244,242,2
24,36,213600315,36031,Buzançais,4579,4507,72
24,36,213600323,36032,Ceaulmont,725,707,18
24,36,213600331,36033,Celon,398,394,4
24,36,213600349,36034,Chabris,2806,2762,44
24,36,213600356,36035,Chaillac,1084,1068,16
24,36,213600364,36036,Chalais,154,153,1
24,36,213600372,36037,La Champenoise,297,291,6
24,36,213600380,36038,Champillet,135,133,2
24,36,213600406,36040,La Chapelle-Orthemale,98,98,0
24,36,213600414,36041,La Chapelle-Saint-Laurian,137,136,1
24,36,213600422,36042,Chasseneuil,711,701,10
24,36,213600430,36043,Chassignolles,577,561,16
24,36,213600448,36044,Châteauroux,44890,43331,1559
24,36,213600455,36045,Châtillon-sur-Indre,2359,2326,33
24,36,213600463,36046,La Châtre,4165,4048,117
24,36,213600471,36047,La Châtre-Langlin,509,501,8
24,36,213600489,36048,Chavin,278,269,9
24,36,213600497,36049,Chazelet,126,124,2
24,36,213600505,36050,Chezelles,458,448,10
24,36,213600513,36051,Chitray,183,181,2
24,36,213600521,36052,Chouday,157,155,2
24,36,213600539,36053,Ciron,540,528,12
24,36,213600547,36054,Cléré-du-Bois,241,233,8
24,36,213600554,36055,Clion,1014,996,18
24,36,213600562,36056,Cluis,998,981,17
24,36,213600570,36057,Coings,902,878,24
24,36,213600588,36058,Concremiers,644,628,16
24,36,213600596,36059,Condé,237,230,7
24,36,213600604,36060,Crevant,720,704,16
24,36,213600612,36061,Crozon-sur-Vauvre,339,330,9
24,36,213600620,36062,Cuzion,460,452,8
24,36,213600638,36063,Déols,7808,7659,149
24,36,213600646,36064,Diors,766,749,17
24,36,213600653,36065,Diou,265,260,5
24,36,213600661,36066,Douadic,465,452,13
24,36,213600679,36067,Dunet,106,103,3
24,36,213600687,36068,Dun-le-Poëlier,429,422,7
24,36,213600695,36069,Écueillé,1224,1202,22
24,36,213600703,36070,Éguzon-Chantôme,1362,1325,37
24,36,213600711,36071,Étrechet,1034,1015,19
24,36,213600737,36073,Feusines,216,211,5
24,36,213600745,36074,Fléré-la-Rivière,547,537,10
24,36,213600752,36075,Fontenay,91,90,1
24,36,213600760,36076,Fontgombault,253,250,3
24,36,213600778,36077,Fontguenand,251,248,3
24,36,213600786,36078,Fougerolles,365,355,10
24,36,213600794,36079,Francillon,78,77,1
24,36,213600802,36080,Frédille,73,73,0
24,36,213600810,36081,Gargilesse-Dampierre,284,276,8
24,36,213600828,36082,Gehée,254,250,4
24,36,213600836,36083,Giroux,121,118,3
24,36,213600844,36084,Gournay,286,284,2
24,36,213600851,36085,Guilly,256,249,7
24,36,213600869,36086,Heugnes,397,389,8
24,36,213600877,36087,Ingrandes,313,309,4
24,36,213600885,36088,Issoudun,11578,11314,264
24,36,213600893,36089,Jeu-les-Bois,414,408,6
24,36,213600901,36090,Jeu-Maloches,120,118,2
24,36,213600919,36091,Lacs,675,657,18
24,36,213600927,36092,Langé,273,266,7
24,36,200082204,36093,Levroux,2911,2883,28
24,36,213600943,36094,Lignac,467,452,15
24,36,213600950,36095,Lignerolles,110,108,2
24,36,213600968,36096,Lingé,209,206,3
24,36,213600976,36097,Liniez,331,323,8
24,36,213600984,36098,Lizeray,88,86,2
24,36,213600992,36099,Lourdoueix-Saint-Michel,304,299,5
24,36,213601008,36100,Lourouer-Saint-Laurent,264,257,7
24,36,213601016,36101,Luant,1585,1544,41
24,36,213601024,36102,Luçay-le-Libre,105,103,2
24,36,213601032,36103,Luçay-le-Mâle,1344,1324,20
24,36,213601040,36104,Lurais,228,226,2
24,36,213601057,36105,Lureuil,264,263,1
24,36,213601065,36106,Luzeret,156,155,1
24,36,213601073,36107,Lye,751,740,11
24,36,213601081,36108,Lys-Saint-Georges,212,210,2
24,36,213601099,36109,Le Magny,1058,1038,20
24,36,213601107,36110,Maillet,266,260,6
24,36,213601115,36111,Malicornay,196,193,3
24,36,213601123,36112,Mâron,762,743,19
24,36,213601131,36113,Martizay,955,935,20
24,36,213601149,36114,Mauvières,302,299,3
24,36,213601156,36115,Menetou-sur-Nahon,132,130,2
24,36,213601164,36116,Ménétréols-sous-Vatan,122,118,4
24,36,213601172,36117,Le Menoux,432,424,8
24,36,213601180,36118,Méobecq,383,380,3
24,36,213601198,36119,Mérigny,554,541,13
24,36,213601206,36120,Mers-sur-Indre,683,667,16
24,36,213601214,36121,Meunet-Planches,178,171,7
24,36,213601222,36122,Meunet-sur-Vatan,198,196,2
24,36,213601230,36123,Mézières-en-Brenne,1006,985,21
24,36,213601248,36124,Migné,264,259,5
24,36,213601255,36125,Migny,120,115,5
24,36,213601263,36126,Montchevrier,452,446,6
24,36,213601271,36127,Montgivray,1584,1554,30
24,36,213601289,36128,Montierchaume,1838,1665,173
24,36,213601297,36129,Montipouret,588,575,13
24,36,213601305,36130,Montlevicq,106,104,2
24,36,213601313,36131,Mosnay,477,470,7
24,36,213601321,36132,La Motte-Feuilly,72,69,3
24,36,213601339,36133,Mouhers,216,210,6
24,36,213601347,36134,Mouhet,407,396,11
24,36,213601354,36135,Moulins-sur-Céphons,293,289,4
24,36,213601362,36136,Murs,132,129,3
24,36,213601370,36137,Néons-sur-Creuse,378,362,16
24,36,213601388,36138,Néret,191,187,4
24,36,213601396,36139,Neuillay-les-Bois,676,659,17
24,36,213601404,36140,Neuvy-Pailloux,1185,1167,18
24,36,213601412,36141,Neuvy-Saint-Sépulchre,1688,1651,37
24,36,213601420,36142,Niherne,1562,1529,33
24,36,213601438,36143,Nohant-Vic,462,448,14
24,36,213601446,36144,Nuret-le-Ferron,298,291,7
24,36,213601453,36145,Obterre,197,193,4
24,36,213601461,36146,Orsennes,723,713,10
24,36,213601479,36147,Orville,141,138,3
24,36,213601487,36148,Oulches,413,410,3
24,36,213601495,36149,Palluau-sur-Indre,810,798,12
24,36,213601503,36150,Parnac,509,501,8
24,36,213601529,36152,Paudy,439,437,2
24,36,213601537,36153,Paulnay,355,347,8
24,36,213601545,36154,Le Pêchereau,1892,1854,38
24,36,213601552,36155,Pellevoisin,853,797,56
24,36,213601560,36156,Pérassay,388,385,3
24,36,213601578,36157,La Pérouille,464,451,13
24,36,213601586,36158,Badecon-le-Pin,779,771,8
24,36,213601594,36159,Le Poinçonnet,6013,5836,177
24,36,213601602,36160,Pommiers,215,210,5
24,36,213601610,36161,Le Pont-Chrétien-Chabenet,954,944,10
24,36,213601628,36162,Poulaines,836,817,19
24,36,213601636,36163,Pouligny-Notre-Dame,654,643,11
24,36,213601644,36164,Pouligny-Saint-Martin,230,227,3
24,36,213601651,36165,Pouligny-Saint-Pierre,1060,1031,29
24,36,213601669,36166,Préaux,174,168,6
24,36,213601677,36167,Preuilly-la-Ville,157,154,3
24,36,213601685,36168,Prissac,598,582,16
24,36,213601693,36169,Pruniers,517,506,11
24,36,213601701,36170,Reboursin,101,101,0
24,36,213601719,36171,Reuilly,2034,2003,31
24,36,213601727,36172,Rivarennes,520,509,11
24,36,213601735,36173,Rosnay,532,519,13
24,36,213601743,36174,Roussines,364,358,6
24,36,213601750,36175,Rouvres-les-Bois,274,273,1
24,36,213601768,36176,Ruffec,587,580,7
24,36,213601776,36177,Sacierges-Saint-Martin,325,319,6
24,36,213601784,36178,Saint-Aigny,286,274,12
24,36,213601792,36179,Saint-Aoustrille,235,234,1
24,36,213601800,36180,Saint-Août,839,821,18
24,36,213601818,36181,Saint-Aubin,164,161,3
24,36,213601826,36182,Saint-Benoît-du-Sault,561,554,7
24,36,213601842,36184,Saint-Chartier,490,485,5
24,36,213601859,36185,Saint-Christophe-en-Bazelle,360,357,3
24,36,213601867,36186,Saint-Christophe-en-Boucherie,251,249,2
24,36,213601875,36187,Saint-Civran,135,134,1
24,36,213601883,36188,Saint-Cyran-du-Jambot,315,171,144
24,36,213601891,36189,Saint-Denis-de-Jouhet,979,966,13
24,36,213601909,36190,Sainte-Fauste,268,266,2
24,36,213601917,36191,Saint-Florentin,537,529,8
24,36,213601925,36192,Saint-Gaultier,1755,1734,21
24,36,213601933,36193,Sainte-Gemme,261,254,7
24,36,213601941,36194,Saint-Genou,961,944,17
24,36,213601958,36195,Saint-Georges-sur-Arnon,585,572,13
24,36,213601966,36196,Saint-Gilles,98,95,3
24,36,213601974,36197,Saint-Hilaire-sur-Benaize,302,299,3
24,36,213601982,36198,Saint-Lactencin,418,403,15
24,36,213601990,36199,Sainte-Lizaigne,1155,1132,23
24,36,213602006,36200,Saint-Marcel,1529,1505,24
24,36,200058055,36202,Saint-Maur,3771,3694,77
24,36,213602030,36203,Saint-Médard,54,54,0
24,36,213602048,36204,Saint-Michel-en-Brenne,328,322,6
24,36,213602055,36205,Saint-Pierre-de-Jards,105,102,3
24,36,213602071,36207,Saint-Plantaire,619,606,13
24,36,213602089,36208,Sainte-Sévère-sur-Indre,779,774,5
24,36,213602097,36209,Saint-Valentin,275,263,12
24,36,213602105,36210,Sarzay,310,299,11
24,36,213602113,36211,Sassierges-Saint-Germain,462,454,8
24,36,213602121,36212,Saulnay,163,158,5
24,36,213602139,36213,Sauzelles,260,255,5
24,36,213602147,36214,Sazeray,310,300,10
24,36,213602154,36215,Ségry,504,492,12
24,36,213602162,36216,Selles-sur-Nahon,63,63,0
24,36,213602170,36217,Sembleçay,101,98,3
24,36,213602188,36218,Sougé,152,147,5
24,36,213602196,36219,Tendu,667,650,17
24,36,213602204,36220,Thenay,907,889,18
24,36,213602212,36221,Thevet-Saint-Julien,396,386,10
24,36,213602220,36222,Thizay,241,235,6
24,36,213602238,36223,Tilly,145,141,4
24,36,213602246,36224,Tournon-Saint-Martin,1152,1127,25
24,36,213602253,36225,Le Tranger,185,184,1
24,36,213602261,36226,Tranzault,362,351,11
24,36,213602279,36227,Urciers,249,246,3
24,36,213602287,36228,Valençay,2383,2303,80
24,36,200056919,36229,Val-Fouzon,967,951,16
24,36,213602303,36230,Vatan,1976,1935,41
24,36,213602311,36231,Velles,989,969,20
24,36,213602329,36232,Vendoeuvres,1089,1066,23
24,36,213602337,36233,La Vernelle,771,760,11
24,36,213602345,36234,Verneuil-sur-Igneraie,341,335,6
24,36,213602352,36235,Veuil,385,377,8
24,36,213602360,36236,Vicq-Exemplet,320,315,5
24,36,213602378,36237,Vicq-sur-Nahon,724,704,20
24,36,213602386,36238,Vigoulant,100,99,1
24,36,213602394,36239,Vigoux,469,464,5
24,36,213602402,36240,Vijon,295,291,4
24,36,213602410,36241,Villedieu-sur-Indre,2725,2679,46
24,36,213602428,36242,Villegongis,107,106,1
24,36,213602436,36243,Villegouin,317,313,4
24,36,200085595,36244,Villentrois-Faverolles-en-Berry,879,873,6
24,36,213602469,36246,Villiers,170,168,2
24,36,213602477,36247,Vineuil,1261,1234,27
24,36,213602485,36248,Vouillon,232,229,3
24,37,213700016,37001,Abilly,1156,1140,16
24,37,213700024,37002,Ambillou,1781,1753,28
24,37,213700032,37003,Amboise,12936,12569,367
24,37,213700040,37004,Anché,437,426,11
24,37,213700057,37005,Antogny-le-Tillac,512,507,5
24,37,213700065,37006,Artannes-sur-Indre,2713,2660,53
24,37,213700073,37007,Assay,170,166,4
24,37,213700081,37008,Athée-sur-Cher,2794,2760,34
24,37,213700099,37009,Autrèche,440,430,10
24,37,213700107,37010,Auzouer-en-Touraine,2273,2209,64
24,37,213700115,37011,Avoine,1972,1933,39
24,37,213700123,37012,Avon-les-Roches,557,549,8
24,37,213700131,37013,Avrillé-les-Ponceaux,479,469,10
24,37,213700149,37014,Azay-le-Rideau,3574,3468,106
24,37,213700156,37015,Azay-sur-Cher,3158,3089,69
24,37,213700164,37016,Azay-sur-Indre,372,358,14
24,37,213700180,37018,Ballan-Miré,8225,8083,142
24,37,213700198,37019,Barrou,470,458,12
24,37,213700206,37020,Beaulieu-lès-Loches,1787,1754,33
24,37,200071124,37021,Beaumont-Louestault,1773,1742,31
24,37,213700222,37022,Beaumont-en-Véron,2770,2685,85
24,37,213700230,37023,Beaumont-Village,247,242,5
24,37,213700248,37024,Benais,934,917,17
24,37,213700255,37025,Berthenay,690,684,6
24,37,213700263,37026,Betz-le-Château,523,519,4
24,37,213700271,37027,Bléré,5329,5264,65
24,37,213700289,37028,Bossay-sur-Claise,756,733,23
24,37,213700297,37029,Bossée,332,327,5
24,37,213700305,37030,Le Boulay,804,796,8
24,37,213700313,37031,Bourgueil,3897,3808,89
24,37,213700321,37032,Bournan,281,274,7
24,37,213700339,37033,Boussay,208,204,4
24,37,213700347,37034,Braslou,315,306,9
24,37,213700354,37035,Braye-sous-Faye,297,287,10
24,37,213700362,37036,Braye-sur-Maulne,199,198,1
24,37,213700370,37037,Brèches,215,210,5
24,37,213700388,37038,Bréhémont,746,738,8
24,37,213700396,37039,Bridoré,497,484,13
24,37,213700404,37040,Brizay,265,256,9
24,37,213700412,37041,Bueil-en-Touraine,329,325,4
24,37,213700420,37042,Candes-Saint-Martin,188,185,3
24,37,213700438,37043,Cangey,1068,1043,25
24,37,213700446,37044,La Celle-Guenand,374,369,5
24,37,213700453,37045,La Celle-Saint-Avant,1064,1050,14
24,37,213700461,37046,Céré-la-Ronde,434,426,8
24,37,213700479,37047,Cerelles,1264,1237,27
24,37,213700487,37048,Chambon,328,322,6
24,37,213700495,37049,Chambourg-sur-Indre,1273,1248,25
24,37,213700503,37050,Chambray-lès-Tours,12221,11956,265
24,37,213700511,37051,Champigny-sur-Veude,826,818,8
24,37,213700529,37052,Chançay,1157,1131,26
24,37,213700537,37053,Chanceaux-près-Loches,124,117,7
24,37,213700545,37054,Chanceaux-sur-Choisille,3576,3529,47
24,37,213700552,37055,Channay-sur-Lathan,823,806,17
24,37,213700560,37056,La Chapelle-aux-Naux,578,567,11
24,37,213700578,37057,La Chapelle-Blanche-Saint-Martin,695,681,14
24,37,213700586,37058,La Chapelle-sur-Loire,1474,1448,26
24,37,213700594,37059,Charentilly,1349,1318,31
24,37,213700602,37060,Chargé,1349,1330,19
24,37,213700610,37061,Charnizay,505,490,15
24,37,213700628,37062,Château-la-Vallière,1738,1720,18
24,37,213700636,37063,Château-Renault,4977,4895,82
24,37,213700644,37064,Chaumussay,228,219,9
24,37,213700651,37065,Chaveignes,557,551,6
24,37,213700669,37066,Chédigny,564,559,5
24,37,213700677,37067,Cheillé,1834,1812,22
24,37,213700685,37068,Chemillé-sur-Dême,737,722,15
24,37,213700693,37069,Chemillé-sur-Indrois,240,232,8
24,37,213700701,37070,Chenonceaux,359,345,14
24,37,213700719,37071,Chezelles,132,131,1
24,37,213700727,37072,Chinon,8361,8063,298
24,37,213700735,37073,Chisseaux,594,580,14
24,37,213700743,37074,Chouzé-sur-Loire,2108,2085,23
24,37,213700750,37075,Cigogné,473,467,6
24,37,213700768,37076,Cinais,396,386,10
24,37,213700776,37077,Cinq-Mars-la-Pile,3874,3822,52
24,37,213700784,37078,Ciran,428,417,11
24,37,213700792,37079,Civray-de-Touraine,1839,1782,57
24,37,213700800,37080,Civray-sur-Esves,208,204,4
24,37,213700818,37081,Cléré-les-Pins,1418,1398,20
24,37,213700826,37082,Continvoir,461,458,3
24,37,213700834,37083,Cormery,1826,1800,26
24,37,213700842,37084,Couesmes,552,545,7
24,37,213700859,37085,Courçay,819,798,21
24,37,213700867,37086,Courcelles-de-Touraine,501,491,10
24,37,213700875,37087,Courcoué,253,244,9
24,37,213700883,37088,Couziers,109,108,1
24,37,213700891,37089,Cravant-les-Côteaux,660,642,18
24,37,213700909,37090,Crissay-sur-Manse,112,110,2
24,37,213700917,37091,La Croix-en-Touraine,2469,2410,59
24,37,213700925,37092,Crotelles,668,653,15
24,37,213700933,37093,Crouzilles,534,529,5
24,37,213700941,37094,Cussay,573,563,10
24,37,213700958,37095,Dame-Marie-les-Bois,352,345,7
24,37,213700966,37096,Dierre,638,628,10
24,37,213700974,37097,Dolus-le-Sec,693,670,23
24,37,213700982,37098,Draché,752,734,18
24,37,213700990,37099,Druye,979,967,12
24,37,213701006,37100,Épeigné-les-Bois,407,403,4
24,37,213701014,37101,Épeigné-sur-Dême,153,152,1
24,37,213701030,37103,Esves-le-Moutier,146,144,2
24,37,213701048,37104,Esvres,6271,6161,110
24,37,213701055,37105,Faye-la-Vineuse,265,259,6
24,37,213701063,37106,La Ferrière,327,323,4
24,37,213701071,37107,Ferrière-Larçon,239,234,5
24,37,213701089,37108,Ferrière-sur-Beaulieu,721,707,14
24,37,213701097,37109,Fondettes,11103,10585,518
24,37,213701105,37110,Francueil,1419,1386,33
24,37,213701113,37111,Genillé,1531,1496,35
24,37,213701121,37112,Gizeux,383,376,7
24,37,213701139,37113,Le Grand-Pressigny,891,871,20
24,37,213701147,37114,La Guerche,180,174,6
24,37,213701154,37115,Descartes,3386,3331,55
24,37,213701162,37116,Les Hermites,570,553,17
24,37,213701170,37117,Hommes,878,869,9
24,37,213701188,37118,Huismes,1446,1411,35
24,37,213701196,37119,L'Île-Bouchard,1556,1517,39
24,37,213701212,37121,Jaulnay,254,249,5
24,37,213701220,37122,Joué-lès-Tours,39143,38750,393
24,37,200065936,37123,Langeais,4411,4349,62
24,37,213701246,37124,Larçay,2541,2501,40
24,37,213701253,37125,Lémeré,498,492,6
24,37,213701261,37126,Lerné,348,340,8
24,37,213701279,37127,Le Liège,334,326,8
24,37,213701287,37128,Lignières-de-Touraine,1331,1306,25
24,37,213701295,37129,Ligré,1081,1060,21
24,37,213701303,37130,Ligueil,2147,2115,32
24,37,213701311,37131,Limeray,1285,1263,22
24,37,213701329,37132,Loches,6691,6165,526
24,37,213701337,37133,Loché-sur-Indrois,475,466,9
24,37,213701345,37134,Louans,692,678,14
24,37,213701360,37136,Le Louroux,530,527,3
24,37,213701378,37137,Lublé,141,138,3
24,37,213701386,37138,Lussault-sur-Loire,876,859,17
24,37,213701394,37139,Luynes,5236,5093,143
24,37,213701402,37140,Luzé,256,251,5
24,37,213701410,37141,Luzillé,975,957,18
24,37,213701428,37142,Maillé,569,563,6
24,37,213701436,37143,Manthelan,1384,1358,26
24,37,213701444,37144,Marçay,537,531,6
24,37,213701451,37145,Marcé-sur-Esves,243,241,2
24,37,213701469,37146,Marcilly-sur-Maulne,221,218,3
24,37,213701477,37147,Marcilly-sur-Vienne,576,563,13
24,37,213701485,37148,Marigny-Marmande,619,613,6
24,37,213701493,37149,Marray,487,479,8
24,37,213701501,37150,Mazières-de-Touraine,1429,1416,13
24,37,213701519,37151,La Membrolle-sur-Choisille,3356,3294,62
24,37,213701527,37152,Mettray,2123,2057,66
24,37,213701535,37153,Monnaie,4732,4678,54
24,37,213701543,37154,Montbazon,4694,4602,92
24,37,213701550,37155,Monthodon,650,642,8
24,37,213701568,37156,Montlouis-sur-Loire,11062,10895,167
24,37,213701576,37157,Montrésor,320,316,4
24,37,213701584,37158,Montreuil-en-Touraine,777,766,11
24,37,213701592,37159,Monts,8040,7896,144
24,37,213701600,37160,Morand,355,349,6
24,37,213701618,37161,Mosnes,825,809,16
24,37,213701626,37162,Mouzay,478,466,12
24,37,213701634,37163,Nazelles-Négron,3584,3525,59
24,37,213701659,37165,Neuil,441,436,5
24,37,213701667,37166,Neuillé-le-Lierre,791,784,7
24,37,213701675,37167,Neuillé-Pont-Pierre,2150,2127,23
24,37,213701683,37168,Neuilly-le-Brignon,296,287,9
24,37,213701691,37169,Neuville-sur-Brenne,955,927,28
24,37,213701709,37170,Neuvy-le-Roi,1145,1077,68
24,37,213701717,37171,Noizay,1153,1131,22
24,37,213701725,37172,Notre-Dame-d'Oé,4302,4221,81
24,37,213701733,37173,Nouans-les-Fontaines,723,714,9
24,37,213701741,37174,Nouâtre,825,809,16
24,37,213701758,37175,Nouzilly,1270,1239,31
24,37,213701766,37176,Noyant-de-Touraine,1228,1179,49
24,37,213701774,37177,Orbigny,728,712,16
24,37,213701782,37178,Panzoult,624,620,4
24,37,213701790,37179,Parçay-Meslay,2564,2530,34
24,37,213701808,37180,Parçay-sur-Vienne,638,632,6
24,37,213701816,37181,Paulmy,237,235,2
24,37,213701824,37182,Pernay,1466,1451,15
24,37,213701832,37183,Perrusson,1479,1452,27
24,37,213701840,37184,Le Petit-Pressigny,334,328,6
24,37,213701857,37185,Pocé-sur-Cisse,1765,1692,73
24,37,213701865,37186,Pont-de-Ruan,1228,1215,13
24,37,213701873,37187,Ports-sur-Vienne,366,359,7
24,37,213701881,37188,Pouzay,907,900,7
24,37,213701899,37189,Preuilly-sur-Claise,1027,1008,19
24,37,213701907,37190,Pussigny,166,164,2
24,37,213701915,37191,Razines,235,228,7
24,37,213701923,37192,Reignac-sur-Indre,1320,1302,18
24,37,213701931,37193,Restigné,1167,1141,26
24,37,213701949,37194,Reugny,1788,1755,33
24,37,213701956,37195,La Riche,10469,10372,97
24,37,213701964,37196,Richelieu,1671,1653,18
24,37,213701972,37197,Rigny-Ussé,524,511,13
24,37,213701980,37198,Rillé,317,315,2
24,37,213701998,37199,Rilly-sur-Vienne,470,462,8
24,37,213702004,37200,Rivarennes,1000,984,16
24,37,213702012,37201,Rivière,714,695,19
24,37,213702020,37202,La Roche-Clermault,541,530,11
24,37,213702038,37203,Rochecorbon,3255,3162,93
24,37,213702046,37204,Rouziers-de-Touraine,1367,1343,24
24,37,213702053,37205,Saché,1427,1411,16
24,37,213702061,37206,Saint-Antoine-du-Rocher,1803,1766,37
24,37,213702079,37207,Saint-Aubin-le-Dépeint,343,341,2
24,37,213702087,37208,Saint-Avertin,15409,15075,334
24,37,213702103,37210,Saint-Benoît-la-Forêt,864,847,17
24,37,213702111,37211,Saint-Branchs,2662,2628,34
24,37,213702129,37212,Sainte-Catherine-de-Fierbois,796,785,11
24,37,213702137,37213,Saint-Christophe-sur-le-Nais,1115,1092,23
24,37,213702145,37214,Saint-Cyr-sur-Loire,17286,16884,402
24,37,213702160,37216,Saint-Épain,1576,1543,33
24,37,213702178,37217,Saint-Étienne-de-Chigny,1657,1634,23
24,37,213702186,37218,Saint-Flovier,586,574,12
24,37,213702194,37219,Saint-Genouph,1044,1029,15
24,37,213702202,37220,Saint-Germain-sur-Vienne,364,360,4
24,37,213702210,37221,Saint-Hippolyte,625,618,7
24,37,213702228,37222,Saint-Jean-Saint-Germain,769,752,17
24,37,213702236,37223,Saint-Laurent-de-Lin,334,327,7
24,37,213702244,37224,Saint-Laurent-en-Gâtines,942,920,22
24,37,213702251,37225,Saint-Martin-le-Beau,3218,3169,49
24,37,213702269,37226,Sainte-Maure-de-Touraine,4199,4147,52
24,37,213702285,37228,Saint-Nicolas-de-Bourgueil,1125,1101,24
24,37,213702293,37229,Saint-Nicolas-des-Motets,251,243,8
24,37,213702301,37230,Saint-Ouen-les-Vignes,1001,982,19
24,37,213702319,37231,Saint-Paterne-Racan,1675,1650,25
24,37,200065969,37232,Coteaux-sur-Loire,1926,1887,39
24,37,213702335,37233,Saint-Pierre-des-Corps,16151,15898,253
24,37,213702343,37234,Saint-Quentin-sur-Indrois,506,491,15
24,37,213702368,37236,Saint-Règle,621,610,11
24,37,213702376,37237,Saint-Roch,1309,1281,28
24,37,213702384,37238,Saint-Senoch,534,526,8
24,37,213702400,37240,Saunay,699,687,12
24,37,213702418,37241,Savigné-sur-Lathan,1348,1328,20
24,37,213702426,37242,Savigny-en-Véron,1592,1560,32
24,37,213702434,37243,Savonnières,3329,3252,77
24,37,213702442,37244,Sazilly,260,256,4
24,37,213702459,37245,Semblançay,2206,2162,44
24,37,213702467,37246,Sennevières,212,207,5
24,37,213702475,37247,Sepmes,619,609,10
24,37,213702483,37248,Seuilly,400,378,22
24,37,213702491,37249,Sonzay,1433,1409,24
24,37,213702509,37250,Sorigny,2862,2785,77
24,37,213702517,37251,Souvigné,905,897,8
24,37,213702525,37252,Souvigny-de-Touraine,400,394,6
24,37,213702533,37253,Sublaines,186,180,6
24,37,200076297,37254,Tauxigny-Saint-Bauld,1739,1703,36
24,37,213702558,37255,Tavant,266,264,2
24,37,213702566,37256,Theneuil,293,290,3
24,37,213702574,37257,Thilouze,1810,1786,24
24,37,213702582,37258,Thizay,294,291,3
24,37,213702590,37259,Tournon-Saint-Pierre,469,459,10
24,37,213702608,37260,La Tour-Saint-Gelin,525,514,11
24,37,213702616,37261,Tours,140474,137850,2624
24,37,213702624,37262,Trogues,295,291,4
24,37,213702632,37263,Truyes,2478,2443,35
24,37,213702640,37264,Vallères,1338,1318,20
24,37,213702657,37265,Varennes,242,237,5
24,37,213702665,37266,Veigné,6633,6511,122
24,37,213702673,37267,Véretz,4671,4590,81
24,37,213702681,37268,Verneuil-le-Château,127,127,0
24,37,213702699,37269,Verneuil-sur-Indre,484,472,12
24,37,213702707,37270,Vernou-sur-Brenne,2821,2769,52
24,37,213702715,37271,Villaines-les-Rochers,1048,1039,9
24,37,213702723,37272,Villandry,1170,1136,34
24,37,213702731,37273,La Ville-aux-Dames,5670,5593,77
24,37,213702749,37274,Villebourg,310,306,4
24,37,213702756,37275,Villedômain,123,121,2
24,37,213702764,37276,Villedômer,1352,1321,31
24,37,213702772,37277,Villeloin-Coulangé,586,583,3
24,37,213702780,37278,Villeperdue,1084,1077,7
24,37,213702798,37279,Villiers-au-Bouin,759,752,7
24,37,213702806,37280,Vou,244,238,6
24,37,213702814,37281,Vouvray,3356,3294,62
24,37,213702822,37282,Yzeures-sur-Creuse,1362,1337,25
84,38,200060127,38001,Les Abrets en Dauphiné,6544,6439,105
84,38,213800022,38002,Les Adrets,1094,1063,31
84,38,213800030,38003,Agnin,1192,1170,22
84,38,213800048,38004,L'Albenc,1311,1285,26
84,38,213800055,38005,Allemond,959,942,17
84,38,213800063,38006,Allevard,4106,3999,107
84,38,213800089,38008,Ambel,27,27,0
84,38,213800097,38009,Anjou,1050,1036,14
84,38,213800105,38010,Annoisin-Chatelans,728,710,18
84,38,213800113,38011,Anthon,1144,1130,14
84,38,213800121,38012,Aoste,2932,2880,52
84,38,213800139,38013,Apprieu,3562,3475,87
84,38,213800154,38015,Artas,1867,1828,39
84,38,213800170,38017,Assieu,1679,1643,36
84,38,213800188,38018,Auberives-en-Royans,378,367,11
84,38,213800196,38019,Auberives-sur-Varèze,1504,1476,28
84,38,213800204,38020,Auris,184,181,3
84,38,200058444,38022,Les Avenières Veyrins-Thuellin,7938,7777,161
84,38,213800238,38023,Avignonet,209,204,5
84,38,213800261,38026,La Balme-les-Grottes,1137,1119,18
84,38,213800279,38027,Barraux,2042,1983,59
84,38,213800295,38029,La Bâtie-Montgascon,2015,1969,46
84,38,213800303,38030,Beaucroissant,1900,1871,29
84,38,213800311,38031,Beaufin,21,21,0
84,38,213800329,38032,Beaufort,595,583,12
84,38,213800337,38033,Beaulieu,651,633,18
84,38,213800345,38034,Beaurepaire,5088,5005,83
84,38,213800352,38035,Beauvoir-de-Marc,1126,1111,15
84,38,213800360,38036,Beauvoir-en-Royans,97,96,1
84,38,213800378,38037,Bellegarde-Poussieu,1014,1000,14
84,38,213800386,38038,Belmont,613,599,14
84,38,213800394,38039,Bernin,3127,3022,105
84,38,213800402,38040,Besse,149,148,1
84,38,213800410,38041,Bessins,107,104,3
84,38,213800428,38042,Bévenais,1053,1031,22
84,38,213800436,38043,Bilieu,1627,1585,42
84,38,213800444,38044,Biol,1530,1488,42
84,38,213800451,38045,Biviers,2394,2304,90
84,38,213800469,38046,Bizonnes,1020,1005,15
84,38,213800477,38047,Blandin,155,152,3
84,38,213800485,38048,Bonnefamille,1121,1102,19
84,38,213800493,38049,Bossieu,315,313,2
84,38,213800501,38050,Le Bouchage,644,634,10
84,38,213800519,38051,Bougé-Chambalud,1410,1381,29
84,38,213800527,38052,Le Bourg-d'Oisans,3386,3285,101
84,38,213800535,38053,Bourgoin-Jallieu,30011,29389,622
84,38,213800543,38054,Bouvesse-Quirieu,1551,1525,26
84,38,213800550,38055,Brangues,641,633,8
84,38,213800568,38056,Bressieux,94,92,2
84,38,213800576,38057,Bresson,676,664,12
84,38,213800584,38058,Brézins,2251,2212,39
84,38,213800592,38059,Brié-et-Angonnes,2579,2533,46
84,38,213800600,38060,Brion,149,145,4
84,38,213800618,38061,La Buisse,3400,3323,77
84,38,213800626,38062,La Buissière,776,763,13
84,38,213800634,38063,Burcin,458,446,12
84,38,213800642,38064,Cessieu,3243,3172,71
84,38,213800659,38065,Châbons,2208,2157,51
84,38,213800667,38066,Chalon,177,173,4
84,38,213800675,38067,Chamagnieu,1765,1731,34
84,38,213800683,38068,Champagnier,1335,1306,29
84,38,213800691,38069,Champier,1477,1452,25
84,38,213800709,38070,Le Champ-près-Froges,1246,1231,15
84,38,213800717,38071,Champ-sur-Drac,3288,3255,33
84,38,213800725,38072,Chanas,2732,2699,33
84,38,200086452,38073,Chantepérier,203,200,3
84,38,213800741,38074,Chantesse,371,365,6
84,38,213800758,38075,Chapareillan,3081,2975,106
84,38,213800766,38076,La Chapelle-de-la-Tour,1971,1905,66
84,38,213800774,38077,La Chapelle-de-Surieu,779,763,16
84,38,213800782,38078,La Chapelle-du-Bard,582,568,14
84,38,213800808,38080,Charancieu,789,769,20
84,38,213800816,38081,Charantonnay,2037,1990,47
84,38,213800824,38082,Charavines,1993,1950,43
84,38,213800832,38083,Charette,460,444,16
84,38,213800840,38084,Charnècles,1432,1407,25
84,38,213800857,38085,Charvieu-Chavagneux,10278,10194,84
84,38,213800865,38086,Chasselay,408,400,8
84,38,213800873,38087,Chasse-sur-Rhône,6390,6338,52
84,38,213800899,38089,Chassignieu,227,222,5
84,38,213800907,38090,Château-Bernard,273,268,5
84,38,213800915,38091,Châteauvilain,767,750,17
84,38,213800923,38092,Châtelus,98,95,3
84,38,213800931,38093,Châtenay,443,437,6
84,38,213800949,38094,Châtonnay,2048,2006,42
84,38,213800956,38095,Chatte,2605,2461,144
84,38,213800972,38097,Chavanoz,5027,4961,66
84,38,213800980,38098,Chélieu,746,729,17
84,38,213800998,38099,Chevrières,757,735,22
84,38,213801004,38100,Le Cheylas,2524,2476,48
84,38,213801012,38101,Cheyssieu,1052,1036,16
84,38,213801020,38102,Chèzeneuve,662,641,21
84,38,213801038,38103,Chichilianne,306,304,2
84,38,213801046,38104,Chimilin,1434,1404,30
84,38,213801053,38105,Chirens,2478,2428,50
84,38,213801061,38106,Cholonge,363,354,9
84,38,213801079,38107,Chonas-l'Amballan,1738,1687,51
84,38,213801087,38108,Choranche,126,126,0
84,38,213801095,38109,Chozeau,1070,1034,36
84,38,213801103,38110,Chuzelles,2345,2300,45
84,38,213801111,38111,Claix,8142,7927,215
84,38,213801129,38112,Clavans-en-Haut-Oisans,99,98,1
84,38,213801137,38113,Clelles,541,535,6
84,38,213801145,38114,Clonas-sur-Varèze,1533,1496,37
84,38,213801152,38115,Saint-Martin-de-la-Cluze,755,736,19
84,38,213801160,38116,Cognet,39,39,0
84,38,213801178,38117,Cognin-les-Gorges,643,628,15
84,38,213801186,38118,Colombe,1676,1635,41
84,38,213801202,38120,La Combe-de-Lancey,727,710,17
84,38,213801244,38124,Corbelin,2323,2281,42
84,38,213801269,38126,Corenc,4232,4101,131
84,38,213801277,38127,Cornillon-en-Trièves,167,162,5
84,38,213801285,38128,Corps,436,431,5
84,38,213801293,38129,Corrençon-en-Vercors,380,362,18
84,38,213801301,38130,La Côte-Saint-André,5097,4817,280
84,38,213801319,38131,Les Côtes-d'Arey,2099,2023,76
84,38,213801327,38132,Les Côtes-de-Corps,72,72,0
84,38,213801335,38133,Coublevie,5723,5318,405
84,38,213801343,38134,Cour-et-Buis,947,927,20
84,38,213801350,38135,Courtenay,1306,1287,19
84,38,213801368,38136,Crachier,584,568,16
84,38,213801376,38137,Cras,444,431,13
84,38,213801384,38138,Crémieu,3499,3437,62
84,38,213801392,38139,Creys-Mépieu,1521,1501,20
84,38,213801400,38140,Crolles,8448,8193,255
84,38,213801418,38141,Culin,775,761,14
84,38,213801442,38144,Diémoz,2881,2837,44
84,38,213801467,38146,Dizimieu,846,820,26
84,38,213801475,38147,Doissin,907,881,26
84,38,213801483,38148,Dolomieu,3292,3218,74
84,38,213801491,38149,Domarin,1726,1690,36
84,38,213801509,38150,Domène,6741,6670,71
84,38,213801517,38151,Échirolles,37181,36970,211
84,38,200049815,38152,Eclose-Badinières,1496,1464,32
84,38,213801533,38153,Engins,462,441,21
84,38,213801541,38154,Entraigues,226,223,3
84,38,213801558,38155,Entre-deux-Guiers,1908,1877,31
84,38,213801566,38156,Les Éparres,999,968,31
84,38,213801574,38157,Estrablin,3694,3620,74
84,38,213801582,38158,Eybens,10231,10112,119
84,38,213801590,38159,Eydoche,548,540,8
84,38,213801608,38160,Eyzin-Pinet,2453,2337,116
84,38,213801616,38161,Faramans,1115,1096,19
84,38,213801624,38162,Faverges-de-la-Tour,1510,1471,39
84,38,200086437,38163,Le Haut-Bréda,420,411,9
84,38,213801665,38166,La Flachère,464,454,10
84,38,213801673,38167,Flachères,550,546,4
84,38,213801699,38169,Fontaine,23295,23049,246
84,38,213801707,38170,Fontanil-Cornillon,3439,3404,35
84,38,213801715,38171,La Forteresse,336,332,4
84,38,213801723,38172,Four,1675,1641,34
84,38,213801731,38173,Le Freney-d'Oisans,252,245,7
84,38,213801749,38174,La Frette,1117,1093,24
84,38,213801756,38175,Froges,3418,3360,58
84,38,213801764,38176,Frontonas,2175,2120,55
84,38,213801772,38177,La Garde,101,101,0
84,38,213801798,38179,Gières,7227,7140,87
84,38,213801806,38180,Gillonnay,1051,1013,38
84,38,213801814,38181,Goncelin,2522,2488,34
84,38,213801822,38182,Le Grand-Lemps,3137,3084,53
84,38,213801830,38183,Granieu,519,510,9
84,38,213801848,38184,Grenay,1646,1626,20
84,38,213801855,38185,Grenoble,160483,158240,2243
84,38,213801863,38186,Gresse-en-Vercors,380,368,12
84,38,213801871,38187,Le Gua,1819,1794,25
84,38,213801889,38188,Herbeys,1393,1370,23
84,38,213801897,38189,Heyrieux,4774,4708,66
84,38,213801905,38190,Hières-sur-Amby,1187,1161,26
84,38,213801913,38191,Huez,1330,1298,32
84,38,213801921,38192,Hurtières,214,208,6
84,38,213801939,38193,L'Isle-d'Abeau,16985,16717,268
84,38,213801947,38194,Izeaux,2184,2148,36
84,38,213801954,38195,Izeron,760,751,9
84,38,213801970,38197,Janneyrias,1835,1815,20
84,38,213801988,38198,Jarcieu,1109,1086,23
84,38,213801996,38199,Jardin,2227,2171,56
84,38,213802002,38200,Jarrie,3867,3797,70
84,38,213802036,38203,Laffrey,475,467,8
84,38,213802044,38204,Lalley,197,192,5
84,38,213802051,38205,Lans-en-Vercors,2794,2673,121
84,38,213802069,38206,Laval-en-Belledonne,1026,989,37
84,38,213802077,38207,Lavaldens,155,152,3
84,38,213802085,38208,Lavars,151,148,3
84,38,213802093,38209,Lentiol,246,239,7
84,38,213802101,38210,Leyrieu,913,898,15
84,38,213802119,38211,Lieudieu,357,351,6
84,38,213802127,38212,Livet-et-Gavet,1279,1269,10
84,38,213802135,38213,Longechenal,603,592,11
84,38,213802143,38214,Lumbin,2254,2178,76
84,38,213802150,38215,Luzinay,2407,2355,52
84,38,213802168,38216,Malleval-en-Vercors,57,55,2
84,38,213802176,38217,Marcieu,73,71,2
84,38,213802184,38218,Marcilloles,1196,1175,21
84,38,213802192,38219,Marcollin,648,633,15
84,38,213802218,38221,Marnans,142,138,4
84,38,213802226,38222,Massieu,763,746,17
84,38,213802234,38223,Maubec,1940,1872,68
84,38,213802242,38224,Mayres-Savel,91,88,3
84,38,200056224,38225,Autrans-Méaudre en Vercors,3172,3068,104
84,38,213802267,38226,Mens,1472,1406,66
84,38,213802283,38228,Merlas,494,476,18
84,38,213802291,38229,Meylan,18578,18221,357
84,38,213802309,38230,Meyrié,1078,1047,31
84,38,213802317,38231,Meyrieu-les-Étangs,1055,1027,28
84,38,213802325,38232,Meyssiez,651,639,12
84,38,213802358,38235,Miribel-Lanchâtre,461,454,7
84,38,213802366,38236,Miribel-les-Échelles,1783,1743,40
84,38,213802374,38237,Mizoën,194,190,4
84,38,213802382,38238,Moidieu-Détourbe,2011,1968,43
84,38,213802390,38239,Moirans,7647,7495,152
84,38,213802408,38240,Moissieu-sur-Dolon,752,737,15
84,38,213802416,38241,Monestier-d'Ambel,15,15,0
84,38,213802424,38242,Monestier-de-Clermont,1482,1449,33
84,38,213802432,38243,Monestier-du-Percy,253,247,6
84,38,213802440,38244,Monsteroux-Milieu,816,797,19
84,38,213802457,38245,Montagne,276,272,4
84,38,213802465,38246,Montagnieu,1173,1155,18
84,38,213802473,38247,Montalieu-Vercieu,3570,3516,54
84,38,213802481,38248,Montaud,541,520,21
84,38,213802499,38249,Montbonnot-Saint-Martin,6018,5457,561
84,38,213802507,38250,Montcarra,606,588,18
84,38,213802523,38252,Montchaboud,346,337,9
84,38,200064434,38253,Les Deux Alpes,1979,1942,37
84,38,213802549,38254,Monteynard,509,496,13
84,38,213802556,38255,Montfalcon,140,140,0
84,38,213802564,38256,Montferrat,1867,1843,24
84,38,213802572,38257,Montrevel,459,447,12
84,38,213802580,38258,Mont-Saint-Martin,83,83,0
84,38,213802598,38259,Montseveroux,1016,999,17
84,38,213802606,38260,Moras,541,523,18
84,38,213802614,38261,Morestel,4606,4492,114
84,38,213802630,38263,Morette,378,373,5
84,38,213802648,38264,La Morte,138,138,0
84,38,213802655,38265,La Motte-d'Aveillans,1739,1707,32
84,38,213802663,38266,La Motte-Saint-Martin,462,451,11
84,38,213802671,38267,Mottier,805,790,15
84,38,213802689,38268,Le Moutaret,267,261,6
84,38,213802697,38269,La Mure,5109,4899,210
84,38,213802705,38270,La Murette,1926,1856,70
84,38,213802713,38271,Murianette,870,859,11
84,38,213802721,38272,Murinais,407,403,4
84,38,213802739,38273,Nantes-en-Ratier,484,465,19
84,38,213802754,38275,Serre-Nerpol,351,310,41
84,38,213802762,38276,Nivolas-Vermelle,2718,2648,70
84,38,213802770,38277,Notre-Dame-de-Commiers,549,543,6
84,38,213802788,38278,Notre-Dame-de-l'Osier,508,499,9
84,38,213802796,38279,Notre-Dame-de-Mésage,1134,1121,13
84,38,213802804,38280,Notre-Dame-de-Vaulx,545,524,21
84,38,213802812,38281,Noyarey,2319,2242,77
84,38,213802820,38282,Optevoz,911,884,27
84,38,213802838,38283,Oris-en-Rattier,108,106,2
84,38,200083038,38284,Ornacieux-Balbins,881,859,22
84,38,213802853,38285,Ornon,164,160,4
84,38,213802861,38286,Oulles,9,9,0
84,38,213802879,38287,Oyeu,1082,1063,19
84,38,213802887,38288,Oytier-Saint-Oblas,1716,1684,32
84,38,213802895,38289,Oz,217,213,4
84,38,213802903,38290,Pact,876,858,18
84,38,213802911,38291,Pajay,1138,1119,19
84,38,200063972,38292,Villages du Lac de Paladru,2584,2526,58
84,38,213802945,38294,Panossas,670,653,17
84,38,213802952,38295,Parmilieu,743,726,17
84,38,213802960,38296,Le Passage,957,918,39
84,38,200063964,38297,Arandon-Passins,1916,1873,43
84,38,213802986,38298,Le Péage-de-Roussillon,6499,6444,55
84,38,213802994,38299,Pellafol,139,136,3
84,38,213803000,38300,Penol,376,368,8
84,38,213803018,38301,Le Percy,173,172,1
84,38,213803034,38303,La Pierre,589,584,5
84,38,213803042,38304,Pierre-Châtel,1543,1506,37
84,38,213803075,38307,Pisieu,532,523,9
84,38,213803083,38308,Plan,281,279,2
84,38,213803091,38309,Poisat,2147,2120,27
84,38,213803109,38310,Poliénas,1205,1180,25
84,38,213803117,38311,Pommier-de-Beaurepaire,738,717,21
84,38,213803133,38313,Ponsonnas,302,294,8
84,38,213803141,38314,Pontcharra,7519,7349,170
84,38,213803158,38315,Le Pont-de-Beauvoisin,3689,3546,143
84,38,213803166,38316,Pont-de-Chéruy,6070,6028,42
84,38,213803174,38317,Le Pont-de-Claix,10948,10879,69
84,38,213803182,38318,Pont-Évêque,5380,5329,51
84,38,213803190,38319,Pont-en-Royans,823,795,28
84,38,213803208,38320,Porcieu-Amblagnieu,1830,1790,40
84,38,213803216,38321,Prébois,172,168,4
84,38,213803224,38322,Presles,97,95,2
84,38,213803232,38323,Pressins,1180,1156,24
84,38,213803240,38324,Primarette,729,711,18
84,38,213803257,38325,Proveysieux,522,513,9
84,38,213803265,38326,Prunières,385,373,12
84,38,213803281,38328,Quaix-en-Chartreuse,934,901,33
84,38,213803299,38329,Quet-en-Beaumont,72,72,0
84,38,213803307,38330,Quincieu,103,102,1
84,38,213803315,38331,Réaumont,1039,1008,31
84,38,213803323,38332,Renage,3437,3388,49
84,38,213803331,38333,Rencurel,337,331,6
84,38,213803349,38334,Revel,1357,1314,43
84,38,213803356,38335,Revel-Tourdan,1076,1050,26
84,38,213803364,38336,Reventin-Vaugris,2041,2006,35
84,38,213803372,38337,Rives,6727,6645,82
84,38,213803380,38338,La Rivière,743,734,9
84,38,213803398,38339,Roche,2207,2150,57
84,38,213803406,38340,Les Roches-de-Condrieu,2008,1970,38
84,38,213803414,38341,Rochetoirin,1131,1094,37
84,38,213803422,38342,Roissard,323,316,7
84,38,213803430,38343,Romagnieu,1671,1636,35
84,38,213803448,38344,Roussillon,8578,8460,118
84,38,213803455,38345,Rovon,618,608,10
84,38,213803463,38346,Royas,401,394,7
84,38,213803471,38347,Roybon,1152,1123,29
84,38,213803489,38348,Ruy-Montceau,4841,4732,109
84,38,213803497,38349,Sablons,2316,2274,42
84,38,213803505,38350,Sainte-Agnès,575,557,18
84,38,213803513,38351,Saint-Agnin-sur-Bion,1131,1110,21
84,38,213803521,38352,Saint-Alban-de-Roche,2191,2131,60
84,38,213803539,38353,Saint-Alban-du-Rhône,889,880,9
84,38,213803547,38354,Saint-Albin-de-Vaulserre,420,414,6
84,38,213803554,38355,Saint-Andéol,129,123,6
84,38,213803562,38356,Saint-André-en-Royans,327,321,6
84,38,213803570,38357,Saint-André-le-Gaz,2902,2761,141
84,38,213803588,38358,Sainte-Anne-sur-Gervonde,744,730,14
84,38,200054526,38359,Saint Antoine l'Abbaye,1219,1197,22
84,38,213803604,38360,Saint-Appolinard,426,418,8
84,38,213803612,38361,Saint-Arey,79,77,2
84,38,213803620,38362,Saint-Aupre,1225,1173,52
84,38,213803638,38363,Saint-Barthélemy,975,920,55
84,38,213803646,38364,Saint-Barthélemy-de-Séchilienne,434,428,6
84,38,213803653,38365,Saint-Baudille-de-la-Tour,847,828,19
84,38,213803661,38366,Saint-Baudille-et-Pipet,267,259,8
84,38,213803687,38368,Saint-Blaise-du-Buis,1109,1084,25
84,38,213803695,38369,Sainte-Blandine,1021,983,38
84,38,213803703,38370,Saint-Bonnet-de-Chavagne,674,656,18
84,38,213803729,38372,Saint-Bueil,726,718,8
84,38,213803737,38373,Saint-Cassien,1185,1143,42
84,38,213803745,38374,Saint-Chef,3824,3731,93
84,38,213803752,38375,Saint-Christophe-en-Oisans,106,106,0
84,38,213803760,38376,Saint-Christophe-sur-Guiers,822,813,9
84,38,213803778,38377,Saint-Clair-de-la-Tour,3504,3446,58
84,38,213803786,38378,Saint-Clair-du-Rhône,3765,3680,85
84,38,213803794,38379,Saint-Clair-sur-Galaure,271,263,8
84,38,213803802,38380,Saint-Didier-de-Bizonnes,316,311,5
84,38,213803810,38381,Saint-Didier-de-la-Tour,2179,2124,55
84,38,213803828,38382,Saint-Égrève,16221,16015,206
84,38,213803836,38383,Saint-Étienne-de-Crossey,2681,2572,109
84,38,213803844,38384,Saint-Étienne-de-Saint-Geoirs,3246,3207,39
84,38,213803869,38386,Saint-Geoire-en-Valdaine,2431,2390,41
84,38,213803877,38387,Saint-Geoirs,508,497,11
84,38,213803885,38388,Saint-Georges-de-Commiers,2625,2592,33
84,38,213803893,38389,Saint-Georges-d'Espéranche,3536,3466,70
84,38,213803901,38390,Saint-Gervais,545,536,9
84,38,213803919,38391,Saint-Guillaume,246,241,5
84,38,213803927,38392,Saint-Hilaire-de-Brens,624,604,20
84,38,213803935,38393,Saint-Hilaire-de-la-Côte,1609,1575,34
84,38,213803943,38394,Saint-Hilaire-du-Rosier,1906,1874,32
84,38,200086767,38395,Plateau-des-Petites-Roches,2470,2397,73
84,38,213803968,38396,Saint-Honoré,837,812,25
84,38,213803976,38397,Saint-Ismier,7360,7046,314
84,38,213803984,38398,Saint-Jean-d'Avelanne,997,981,16
84,38,213803992,38399,Saint-Jean-de-Bournay,4759,4655,104
84,38,213804008,38400,Saint-Jean-de-Moirans,3641,3563,78
84,38,213804016,38401,Saint-Jean-de-Soudain,1701,1661,40
84,38,213804024,38402,Saint-Jean-de-Vaulx,549,530,19
84,38,213804032,38403,Saint-Jean-d'Hérans,294,289,5
84,38,213804040,38404,Saint-Jean-le-Vieux,301,292,9
84,38,213804057,38405,Saint-Joseph-de-Rivière,1267,1237,30
84,38,213804065,38406,Saint-Julien-de-l'Herms,158,156,2
84,38,200064459,38407,La Sure en Chartreuse,1017,988,29
84,38,213804081,38408,Saint-Just-Chaleyssin,2744,2682,62
84,38,213804099,38409,Saint-Just-de-Claix,1395,1361,34
84,38,213804107,38410,Saint-Lattier,1443,1418,25
84,38,213804123,38412,Saint-Laurent-du-Pont,4601,4499,102
84,38,213804131,38413,Saint-Laurent-en-Beaumont,434,425,9
84,38,213804149,38414,Sainte-Luce,42,40,2
84,38,213804156,38415,Saint-Marcel-Bel-Accueil,1476,1437,39
84,38,213804164,38416,Saint-Marcellin,7914,7731,183
84,38,213804172,38417,Sainte-Marie-d'Alloix,498,481,17
84,38,213804180,38418,Sainte-Marie-du-Mont,237,235,2
84,38,213804198,38419,Saint-Martin-de-Clelles,185,183,2
84,38,213804206,38420,Saint-Martin-de-Vaulserre,252,247,5
84,38,213804214,38421,Saint-Martin-d'Hères,38455,38188,267
84,38,213804222,38422,Saint-Martin-d'Uriage,5707,5529,178
84,38,213804230,38423,Saint-Martin-le-Vinoux,5914,5851,63
84,38,213804248,38424,Saint-Maurice-en-Trièves,177,174,3
84,38,213804255,38425,Saint-Maurice-l'Exil,6506,6413,93
84,38,213804263,38426,Saint-Maximin,675,658,17
84,38,213804271,38427,Saint-Michel-de-Saint-Geoirs,299,295,4
84,38,213804289,38428,Saint-Michel-en-Beaumont,31,31,0
84,38,213804297,38429,Saint-Michel-les-Portes,294,287,7
84,38,213804305,38430,Saint-Mury-Monteymond,327,320,7
84,38,213804313,38431,Saint-Nazaire-les-Eymes,3065,2978,87
84,38,213804321,38432,Saint-Nicolas-de-Macherin,989,966,23
84,38,213804339,38433,Saint-Nizier-du-Moucherotte,1135,1103,32
84,38,213804347,38434,Saint-Ondras,656,650,6
84,38,213804362,38436,Saint-Paul-de-Varces,2282,2235,47
84,38,213804370,38437,Saint-Paul-d'Izeaux,299,295,4
84,38,213804388,38438,Saint-Paul-lès-Monestier,275,274,1
84,38,200055556,38439,Crêts en Belledonne,3437,3380,57
84,38,213804404,38440,Saint-Pierre-de-Bressieux,779,763,16
84,38,213804420,38442,Saint-Pierre-de-Chartreuse,976,950,26
84,38,213804438,38443,Saint-Pierre-de-Chérennes,482,466,16
84,38,213804446,38444,Saint-Pierre-de-Méaroz,117,112,5
84,38,213804453,38445,Saint-Pierre-de-Mésage,790,784,6
84,38,213804461,38446,Saint-Pierre-d'Entremont,581,567,14
84,38,213804487,38448,Saint-Prim,1437,1406,31
84,38,213804495,38449,Saint-Quentin-Fallavier,6122,6076,46
84,38,213804503,38450,Saint-Quentin-sur-Isère,1504,1483,21
84,38,213804511,38451,Saint-Romain-de-Jalionas,3445,3403,42
84,38,213804529,38452,Saint-Romain-de-Surieu,405,401,4
84,38,213804537,38453,Saint-Romans,1831,1791,40
84,38,213804545,38454,Saint-Sauveur,2158,2111,47
84,38,213804552,38455,Saint-Savin,4328,4232,96
84,38,200068336,38456,Châtel-en-Trièves,501,491,10
84,38,213804578,38457,Saint-Siméon-de-Bressieux,3016,2952,64
84,38,213804586,38458,Saint-Sorlin-de-Morestel,626,610,16
84,38,213804594,38459,Saint-Sorlin-de-Vienne,965,942,23
84,38,213804602,38460,Saint-Sulpice-des-Rivoires,443,431,12
84,38,213804628,38462,Saint-Théoffrey,575,563,12
84,38,213804636,38463,Saint-Vérand,1756,1717,39
84,38,213804644,38464,Saint-Victor-de-Cessieu,2265,2224,41
84,38,213804651,38465,Saint-Victor-de-Morestel,1111,1088,23
84,38,213804669,38466,Saint-Vincent-de-Mercuze,1543,1495,48
84,38,213804677,38467,Salagnon,1501,1463,38
84,38,213804685,38468,Salaise-sur-Sanne,4576,4505,71
84,38,213804693,38469,La Salette-Fallavaux,73,73,0
84,38,213804701,38470,La Salle-en-Beaumont,350,342,8
84,38,213804719,38471,Le Sappey-en-Chartreuse,1163,1133,30
84,38,213804727,38472,Sarcenas,231,227,4
84,38,213804735,38473,Sardieu,1184,1163,21
84,38,213804743,38474,Sassenage,11545,11339,206
84,38,213804750,38475,Satolas-et-Bonce,2533,2500,33
84,38,213804768,38476,Savas-Mépin,904,892,12
84,38,213804784,38478,Séchilienne,1055,1043,12
84,38,200084879,38479,Porte-des-Bonnevaux,2102,2046,56
84,38,213804800,38480,Septème,2129,2088,41
84,38,213804818,38481,Sérézin-de-la-Tour,1162,1130,32
84,38,213804834,38483,Sermérieu,1705,1654,51
84,38,213804842,38484,Serpaize,2147,2116,31
84,38,213804859,38485,Seyssinet-Pariset,11923,11792,131
84,38,213804867,38486,Seyssins,8023,7907,116
84,38,213804875,38487,Seyssuel,2116,2063,53
84,38,213804883,38488,Siccieu-Saint-Julien-et-Carisieu,603,586,17
84,38,213804891,38489,Siévoz,133,132,1
84,38,213804909,38490,Sillans,1980,1934,46
84,38,213804925,38492,Sinard,731,711,20
84,38,213804941,38494,Soleymieu,829,810,19
84,38,213804958,38495,La Sône,598,594,4
84,38,213804966,38496,Sonnay,1304,1278,26
84,38,213804974,38497,Sousville,145,145,0
84,38,213804982,38498,Succieu,759,748,11
84,38,213804990,38499,Susville,1192,1173,19
84,38,213805005,38500,Têche,593,582,11
84,38,213805013,38501,Tencin,2178,2153,25
84,38,213805039,38503,La Terrasse,2619,2495,124
84,38,213805047,38504,Theys,2103,2011,92
84,38,213805054,38505,Thodure,801,786,15
84,38,213805070,38507,Tignieu-Jameyzieu,7806,7685,121
84,38,213805088,38508,Torchefelon,846,821,25
84,38,213805096,38509,La Tour-du-Pin,8353,8148,205
84,38,213805112,38511,Le Touvet,3269,3166,103
84,38,213805120,38512,Tramolé,811,786,25
84,38,213805138,38513,Treffort,297,286,11
84,38,213805146,38514,Tréminis,190,185,5
84,38,213805153,38515,Trept,2220,2174,46
84,38,213805161,38516,La Tronche,6700,6559,141
84,38,213805179,38517,Tullins,7883,7755,128
84,38,213805187,38518,Valbonnais,525,512,13
84,38,213805195,38519,Valencin,2937,2885,52
84,38,213805203,38520,Valencogne,701,692,9
84,38,213805211,38521,La Valette,67,65,2
84,38,213805229,38522,Valjouffrey,144,142,2
84,38,213805237,38523,Varacieux,865,845,20
84,38,213805245,38524,Varces-Allières-et-Risset,8483,8329,154
84,38,213805252,38525,Vasselin,469,461,8
84,38,213805260,38526,Vatilieu,369,358,11
84,38,213805278,38527,Vaujany,350,346,4
84,38,213805286,38528,Vaulnaveys-le-Bas,1371,1341,30
84,38,213805294,38529,Vaulnaveys-le-Haut,4063,3983,80
84,38,213805302,38530,Vaulx-Milieu,2578,2528,50
84,38,213805310,38531,Velanne,570,562,8
84,38,213805328,38532,Vénérieu,985,973,12
84,38,213805336,38533,Venon,783,767,16
84,38,213805351,38535,Vernas,270,263,7
84,38,213805369,38536,Vernioz,1464,1439,25
84,38,213805377,38537,La Verpillière,7441,7354,87
84,38,213805385,38538,Le Versoud,5057,4991,66
84,38,213805393,38539,Vertrieu,632,612,20
84,38,213805401,38540,Veurey-Voroize,1447,1420,27
84,38,213805427,38542,Veyssilieu,342,327,15
84,38,213805435,38543,Vézeronce-Curtin,2206,2170,36
84,38,213805443,38544,Vienne,30401,30059,342
84,38,213805450,38545,Vif,8740,8614,126
84,38,213805468,38546,Vignieu,986,959,27
84,38,213805476,38547,Villard-Bonnot,7431,7324,107
84,38,213805484,38548,Villard-de-Lans,4492,4279,213
84,38,213805492,38549,Villard-Notre-Dame,31,28,3
84,38,213805500,38550,Villard-Reculas,58,58,0
84,38,213805518,38551,Villard-Reymond,40,39,1
84,38,213805526,38552,Villard-Saint-Christophe,410,401,9
84,38,213805534,38553,Villefontaine,19131,18891,240
84,38,213805542,38554,Villemoirieu,1894,1824,70
84,38,213805559,38555,Villeneuve-de-Marc,1196,1166,30
84,38,213805567,38556,Ville-sous-Anjou,1201,1182,19
84,38,213805575,38557,Villette-d'Anthon,5274,5183,91
84,38,213805583,38558,Villette-de-Vienne,1957,1926,31
84,38,213805591,38559,Vinay,4478,4405,73
84,38,200083491,38560,Val-de-Virieu,1562,1536,26
84,38,213805617,38561,Viriville,1716,1681,35
84,38,213805625,38562,Vizille,7474,7305,169
84,38,213805633,38563,Voiron,20853,20332,521
84,38,213805641,38564,Voissant,248,238,10
84,38,213805658,38565,Voreppe,9888,9514,374
84,38,213805666,38566,Vourey,1746,1697,49
84,38,213805674,38567,Chamrousse,416,411,5
27,39,213900012,39001,Abergement-la-Ronce,874,850,24
27,39,213900020,39002,Abergement-le-Grand,62,61,1
27,39,213900038,39003,Abergement-le-Petit,50,50,0
27,39,213900046,39004,Abergement-lès-Thésy,56,53,3
27,39,213900061,39006,Aiglepierre,457,441,16
27,39,213900079,39007,Alièze,156,151,5
27,39,213900087,39008,Amange,494,445,49
27,39,213900095,39009,Andelot-en-Montagne,545,530,15
27,39,213900103,39010,Andelot-Morval,94,92,2
27,39,213900111,39011,Annoire,424,417,7
27,39,213900137,39013,Arbois,3443,3239,204
27,39,213900145,39014,Archelange,222,215,7
27,39,213900152,39015,Ardon,117,115,2
27,39,200077253,39016,Arinthod,1142,1112,30
27,39,200055135,39017,Arlay,1233,1196,37
27,39,200071348,39018,Aromas,641,634,7
27,39,213900194,39019,Les Arsures,223,214,9
27,39,213900202,39020,Arsure-Arsurette,104,100,4
27,39,200055150,39021,La Chailleuse,609,595,14
27,39,213900228,39022,Asnans-Beauvoisin,757,746,11
27,39,213900244,39024,Audelange,273,267,6
27,39,213900251,39025,Augea,269,266,3
27,39,213900269,39026,Augerans,183,182,1
27,39,213900277,39027,Augisey,194,188,6
27,39,213900285,39028,Aumont,471,466,5
27,39,213900293,39029,Aumur,386,377,9
27,39,213900301,39030,Authume,852,832,20
27,39,213900319,39031,Auxange,203,201,2
27,39,213900327,39032,Avignon-lès-Saint-Claude,378,361,17
27,39,213900343,39034,Balaiseaux,328,319,9
27,39,213900350,39035,Balanod,363,354,9
27,39,213900376,39037,Bans,198,194,4
27,39,213900384,39038,Barésia-sur-l'Ain,146,144,2
27,39,213900392,39039,La Barre,248,243,5
27,39,213900400,39040,Barretaine,178,176,2
27,39,213900418,39041,Baume-les-Messieurs,164,158,6
27,39,213900426,39042,Baverans,514,492,22
27,39,200086361,39043,Beaufort-Orbagna,1444,1422,22
27,39,213900459,39045,Beffia,81,78,3
27,39,213900467,39046,Bellecombe,78,75,3
27,39,213900475,39047,Bellefontaine,527,516,11
27,39,213900483,39048,Belmont,259,251,8
27,39,213900491,39049,Bersaillin,419,406,13
27,39,213900509,39050,Besain,162,157,5
27,39,213900517,39051,Biarne,422,417,5
27,39,213900525,39052,Bief-des-Maisons,71,70,1
27,39,213900533,39053,Bief-du-Fourg,221,211,10
27,39,213900541,39054,Biefmorin,106,104,2
27,39,213900558,39055,Billecul,48,47,1
27,39,213900566,39056,Bletterans,1557,1527,30
27,39,213900574,39057,Blois-sur-Seille,100,99,1
27,39,213900582,39058,Blye,182,177,5
27,39,213900590,39059,Bois-d'Amont,1693,1650,43
27,39,213900608,39060,Bois-de-Gand,57,57,0
27,39,213900616,39061,Boissia,113,108,5
27,39,213900624,39062,La Boissière,69,69,0
27,39,213900632,39063,Bonlieu,254,250,4
27,39,213900657,39065,Bonnefontaine,116,116,0
27,39,213900665,39066,Bornay,185,179,6
27,39,213900681,39068,Les Bouchoux,319,310,9
27,39,213900707,39070,Bourg-de-Sirod,95,93,2
27,39,213900723,39072,Bracon,274,268,6
27,39,213900731,39073,Brainans,178,172,6
27,39,213900749,39074,Brans,213,205,8
27,39,213900764,39076,La Bretenière,225,223,2
27,39,213900772,39077,Bretenières,45,43,2
27,39,213900780,39078,Brevans,705,692,13
27,39,213900798,39079,Briod,211,202,9
27,39,213900806,39080,Broissia,62,60,2
27,39,213900814,39081,Buvilly,400,391,9
27,39,213900830,39083,Censeau,341,335,6
27,39,213900848,39084,Cernans,148,143,5
27,39,213900855,39085,Cerniébaud,90,89,1
27,39,213900863,39086,Cernon,236,234,2
27,39,213900889,39088,Cesancey,400,390,10
27,39,213900905,39090,Chaînée-des-Coupis,191,187,4
27,39,213900913,39091,Les Chalesmes,89,88,1
27,39,213900921,39092,Chambéria,189,189,0
27,39,213900939,39093,Chamblay,434,424,10
27,39,213900947,39094,Chamole,168,161,7
27,39,213900954,39095,Champagne-sur-Loue,127,122,5
27,39,213900962,39096,Champagney,474,465,9
27,39,213900970,39097,Champagnole,8466,8040,426
27,39,213900996,39099,Champdivers,448,442,6
27,39,213901002,39100,Champrougier,107,104,3
27,39,213901010,39101,Champvans,1490,1456,34
27,39,213901028,39102,Chancia,230,226,4
27,39,213901036,39103,La Chapelle-sur-Furieuse,307,306,1
27,39,213901044,39104,Chapelle-Voland,611,601,10
27,39,213901051,39105,Chapois,224,216,8
27,39,213901069,39106,Charchilla,293,288,5
27,39,213901077,39107,Charcier,145,142,3
27,39,213901085,39108,Charency,58,55,3
27,39,213901093,39109,Charézier,181,175,6
27,39,213901101,39110,La Charme,66,66,0
27,39,213901119,39111,Charnod,38,38,0
27,39,213901127,39112,La Chassagne,110,108,2
27,39,213901143,39114,Château-Chalon,146,140,6
27,39,213901168,39116,La Châtelaine,154,152,2
27,39,213901176,39117,Chatelay,106,106,0
27,39,213901184,39118,Châtel-de-Joux,52,52,0
27,39,213901192,39119,Le Chateley,89,86,3
27,39,213901200,39120,Châtelneuf,134,126,8
27,39,213901218,39121,Châtenois,420,413,7
27,39,213901226,39122,Châtillon,118,113,5
27,39,213901242,39124,Chaumergy,483,470,13
27,39,213901267,39126,La Chaumusse,404,393,11
27,39,213901275,39127,Chaussenans,110,109,1
27,39,213901283,39128,Chaussin,1588,1563,25
27,39,213901291,39129,Chaux-des-Crotenay,404,390,14
27,39,200087468,39130,Nanchez,829,789,40
27,39,213901317,39131,La Chaux-du-Dombief,578,565,13
27,39,213901325,39132,La Chaux-en-Bresse,32,32,0
27,39,213901333,39133,Chaux-Champagny,73,71,2
27,39,213901341,39134,Chavéria,234,226,8
27,39,213901366,39136,Chemenot,40,38,2
27,39,200086007,39137,Saint-Hymetière-sur-Valouse,445,432,13
27,39,213901382,39138,Chemin,341,334,7
27,39,213901390,39139,Chêne-Bernard,78,78,0
27,39,213901408,39140,Chêne-Sec,39,39,0
27,39,213901416,39141,Chevigny,287,281,6
27,39,213901424,39142,Chevreaux,130,128,2
27,39,213901432,39143,Chevrotaine,34,34,0
27,39,213901457,39145,Chille,315,296,19
27,39,213901465,39146,Chilly-le-Vignoble,631,607,24
27,39,213901473,39147,Chilly-sur-Salins,100,96,4
27,39,213901499,39149,Chissey-sur-Loue,319,314,5
27,39,213901507,39150,Choisey,1044,1014,30
27,39,213901515,39151,Choux,132,127,5
27,39,213901531,39153,Cize,833,803,30
27,39,213901549,39154,Clairvaux-les-Lacs,1467,1427,40
27,39,213901556,39155,Clucy,77,77,0
27,39,213901564,39156,Cogna,249,242,7
27,39,213901572,39157,Coiserette,57,54,3
27,39,213901598,39159,Colonne,264,262,2
27,39,213901606,39160,Commenailles,912,896,16
27,39,213901622,39162,Condamine,259,254,5
27,39,213901630,39163,Condes,117,116,1
27,39,213901648,39164,Conliège,689,661,28
27,39,213901655,39165,Conte,57,57,0
27,39,213901663,39166,Cornod,217,215,2
27,39,213901671,39167,Cosges,363,358,5
27,39,213901689,39168,Courbette,46,46,0
27,39,213901697,39169,Courbouzon,610,594,16
27,39,213901705,39170,Courlans,955,927,28
27,39,213901713,39171,Courlaoux,1174,1143,31
27,39,213901721,39172,Courtefontaine,259,255,4
27,39,213901739,39173,Cousance,1325,1297,28
27,39,213901747,39174,Coyrière,65,65,0
27,39,213901754,39175,Coyron,74,71,3
27,39,213901762,39176,Cramans,535,526,9
27,39,200057149,39177,Hauteroche,996,973,23
27,39,213901788,39178,Crans,79,77,2
27,39,213901796,39179,Crenans,242,235,7
27,39,213901804,39180,Cressia,376,256,120
27,39,213901820,39182,Crissey,706,679,27
27,39,213901838,39183,Crotenay,714,634,80
27,39,213901846,39184,Les Crozets,196,191,5
27,39,213901853,39185,Cuisia,403,390,13
27,39,213901879,39187,Cuvier,281,274,7
27,39,213901887,39188,Dammartin-Marpain,353,349,4
27,39,213901895,39189,Damparis,2697,2621,76
27,39,200087203,39190,Dampierre,1344,1315,29
27,39,213901911,39191,Darbonnay,87,82,5
27,39,213901929,39192,Denezières,73,72,1
27,39,213901937,39193,Le Deschaux,1027,1008,19
27,39,213901945,39194,Desnes,487,481,6
27,39,213901960,39196,Les Deux-Fays,120,118,2
27,39,213901978,39197,Digna,375,363,12
27,39,213901986,39198,Dole,24483,23611,872
27,39,200086395,39199,Domblans,1257,1220,37
27,39,213902000,39200,Dompierre-sur-Mont,220,214,6
27,39,213902018,39201,Doucier,319,280,39
27,39,213902026,39202,Dournon,140,139,1
27,39,213902034,39203,Doye,106,104,2
27,39,213902042,39204,Dramelay,30,29,1
27,39,213902059,39205,Éclans-Nenon,389,379,10
27,39,213902067,39206,Écleux,230,222,8
27,39,213902075,39207,Écrille,85,82,3
27,39,213902083,39208,Entre-deux-Monts,150,146,4
27,39,200076107,39209,Val-d'Épy,325,318,7
27,39,213902109,39210,Équevillon,596,583,13
27,39,213902117,39211,Les Essards-Taignevaux,254,251,3
27,39,213902141,39214,Esserval-Tartre,123,122,1
27,39,213902166,39216,Étival,319,307,12
27,39,213902174,39217,L'Étoile,584,568,16
27,39,213902182,39218,Étrepigney,441,432,9
27,39,213902190,39219,Évans,665,657,8
27,39,213902208,39220,Falletans,414,404,10
27,39,213902216,39221,La Favière,32,31,1
27,39,213902224,39222,Fay-en-Montagne,88,81,7
27,39,213902232,39223,La Ferté,202,197,5
27,39,213902257,39225,Le Fied,197,191,6
27,39,213902273,39227,Foncine-le-Bas,195,193,2
27,39,213902281,39228,Foncine-le-Haut,1128,1099,29
27,39,213902299,39229,Fontainebrux,215,205,10
27,39,213902307,39230,Fontenu,78,75,3
27,39,213902323,39232,Fort-du-Plasne,461,454,7
27,39,213902331,39233,Foucherans,2316,2272,44
27,39,213902349,39234,Foulenay,81,80,1
27,39,213902356,39235,Fraisans,1206,1192,14
27,39,213902364,39236,Francheville,52,52,0
27,39,213902372,39237,Fraroz,56,52,4
27,39,213902380,39238,Frasne-les-Meulières,116,109,7
27,39,213902398,39239,La Frasnée,41,39,2
27,39,213902406,39240,Le Frasnois,175,170,5
27,39,213902414,39241,Frébuans,388,380,8
27,39,213902448,39244,Frontenay,164,159,5
27,39,213902455,39245,Gatey,370,360,10
27,39,213902463,39246,Gendrey,444,431,13
27,39,213902471,39247,Genod,75,74,1
27,39,213902489,39248,Geraise,44,44,0
27,39,213902497,39249,Germigney,79,75,4
27,39,213902505,39250,Geruge,181,178,3
27,39,213902513,39251,Gevingey,544,449,95
27,39,213902521,39252,Gevry,725,714,11
27,39,213902539,39253,Gigny,279,271,8
27,39,213902547,39254,Gillois,143,137,6
27,39,213902554,39255,Gizia,235,230,5
27,39,200086817,39258,Grande-Rivière Château,646,632,14
27,39,213902596,39259,Grange-de-Vaivre,37,37,0
27,39,213902612,39261,Graye-et-Charnay,142,139,3
27,39,213902620,39262,Gredisans,133,132,1
27,39,213902638,39263,Grozon,402,389,13
27,39,213902653,39265,Hautecour,203,199,4
27,39,213902661,39266,Les Hays,351,349,2
27,39,213902679,39267,Ivory,102,98,4
27,39,213902687,39268,Ivrey,60,59,1
27,39,213902695,39269,Jeurre,263,258,5
27,39,213902703,39270,Jouhe,596,537,59
27,39,213902711,39271,Lac-des-Rouges-Truites,407,390,17
27,39,213902729,39272,Ladoye-sur-Seille,50,47,3
27,39,200062578,39273,Montlainsia,236,232,4
27,39,213902745,39274,Lajoux,298,286,12
27,39,213902752,39275,Lamoura,665,648,17
27,39,213902778,39277,Le Larderet,54,53,1
27,39,213902786,39278,Largillay-Marsonnay,140,138,2
27,39,213902794,39279,Larnaud,622,610,12
27,39,213902802,39280,Larrivoire,103,101,2
27,39,213902810,39281,Le Latet,89,87,2
27,39,213902828,39282,La Latette,81,79,2
27,39,213902836,39283,Lavancia-Epercy,639,621,18
27,39,213902844,39284,Lavangeot,144,143,1
27,39,213902851,39285,Lavans-lès-Dole,339,331,8
27,39,200084820,39286,Lavans-lès-Saint-Claude,2433,2327,106
27,39,213902885,39288,Lavigny,393,384,9
27,39,213902893,39289,Lect,355,348,7
27,39,200063220,39290,Valzin en Petite Montagne,478,466,12
27,39,213902919,39291,Lemuy,245,239,6
27,39,213902927,39292,Lent,160,156,4
27,39,213902935,39293,Leschères,210,206,4
27,39,213902950,39295,Loisia,161,160,1
27,39,213902968,39296,Lombard,219,214,5
27,39,213902976,39297,Longchaumois,1165,1134,31
27,39,213902984,39298,Longcochon,61,58,3
27,39,213902992,39299,Longwy-sur-le-Doubs,498,487,11
27,39,213903008,39300,Lons-le-Saunier,17921,17092,829
27,39,213903016,39301,Loulle,175,171,4
27,39,213903024,39302,Louvatange,99,95,4
27,39,213903040,39304,Le Louverot,237,228,9
27,39,213903057,39305,La Loye,584,574,10
27,39,213903065,39306,Macornay,1008,979,29
27,39,213903073,39307,Maisod,338,328,10
27,39,213903081,39308,Malange,323,317,6
27,39,213903107,39310,Mantry,493,479,14
27,39,213903123,39312,Marigna-sur-Valouse,111,110,1
27,39,213903131,39313,Marigny,216,215,1
27,39,213903149,39314,Marnézia,81,77,4
27,39,213903156,39315,Marnoz,415,394,21
27,39,213903172,39317,La Marre,370,355,15
27,39,213903180,39318,Martigna,203,190,13
27,39,213903198,39319,Mathenay,145,144,1
27,39,213903206,39320,Maynal,337,336,1
27,39,213903214,39321,Menétru-le-Vignoble,164,159,5
27,39,213903222,39322,Menétrux-en-Joux,60,60,0
27,39,213903230,39323,Menotey,328,316,12
27,39,213903248,39324,Mérona,7,7,0
27,39,213903255,39325,Mesnay,590,574,16
27,39,213903263,39326,Mesnois,179,175,4
27,39,213903271,39327,Messia-sur-Sorne,867,853,14
27,39,213903289,39328,Meussia,435,427,8
27,39,200054062,39329,Mièges,172,170,2
27,39,213903305,39330,Miéry,157,152,5
27,39,200057115,39331,Mignovillard,871,846,25
27,39,213903339,39333,Moirans-en-Montagne,2241,2133,108
27,39,213903347,39334,Moiron,133,128,5
27,39,213903354,39335,Moissey,582,569,13
27,39,213903362,39336,Molain,116,112,4
27,39,213903370,39337,Molamboz,89,88,1
27,39,213903388,39338,Molay,515,506,9
27,39,200085959,39339,Chassal-Molinges,1149,1120,29
27,39,213903420,39342,Monay,124,123,1
27,39,213903438,39343,Monnetay,16,16,0
27,39,213903446,39344,Monnet-la-Ville,347,333,14
27,39,213903453,39345,Monnières,414,397,17
27,39,213903461,39346,Montagna-le-Reconduit,116,111,5
27,39,213903487,39348,Montaigu,461,414,47
27,39,213903495,39349,Montain,514,490,24
27,39,213903503,39350,Montbarrey,312,306,6
27,39,213903511,39351,Montcusel,153,147,6
27,39,213903529,39352,Monteplain,140,137,3
27,39,213903537,39353,Montfleur,173,164,9
27,39,213903545,39354,Montholier,375,372,3
27,39,213903552,39355,Montigny-lès-Arsures,241,235,6
27,39,213903560,39356,Montigny-sur-l'Ain,215,207,8
27,39,213903594,39359,Montmarlon,32,32,0
27,39,213903602,39360,Montmirey-la-Ville,174,173,1
27,39,213903610,39361,Montmirey-le-Château,199,194,5
27,39,213903628,39362,Montmorot,3430,3099,331
27,39,213903636,39363,Montrevel,84,83,1
27,39,213903644,39364,Montrond,508,494,14
27,39,213903651,39365,Mont-sous-Vaudrey,1307,1287,20
27,39,213903669,39366,Mont-sur-Monnet,247,231,16
27,39,200007078,39367,Morbier,2358,2274,84
27,39,200060051,39368,Hauts de Bienne,5496,5226,270
27,39,213903701,39370,Mouchard,1377,1062,315
27,39,213903727,39372,Mournans-Charbonny,95,87,8
27,39,213903735,39373,Les Moussières,165,160,5
27,39,213903750,39375,Moutonne,129,129,0
27,39,213903768,39376,Moutoux,76,74,2
27,39,213903776,39377,Mutigney,182,174,8
27,39,200085975,39378,Les Trois-Châteaux,781,766,15
27,39,213903792,39379,Nance,537,526,11
27,39,213903800,39380,Nancuise,46,44,2
27,39,213903818,39381,Les Nans,101,98,3
27,39,213903859,39385,Neublans-Abergement,548,541,7
27,39,213903867,39386,Neuvilley,95,95,0
27,39,213903875,39387,Nevy-lès-Dole,300,294,6
27,39,213903883,39388,Nevy-sur-Seille,203,195,8
27,39,213903891,39389,Ney,609,595,14
27,39,213903909,39390,Nogna,309,297,12
27,39,213903917,39391,Nozeroy,406,394,12
27,39,213903925,39392,Offlanges,195,192,3
27,39,213903933,39393,Onglières,65,63,2
27,39,213903941,39394,Onoz,74,70,4
27,39,213903966,39396,Orchamps,1117,1105,12
27,39,213903974,39397,Orgelet,1651,1604,47
27,39,213903982,39398,Ougney,408,405,3
27,39,213903990,39399,Ounans,348,340,8
27,39,213904006,39400,Our,151,149,2
27,39,213904014,39401,Oussières,243,237,6
27,39,213904022,39402,Pagney,347,341,6
27,39,213904030,39403,Pagnoz,228,221,7
27,39,213904048,39404,Pannessières,485,474,11
27,39,213904055,39405,Parcey,1025,1004,21
27,39,213904063,39406,Le Pasquier,271,268,3
27,39,213904071,39407,Passenans,342,336,6
27,39,213904089,39408,Patornay,160,154,6
27,39,213904097,39409,Peintre,137,133,4
27,39,213904113,39411,Perrigny,1556,1511,45
27,39,213904121,39412,Peseux,319,312,7
27,39,213904139,39413,La Pesse,337,329,8
27,39,213904154,39415,Petit-Noir,1102,1093,9
27,39,213904188,39418,Picarreau,100,98,2
27,39,213904196,39419,Pillemoine,62,62,0
27,39,213904204,39420,Pimorin,211,208,3
27,39,213904212,39421,Le Pin,257,242,15
27,39,213904220,39422,Plainoiseau,533,522,11
27,39,213904238,39423,Plaisia,113,104,9
27,39,213904246,39424,Les Planches-en-Montagne,162,159,3
27,39,213904253,39425,Les Planches-près-Arbois,88,88,0
27,39,213904261,39426,Plasne,220,210,10
27,39,213904279,39427,Plénise,63,62,1
27,39,213904287,39428,Plénisette,25,22,3
27,39,213904295,39429,Pleure,446,439,7
27,39,213904303,39430,Plumont,106,105,1
27,39,213904311,39431,Poids-de-Fiole,338,334,4
27,39,213904329,39432,Pointre,128,126,2
27,39,213904345,39434,Poligny,4384,4013,371
27,39,213904352,39435,Pont-de-Poitte,653,631,22
27,39,213904360,39436,Pont-d'Héry,234,234,0
27,39,213904378,39437,Pont-du-Navoy,279,275,4
27,39,213904394,39439,Port-Lesney,540,529,11
27,39,213904410,39441,Prémanon,1233,1201,32
27,39,213904436,39443,Présilly,123,118,5
27,39,213904444,39444,Pretin,62,60,2
27,39,213904451,39445,Publy,297,282,15
27,39,213904469,39446,Pupillin,255,248,7
27,39,213904477,39447,Quintigny,279,268,11
27,39,213904485,39448,Rahon,476,461,15
27,39,213904493,39449,Rainans,274,264,10
27,39,213904519,39451,Ranchot,508,505,3
27,39,213904527,39452,Rans,534,527,7
27,39,213904535,39453,Ravilloles,460,448,12
27,39,213904543,39454,Recanoz,94,92,2
27,39,213904550,39455,Reithouse,54,53,1
27,39,213904568,39456,Relans,349,345,4
27,39,213904576,39457,Les Repôts,55,55,0
27,39,213904584,39458,Revigny,251,241,10
27,39,213904600,39460,La Rixouse,201,193,8
27,39,213904618,39461,Rix,84,84,0
27,39,213904626,39462,Rochefort-sur-Nenon,680,676,4
27,39,213904634,39463,Rogna,237,231,6
27,39,213904642,39464,Romain,218,212,6
27,39,213904659,39465,Romange,205,203,2
27,39,213904667,39466,Rosay,124,123,1
27,39,213904675,39467,Rotalier,159,153,6
27,39,213904683,39468,Rothonay,142,139,3
27,39,213904691,39469,Rouffange,116,116,0
27,39,213904709,39470,Les Rousses,3738,3663,75
27,39,213904717,39471,Ruffey-sur-Seille,775,758,17
27,39,213904725,39472,Rye,214,209,5
27,39,213904733,39473,Saffloz,91,89,2
27,39,213904741,39474,Sainte-Agnès,364,355,9
27,39,213904758,39475,Saint-Amour,2476,2379,97
27,39,213904766,39476,Saint-Aubin,1867,1821,46
27,39,213904774,39477,Saint-Baraing,265,260,5
27,39,213904782,39478,Saint-Claude,9139,8895,244
27,39,213904790,39479,Saint-Cyr-Montmalin,250,243,7
27,39,213904808,39480,Saint-Didier,275,266,9
27,39,213904816,39481,Saint-Germain-en-Montagne,392,383,9
27,39,200067734,39485,Val Suran,801,787,14
27,39,213904865,39486,Saint-Lamain,118,114,4
27,39,213904873,39487,Saint-Laurent-en-Grandvaux,1861,1824,37
27,39,213904899,39489,Saint-Lothain,467,456,11
27,39,213904907,39490,Saint-Loup,250,245,5
27,39,200063238,39491,Coteaux du Lizon,2282,2191,91
27,39,213904923,39492,Saint-Maur,235,229,6
27,39,213904931,39493,Saint-Maurice-Crillat,233,232,1
27,39,213904949,39494,Saint-Pierre,389,368,21
27,39,213904956,39495,Saint-Thiébaud,70,70,0
27,39,213904972,39497,Saizenay,96,94,2
27,39,213904980,39498,Salans,634,619,15
27,39,213904998,39499,Saligney,193,192,1
27,39,213905003,39500,Salins-les-Bains,2678,2528,150
27,39,213905011,39501,Sampans,1198,1171,27
27,39,213905029,39502,Santans,288,280,8
27,39,213905037,39503,Sapois,411,396,15
27,39,213905045,39504,Sarrogna,229,222,7
27,39,213905052,39505,Saugeot,61,58,3
27,39,213905078,39507,Séligney,80,79,1
27,39,213905086,39508,Sellières,734,725,9
27,39,200071355,39510,Septmoncel les Molunes,822,800,22
27,39,213905110,39511,Sergenaux,65,62,3
27,39,213905128,39512,Sergenon,54,52,2
27,39,213905136,39513,Sermange,232,231,1
27,39,213905144,39514,Serre-les-Moulières,196,188,8
27,39,213905177,39517,Sirod,541,527,14
27,39,213905185,39518,Songeson,73,71,2
27,39,213905193,39519,Soucia,180,175,5
27,39,213905201,39520,Souvans,501,492,9
27,39,213905227,39522,Supt,107,105,2
27,39,213905235,39523,Syam,200,191,9
27,39,213905250,39525,Tassenières,404,395,9
27,39,213905268,39526,Tavaux,4038,3934,104
27,39,213905276,39527,Taxenne,121,121,0
27,39,213905284,39528,Thervay,393,383,10
27,39,213905292,39529,Thésy,65,64,1
27,39,200073021,39530,Thoirette-Coisia,871,848,23
27,39,213905318,39531,Thoiria,189,184,5
27,39,213905326,39532,Thoissia,39,38,1
27,39,213905334,39533,Toulouse-le-Château,221,215,6
27,39,213905342,39534,La Tour-du-Meix,256,250,6
27,39,213905359,39535,Tourmont,470,456,14
27,39,200062693,39537,Trenal,471,461,10
27,39,213905383,39538,Uxelles,62,61,1
27,39,213905391,39539,Vadans,302,296,6
27,39,213905409,39540,Valempoulières,200,189,11
27,39,213905433,39543,Vannoz,228,219,9
27,39,213905458,39545,Le Vaudioux,175,170,5
27,39,213905466,39546,Vaudrey,368,355,13
27,39,213905474,39547,Vaux-lès-Saint-Claude,695,677,18
27,39,213905482,39548,Vaux-sur-Poligny,78,73,5
27,39,213905508,39550,Verges,198,193,5
27,39,213905516,39551,Véria,118,115,3
27,39,213905524,39552,Vernantois,307,297,10
27,39,213905532,39553,Le Vernois,299,289,10
27,39,213905540,39554,Vers-en-Montagne,233,227,6
27,39,213905557,39555,Vers-sous-Sellières,254,252,2
27,39,213905565,39556,Vertamboz,98,95,3
27,39,213905573,39557,Vescles,192,184,8
27,39,213905581,39558,Vevy,310,297,13
27,39,213905599,39559,La Vieille-Loye,396,392,4
27,39,213905607,39560,Villard-Saint-Sauveur,618,604,14
27,39,213905615,39561,Villards-d'Héria,391,385,6
27,39,213905656,39565,Villeneuve-d'Aval,90,89,1
27,39,213905672,39567,Villeneuve-sous-Pymont,308,298,10
27,39,213905680,39568,Villerserine,40,38,2
27,39,213905698,39569,Villers-Farlay,687,676,11
27,39,213905706,39570,Villers-les-Bois,223,222,1
27,39,213905714,39571,Villers-Robert,236,235,1
27,39,213905722,39572,Villette-lès-Arbois,398,390,8
27,39,213905730,39573,Villette-lès-Dole,797,781,16
27,39,213905748,39574,Villevieux,731,711,20
27,39,213905755,39575,Le Villey,91,89,2
27,39,200063212,39576,Val-Sonnette,962,936,26
27,39,200061760,39577,Vincent-Froideville,408,395,13
27,39,213905797,39579,Viry,931,890,41
27,39,213905813,39581,Vitreux,274,273,1
27,39,213905821,39582,Voiteur,808,785,23
27,39,200077246,39583,Vosbles-Valfin,189,184,5
27,39,213905847,39584,Vriange,163,162,1
27,39,213905854,39585,Vulvoz,20,20,0
27,39,213905862,39586,Aresches,28,28,0
75,40,214000010,40001,Aire-sur-l'Adour,6753,6197,556
75,40,214000028,40002,Amou,1588,1565,23
75,40,214000036,40003,Angoumé,280,271,9
75,40,214000044,40004,Angresse,2242,2193,49
75,40,214000051,40005,Arboucave,205,202,3
75,40,214000069,40006,Arengosse,713,706,7
75,40,214000077,40007,Argelos,168,166,2
75,40,214000085,40008,Argelouse,101,99,2
75,40,214000119,40011,Arsague,332,329,3
75,40,214000127,40012,Artassenx,267,263,4
75,40,214000135,40013,Arthez-d'Armagnac,102,97,5
75,40,214000143,40014,Arue,363,358,5
75,40,214000150,40015,Arx,48,46,2
75,40,214000168,40016,Aubagnan,262,260,2
75,40,214000176,40017,Audignon,402,393,9
75,40,214000184,40018,Audon,394,388,6
75,40,214000192,40019,Aureilhan,1097,1068,29
75,40,214000200,40020,Aurice,648,625,23
75,40,214000218,40021,Azur,924,904,20
75,40,214000226,40022,Bahus-Soubiran,408,395,13
75,40,214000234,40023,Baigts,353,345,8
75,40,214000242,40024,Banos,267,263,4
75,40,214000259,40025,Bascons,865,843,22
75,40,214000267,40026,Bas-Mauco,384,374,10
75,40,214000275,40027,Bassercles,157,155,2
75,40,214000283,40028,Bastennes,266,257,9
75,40,214000291,40029,Bats,324,317,7
75,40,214000309,40030,Baudignan,50,50,0
75,40,214000317,40031,Bégaar,1210,1198,12
75,40,214000325,40032,Belhade,213,211,2
75,40,214000333,40033,Bélis,164,159,5
75,40,214000341,40034,Bélus,630,605,25
75,40,214000358,40035,Bénesse-lès-Dax,579,569,10
75,40,214000366,40036,Bénesse-Maremne,3819,3748,71
75,40,214000374,40037,Benquet,1924,1878,46
75,40,214000382,40038,Bergouey,112,108,4
75,40,214000390,40039,Betbezer-d'Armagnac,152,152,0
75,40,214000408,40040,Beylongue,382,373,9
75,40,214000416,40041,Beyries,130,128,2
75,40,214000424,40042,Biarrotte,349,342,7
75,40,214000432,40043,Bias,779,766,13
75,40,214000440,40044,Biaudos,971,953,18
75,40,214000465,40046,Biscarrosse,14393,14034,359
75,40,214000473,40047,Bonnegarde,270,264,6
75,40,214000499,40049,Bordères-et-Lamensans,403,397,6
75,40,214000507,40050,Bostens,211,209,2
75,40,214000515,40051,Bougue,869,842,27
75,40,214000523,40052,Bourdalat,214,210,4
75,40,214000531,40053,Bourriot-Bergonce,310,306,4
75,40,214000549,40054,Brassempouy,269,263,6
75,40,214000556,40055,Bretagne-de-Marsan,1672,1643,29
75,40,214000564,40056,Brocas,783,763,20
75,40,214000572,40057,Buanes,254,248,6
75,40,214000580,40058,Cachen,238,227,11
75,40,214000598,40059,Cagnotte,785,765,20
75,40,214000606,40060,Callen,143,139,4
75,40,214000614,40061,Campagne,1020,994,26
75,40,214000622,40062,Campet-et-Lamolère,530,523,7
75,40,214000630,40063,Candresse,848,831,17
75,40,214000648,40064,Canenx-et-Réaut,173,170,3
75,40,214000655,40065,Capbreton,9494,9181,313
75,40,214000663,40066,Carcarès-Sainte-Croix,542,538,4
75,40,214000671,40067,Carcen-Ponson,642,636,6
75,40,214000689,40068,Cassen,602,584,18
75,40,214000697,40069,Castaignos-Souslens,421,416,5
75,40,214000705,40070,Castandet,419,406,13
75,40,214000713,40071,Castelnau-Chalosse,648,605,43
75,40,214000721,40072,Castelnau-Tursan,192,186,6
75,40,214000739,40073,Castelner,121,119,2
75,40,214000747,40074,Castel-Sarrazin,577,558,19
75,40,214000754,40075,Castets,2525,2497,28
75,40,214000762,40076,Cauna,444,436,8
75,40,214000770,40077,Cauneille,816,799,17
75,40,214000788,40078,Caupenne,402,395,7
75,40,214000796,40079,Cazalis,140,135,5
75,40,214000804,40080,Cazères-sur-l'Adour,1161,1128,33
75,40,214000812,40081,Cère,414,408,6
75,40,214000820,40082,Classun,259,252,7
75,40,214000838,40083,Clèdes,127,120,7
75,40,214000846,40084,Clermont,779,745,34
75,40,214000853,40085,Commensacq,441,429,12
75,40,214000861,40086,Coudures,544,536,8
75,40,214000879,40087,Créon-d'Armagnac,358,353,5
75,40,214000887,40088,Dax,21857,21044,813
75,40,214000895,40089,Doazit,882,856,26
75,40,214000903,40090,Donzacq,472,462,10
75,40,214000911,40091,Duhort-Bachen,664,646,18
75,40,214000929,40092,Dumes,226,221,5
75,40,214000937,40093,Escalans,256,253,3
75,40,214000945,40094,Escource,764,751,13
75,40,214000952,40095,Estibeaux,723,703,20
75,40,214000960,40096,Estigarde,105,103,2
75,40,214000978,40097,Eugénie-les-Bains,470,460,10
75,40,214000986,40098,Eyres-Moncube,365,353,12
75,40,214000994,40099,Fargues,326,323,3
75,40,214001000,40100,Le Frêche,411,409,2
75,40,214001018,40101,Gaas,488,474,14
75,40,214001026,40102,Gabarret,1506,1277,229
75,40,214001034,40103,Gaillères,646,634,12
75,40,214001042,40104,Gamarde-les-Bains,1494,1460,34
75,40,214001059,40105,Garein,446,433,13
75,40,214001067,40106,Garrey,222,216,6
75,40,214001083,40108,Gastes,886,869,17
75,40,214001091,40109,Gaujacq,442,433,9
75,40,214001109,40110,Geaune,765,750,15
75,40,214001117,40111,Geloux,718,702,16
75,40,214001125,40112,Gibret,101,100,1
75,40,214001133,40113,Goos,537,528,9
75,40,214001141,40114,Gourbera,372,359,13
75,40,214001158,40115,Gousse,297,287,10
75,40,214001166,40116,Gouts,277,274,3
75,40,214001174,40117,Grenade-sur-l'Adour,2523,2443,80
75,40,214001182,40118,Habas,1499,1470,29
75,40,214001190,40119,Hagetmau,4739,4631,108
75,40,214001208,40120,Hastingues,615,598,17
75,40,214001216,40121,Hauriet,281,276,5
75,40,214001224,40122,Haut-Mauco,1009,981,28
75,40,214001232,40123,Herm,1191,1158,33
75,40,214001240,40124,Herré,142,140,2
75,40,214001257,40125,Heugas,1409,1371,38
75,40,214001265,40126,Hinx,1924,1881,43
75,40,214001273,40127,Hontanx,624,616,8
75,40,214001281,40128,Horsarrieu,717,698,19
75,40,214001299,40129,Josse,933,914,19
75,40,214001307,40130,Labastide-Chalosse,160,160,0
75,40,214001315,40131,Labastide-d'Armagnac,694,689,5
75,40,214001323,40132,Labatut,1443,1417,26
75,40,214001331,40133,Labenne,7050,6934,116
75,40,214001349,40134,Labouheyre,2831,2795,36
75,40,214001356,40135,Labrit,871,863,8
75,40,214001364,40136,Lacajunte,159,156,3
75,40,214001372,40137,Lacquy,295,285,10
75,40,214001380,40138,Lacrabe,289,283,6
75,40,214001398,40139,Laglorieuse,570,555,15
75,40,214001406,40140,Lagrange,194,191,3
75,40,214001414,40141,Lahosse,295,291,4
75,40,214001422,40142,Laluque,1074,1054,20
75,40,214001430,40143,Lamothe,306,302,4
75,40,214001448,40144,Larbey,254,245,9
75,40,214001455,40145,Larrivière-Saint-Savin,616,594,22
75,40,214001463,40146,Latrille,168,165,3
75,40,214001471,40147,Laurède,373,370,3
75,40,214001489,40148,Lauret,85,82,3
75,40,214001497,40149,Lencouacq,378,373,5
75,40,214001505,40150,Léon,1985,1932,53
75,40,214001513,40151,Lesgor,444,432,12
75,40,214001521,40152,Lesperon,1051,1026,25
75,40,214001539,40153,Le Leuy,237,231,6
75,40,214001547,40154,Lévignacq,318,312,6
75,40,214001554,40155,Linxe,1552,1513,39
75,40,214001562,40156,Liposthey,571,566,5
75,40,214001570,40157,Lit-et-Mixe,1721,1682,39
75,40,214001588,40158,Losse,277,274,3
75,40,214001596,40159,Louer,324,320,4
75,40,214001604,40160,Lourquen,187,180,7
75,40,214001612,40161,Lubbon,85,84,1
75,40,214001620,40162,Lucbardez-et-Bargues,585,575,10
75,40,214001638,40163,Lüe,589,581,8
75,40,214001646,40164,Retjons,363,362,1
75,40,214001653,40165,Luglon,391,380,11
75,40,214001661,40166,Lussagnet,76,75,1
75,40,214001679,40167,Luxey,664,654,10
75,40,214001687,40168,Magescq,2487,2450,37
75,40,214001695,40169,Maillas,129,126,3
75,40,214001703,40170,Maillères,234,231,3
75,40,214001711,40171,Mano,123,120,3
75,40,214001729,40172,Mant,274,267,7
75,40,214001737,40173,Marpaps,144,139,5
75,40,214001745,40174,Mauries,89,85,4
75,40,214001752,40175,Maurrin,450,444,6
75,40,214001760,40176,Mauvezin-d'Armagnac,87,86,1
75,40,214001778,40177,Maylis,328,311,17
75,40,214001786,40178,Mazerolles,669,642,27
75,40,214001794,40179,Mées,1888,1841,47
75,40,214001802,40180,Meilhan,1188,1158,30
75,40,214001810,40181,Messanges,1019,986,33
75,40,214001828,40182,Mézos,842,831,11
75,40,214001836,40183,Mimbaste,995,965,30
75,40,214001844,40184,Mimizan,7489,7321,168
75,40,214001851,40185,Miramont-Sensacq,362,354,8
75,40,214001869,40186,Misson,840,822,18
75,40,214001877,40187,Moliets-et-Maa,1244,1225,19
75,40,214001885,40188,Momuy,487,475,12
75,40,214001893,40189,Monget,85,82,3
75,40,214001901,40190,Monségur,401,390,11
75,40,214001919,40191,Montaut,628,616,12
75,40,214001927,40192,Mont-de-Marsan,31366,29953,1413
75,40,214001935,40193,Montégut,78,76,2
75,40,214001943,40194,Montfort-en-Chalosse,1224,1193,31
75,40,214001950,40195,Montgaillard,624,611,13
75,40,214001968,40196,Montsoué,578,565,13
75,40,200084713,40197,Morcenx-la-Nouvelle,5108,4976,132
75,40,214001984,40198,Morganx,180,173,7
75,40,214001992,40199,Mouscardès,273,269,4
75,40,214002008,40200,Moustey,679,669,10
75,40,214002016,40201,Mugron,1432,1329,103
75,40,214002024,40202,Narrosse,3335,3259,76
75,40,214002032,40203,Nassiet,333,320,13
75,40,214002040,40204,Nerbis,271,267,4
75,40,214002057,40205,Nousse,255,247,8
75,40,214002065,40206,Oeyregave,330,317,13
75,40,214002073,40207,Oeyreluy,1715,1507,208
75,40,214002081,40208,Onard,371,365,6
75,40,214002099,40209,Ondres,5639,5519,120
75,40,214002107,40210,Onesse-Laharie,1051,1032,19
75,40,214002115,40211,Orist,780,762,18
75,40,214002123,40212,Orthevielle,1045,1028,17
75,40,214002131,40213,Orx,653,640,13
75,40,214002149,40214,Ossages,505,499,6
75,40,214002156,40215,Ousse-Suzan,294,286,8
75,40,214002164,40216,Ozourt,199,197,2
75,40,214002172,40217,Parentis-en-Born,7123,6928,195
75,40,214002180,40218,Parleboscq,501,488,13
75,40,214002198,40219,Payros-Cazautets,109,107,2
75,40,214002206,40220,Pécorade,140,138,2
75,40,214002214,40221,Perquie,343,339,4
75,40,214002222,40222,Pey,758,744,14
75,40,214002230,40223,Peyre,237,230,7
75,40,214002248,40224,Peyrehorade,3821,3637,184
75,40,214002255,40225,Philondenx,198,196,2
75,40,214002263,40226,Pimbo,206,203,3
75,40,214002271,40227,Pissos,1473,1453,20
75,40,214002289,40228,Pomarez,1608,1579,29
75,40,214002297,40229,Pontenx-les-Forges,1706,1673,33
75,40,214002305,40230,Pontonx-sur-l'Adour,2997,2899,98
75,40,214002313,40231,Port-de-Lanne,1228,1195,33
75,40,214002321,40232,Poudenx,230,220,10
75,40,214002339,40233,Pouillon,3169,3105,64
75,40,214002347,40234,Pouydesseaux,927,899,28
75,40,214002354,40235,Poyanne,712,693,19
75,40,214002362,40236,Poyartin,800,781,19
75,40,214002370,40237,Préchacq-les-Bains,782,776,6
75,40,214002388,40238,Pujo-le-Plan,641,623,18
75,40,214002396,40239,Puyol-Cazalet,107,104,3
75,40,214002404,40240,Renung,525,507,18
75,40,214002420,40242,Rimbez-et-Baudiets,104,104,0
75,40,200068708,40243,Rion-des-Landes,3106,3065,41
75,40,214002446,40244,Rivière-Saas-et-Gourby,1354,1324,30
75,40,214002453,40245,Roquefort,1962,1927,35
75,40,214002461,40246,Sabres,1312,1163,149
75,40,214002479,40247,Saint-Agnet,185,179,6
75,40,214002487,40248,Saint-André-de-Seignanx,1918,1890,28
75,40,214002495,40249,Saint-Aubin,513,501,12
75,40,214002503,40250,Saint-Avit,725,703,22
75,40,214002511,40251,Saint-Barthélemy,434,420,14
75,40,214002529,40252,Sainte-Colombe,645,630,15
75,40,214002537,40253,Saint-Cricq-Chalosse,658,647,11
75,40,214002545,40254,Saint-Cricq-du-Gave,443,431,12
75,40,214002552,40255,Saint-Cricq-Villeneuve,480,469,11
75,40,214002560,40256,Saint-Étienne-d'Orthe,729,713,16
75,40,214002578,40257,Sainte-Eulalie-en-Born,1371,1340,31
75,40,214002586,40258,Sainte-Foy,255,252,3
75,40,214002594,40259,Saint-Gein,442,428,14
75,40,214002602,40260,Saint-Geours-d'Auribat,424,417,7
75,40,214002610,40261,Saint-Geours-de-Maremne,2862,2812,50
75,40,214002628,40262,Saint-Gor,323,317,6
75,40,214002636,40263,Saint-Jean-de-Lier,418,411,7
75,40,214002644,40264,Saint-Jean-de-Marsacq,1780,1755,25
75,40,214002651,40265,Saint-Julien-d'Armagnac,111,111,0
75,40,214002669,40266,Saint-Julien-en-Born,1722,1687,35
75,40,214002677,40267,Saint-Justin,1021,1008,13
75,40,214002685,40268,Saint-Laurent-de-Gosse,721,699,22
75,40,214002693,40269,Saint-Lon-les-Mines,1271,1233,38
75,40,214002701,40270,Saint-Loubouer,455,442,13
75,40,214002719,40271,Sainte-Marie-de-Gosse,1226,1201,25
75,40,214002727,40272,Saint-Martin-de-Hinx,1700,1659,41
75,40,214002735,40273,Saint-Martin-de-Seignanx,6170,6033,137
75,40,214002743,40274,Saint-Martin-d'Oney,1410,1370,40
75,40,214002750,40275,Saint-Maurice-sur-Adour,636,617,19
75,40,214002768,40276,Saint-Michel-Escalus,324,316,8
75,40,214002776,40277,Saint-Pandelon,763,713,50
75,40,214002784,40278,Saint-Paul-en-Born,993,977,16
75,40,214002792,40279,Saint-Paul-lès-Dax,14609,14126,483
75,40,214002800,40280,Saint-Perdon,1754,1722,32
75,40,214002818,40281,Saint-Pierre-du-Mont,10087,9726,361
75,40,214002826,40282,Saint-Sever,5046,4927,119
75,40,214002834,40283,Saint-Vincent-de-Paul,3524,3337,187
75,40,214002842,40284,Saint-Vincent-de-Tyrosse,8046,7798,248
75,40,214002859,40285,Saint-Yaguen,639,625,14
75,40,214002867,40286,Samadet,1155,1131,24
75,40,214002875,40287,Sanguinet,4553,4487,66
75,40,214002883,40288,Sarbazan,1176,1153,23
75,40,214002891,40289,Sarraziet,255,254,1
75,40,214002909,40290,Sarron,110,107,3
75,40,214002917,40291,Saubion,1813,1780,33
75,40,214002925,40292,Saubrigues,1616,1543,73
75,40,214002933,40293,Saubusse,1122,1100,22
75,40,214002941,40294,Saugnac-et-Cambran,1602,1569,33
75,40,214002958,40295,Saugnac-et-Muret,1149,1130,19
75,40,214002966,40296,Seignosse,3986,3890,96
75,40,214002974,40297,Le Sen,236,233,3
75,40,214002982,40298,Serres-Gaston,410,398,12
75,40,214002990,40299,Serreslous-et-Arribans,200,189,11
75,40,214003006,40300,Seyresse,1031,996,35
75,40,214003014,40301,Siest,143,138,5
75,40,214003030,40303,Solférino,337,335,2
75,40,214003048,40304,Soorts-Hossegor,3584,3497,87
75,40,214003055,40305,Sorbets,199,191,8
75,40,214003063,40306,Sorde-l'Abbaye,632,619,13
75,40,214003071,40307,Sore,1179,1156,23
75,40,214003089,40308,Sort-en-Chalosse,915,889,26
75,40,214003097,40309,Souprosse,1153,1134,19
75,40,214003105,40310,Soustons,8522,8318,204
75,40,214003113,40311,Taller,669,655,14
75,40,214003121,40312,Tarnos,13234,12914,320
75,40,214003139,40313,Tartas,3255,3209,46
75,40,214003147,40314,Tercis-les-Bains,1308,1283,25
75,40,214003154,40315,Téthieu,788,777,11
75,40,214003162,40316,Tilh,855,836,19
75,40,214003170,40317,Tosse,3390,3308,82
75,40,214003188,40318,Toulouzette,329,323,6
75,40,214003196,40319,Trensacq,262,255,7
75,40,214003204,40320,Uchacq-et-Parentis,616,602,14
75,40,214003212,40321,Urgons,252,243,9
75,40,214003220,40322,Uza,205,203,2
75,40,214003238,40323,Vert,251,246,5
75,40,214003246,40324,Vicq-d'Auribat,268,258,10
75,40,214003253,40325,Vielle-Tursan,289,278,11
75,40,214003261,40326,Vielle-Saint-Girons,1472,1438,34
75,40,214003279,40327,Vielle-Soubiran,229,224,5
75,40,214003287,40328,Vieux-Boucau-les-Bains,1670,1637,33
75,40,214003295,40329,Le Vignau,485,479,6
75,40,214003303,40330,Villenave,319,311,8
75,40,214003311,40331,Villeneuve-de-Marsan,2492,2445,47
75,40,214003329,40332,Ychoux,2379,2323,56
75,40,214003337,40333,Ygos-Saint-Saturnin,1370,1344,26
75,40,214003345,40334,Yzosse,390,377,13
24,41,214100018,41001,Ambloy,195,190,5
24,41,214100026,41002,Angé,833,812,21
24,41,214100034,41003,Areines,788,590,198
24,41,214100042,41004,Artins,269,264,5
24,41,214100067,41006,Autainville,452,444,8
24,41,214100075,41007,Authon,755,742,13
24,41,214100083,41008,Avaray,738,718,20
24,41,214100091,41009,Averdon,700,683,17
24,41,214100109,41010,Azé,1034,1005,29
24,41,214100125,41012,Baillou,216,204,12
24,41,214100133,41013,Bauzy,277,273,4
24,41,214100141,41014,Beauchêne,162,160,2
24,41,214100166,41016,Billy,1071,1056,15
24,41,214100174,41017,Binas,672,653,19
24,41,214100182,41018,Blois,48127,46660,1467
24,41,214100190,41019,Boisseau,95,93,2
24,41,214100208,41020,Bonneveau,463,458,5
24,41,214100224,41022,Bouffry,134,132,2
24,41,214100240,41024,Boursay,187,180,7
24,41,214100257,41025,Bracieux,1338,1321,17
24,41,214100265,41026,Brévainville,173,170,3
24,41,214100273,41027,Briou,145,143,2
24,41,214100281,41028,Busloup,491,482,9
24,41,214100299,41029,Candé-sur-Beuvron,1529,1504,25
24,41,214100307,41030,Cellé,230,226,4
24,41,214100315,41031,Cellettes,2742,2671,71
24,41,214100323,41032,Chailles,2762,2683,79
24,41,214100349,41034,Chambord,93,92,1
24,41,214100356,41035,Champigny-en-Beauce,632,619,13
24,41,214100364,41036,Chaon,458,450,8
24,41,214100372,41037,La Chapelle-Enchérie,214,210,4
24,41,214100380,41038,La Chapelle-Montmartin,423,411,12
24,41,214100398,41039,La Chapelle-Saint-Martin-en-Plaine,703,684,19
24,41,214100406,41040,La Chapelle-Vendômoise,827,800,27
24,41,214100414,41041,La Chapelle-Vicomtesse,161,158,3
24,41,214100422,41042,Châteauvieux,538,534,4
24,41,214100430,41043,Châtillon-sur-Cher,1713,1679,34
24,41,214100448,41044,Châtres-sur-Cher,1124,1110,14
24,41,214100455,41045,Chaumont-sur-Loire,1104,1082,22
24,41,214100463,41046,Chaumont-sur-Tharonne,1086,1064,22
24,41,214100471,41047,La Chaussée-Saint-Victor,4632,4519,113
24,41,214100489,41048,Chauvigny-du-Perche,233,229,4
24,41,214100497,41049,Chémery,948,935,13
24,41,214100505,41050,Cheverny,957,918,39
24,41,214100513,41051,Chissay-en-Touraine,1101,1075,26
24,41,214100521,41052,Chitenay,1145,1112,33
24,41,214100539,41053,Choue,537,527,10
24,41,214100547,41054,Choussy,347,342,5
24,41,200062768,41055,Valloire-sur-Cisse,2455,2401,54
24,41,214100570,41057,Conan,173,167,6
24,41,214100588,41058,Concriers,193,188,5
24,41,200084994,41059,Le Controis-en-Sologne,6817,6663,154
24,41,214100604,41060,Cormenon,721,711,10
24,41,214100612,41061,Cormeray,1579,1553,26
24,41,214100620,41062,Couddes,557,545,12
24,41,214100638,41063,Couffy,502,494,8
24,41,214100653,41065,Coulommiers-la-Tour,591,574,17
24,41,214100661,41066,Courbouzon,446,431,15
24,41,214100679,41067,Cour-Cheverny,2858,2781,77
24,41,214100687,41068,Courmemin,507,498,9
24,41,214100695,41069,Cour-sur-Loire,255,249,6
24,41,200085173,41070,Vallée-de-Ronsard,529,518,11
24,41,214100711,41071,Crouy-sur-Cosson,560,548,12
24,41,214100729,41072,Crucheray,423,407,16
24,41,214100737,41073,Danzé,694,677,17
24,41,214100745,41074,Dhuizon,1228,1214,14
24,41,214100752,41075,Droué,1021,1013,8
24,41,214100778,41077,Épiais,133,127,6
24,41,214100786,41078,Épuisay,841,823,18
24,41,214100794,41079,Les Essarts,101,101,0
24,41,214100802,41080,Faverolles-sur-Cher,1425,1397,28
24,41,214100810,41081,Faye,230,225,5
24,41,214100836,41083,La Ferté-Beauharnais,564,560,4
24,41,214100844,41084,La Ferté-Imbault,987,962,25
24,41,214100851,41085,La Ferté-Saint-Cyr,1069,1056,13
24,41,214100869,41086,Fontaines-en-Sologne,656,648,8
24,41,214100877,41087,Fontaine-les-Coteaux,333,328,5
24,41,214100885,41088,Fontaine-Raoul,239,235,4
24,41,214100893,41089,La Fontenelle,208,206,2
24,41,214100901,41090,Fortan,260,254,6
24,41,214100919,41091,Fossé,1326,1307,19
24,41,214100935,41093,Françay,280,272,8
24,41,214100943,41094,Fresnes,1204,1173,31
24,41,214100950,41095,Fréteval,1069,1053,16
24,41,214100968,41096,Le Gault-du-Perche,337,335,2
24,41,214100976,41097,Gièvres,2398,2367,31
24,41,214100984,41098,Gombergean,174,170,4
24,41,214100992,41099,Gy-en-Sologne,507,495,12
24,41,214101008,41100,Les Hayes,176,169,7
24,41,214101016,41101,Herbault,1188,1156,32
24,41,214101024,41102,Houssay,388,384,4
24,41,214101032,41103,Huisseau-en-Beauce,424,413,11
24,41,214101040,41104,Huisseau-sur-Cosson,2376,2322,54
24,41,214101057,41105,Josnes,872,856,16
24,41,214101065,41106,Lamotte-Beuvron,4666,4611,55
24,41,214101073,41107,Lancé,482,476,6
24,41,214101081,41108,Lancôme,123,122,1
24,41,214101099,41109,Landes-le-Gaulois,759,740,19
24,41,214101107,41110,Langon-sur-Cher,849,830,19
24,41,214101123,41112,Lassay-sur-Croisne,251,242,9
24,41,214101131,41113,Lavardin,186,178,8
24,41,214101149,41114,Lestiou,288,282,6
24,41,214101156,41115,Lignières,404,398,6
24,41,214101164,41116,Lisle,201,198,3
24,41,214101180,41118,Loreux,200,196,4
24,41,214101198,41119,Lorges,347,342,5
24,41,214101206,41120,Lunay,1285,1250,35
24,41,214101214,41121,La Madeleine-Villefrouin,32,32,0
24,41,214101222,41122,Maray,241,236,5
24,41,214101230,41123,Marchenoir,691,679,12
24,41,214101248,41124,Marcilly-en-Beauce,351,332,19
24,41,214101255,41125,Marcilly-en-Gault,734,717,17
24,41,214101263,41126,Mareuil-sur-Cher,1180,1159,21
24,41,214101271,41127,La Marolle-en-Sologne,340,336,4
24,41,214101289,41128,Marolles,736,717,19
24,41,214101297,41129,Maslives,710,698,12
24,41,214101305,41130,Maves,682,669,13
24,41,214101313,41131,Mazangé,846,819,27
24,41,214101321,41132,Méhers,323,317,6
24,41,214101347,41134,Menars,651,630,21
24,41,214101354,41135,Mennetou-sur-Cher,889,877,12
24,41,214101362,41136,Mer,6316,6211,105
24,41,214101370,41137,Mesland,594,570,24
24,41,214101388,41138,Meslay,322,313,9
24,41,214101396,41139,Meusnes,1106,1093,13
24,41,214101404,41140,Millançay,735,718,17
24,41,214101412,41141,Moisy,372,363,9
24,41,200063725,41142,Valencisse,2426,2331,95
24,41,214101438,41143,Mondoubleau,1357,1310,47
24,41,214101446,41144,Monteaux,749,727,22
24,41,214101453,41145,Monthou-sur-Bièvre,814,794,20
24,41,214101461,41146,Monthou-sur-Cher,972,958,14
24,41,214101479,41147,Les Montils,1956,1914,42
24,41,214101487,41148,Montlivault,1338,1305,33
24,41,214101495,41149,Montoire-sur-le-Loir,3893,3698,195
24,41,214101503,41150,Mont-près-Chambord,3400,3309,91
24,41,200056984,41151,Montrichard Val de Cher,3716,3675,41
24,41,214101529,41152,Montrieux-en-Sologne,645,633,12
24,41,214101537,41153,Montrouveau,151,149,2
24,41,214101545,41154,Morée,1111,1084,27
24,41,214101552,41155,Muides-sur-Loire,1266,1234,32
24,41,214101560,41156,Mulsans,541,527,14
24,41,214101578,41157,Mur-de-Sologne,1533,1517,16
24,41,214101586,41158,Naveil,2482,2423,59
24,41,214101594,41159,Neung-sur-Beuvron,1259,1243,16
24,41,214101602,41160,Neuvy,325,321,4
24,41,214101610,41161,Nouan-le-Fuzelier,2369,2321,48
24,41,214101636,41163,Nourray,123,121,2
24,41,214101644,41164,Noyers-sur-Cher,2738,2708,30
24,41,214101669,41166,Oisly,389,385,4
24,41,200065654,41167,Veuzain-sur-Loire,3488,3401,87
24,41,214101685,41168,Orçay,239,235,4
24,41,200065670,41171,Oucques La Nouvelle,1731,1702,29
24,41,214101727,41172,Ouzouer-le-Doyen,226,224,2
24,41,200055390,41173,Beauce la Romaine,3496,3436,60
24,41,214101743,41174,Périgny,180,174,6
24,41,214101750,41175,Pezou,1133,1113,20
24,41,214101768,41176,Pierrefitte-sur-Sauldre,752,739,13
24,41,214101776,41177,Le Plessis-Dorin,158,158,0
24,41,214101784,41178,Le Plessis-l'Échelle,63,61,2
24,41,214101792,41179,Le Poislay,190,189,1
24,41,214101800,41180,Pontlevoy,1695,1518,177
24,41,214101818,41181,Pouillé,822,801,21
24,41,214101826,41182,Pray,293,282,11
24,41,214101842,41184,Prunay-Cassereau,608,601,7
24,41,214101859,41185,Pruniers-en-Sologne,2359,2304,55
24,41,214101867,41186,Rahart,306,301,5
24,41,214101875,41187,Renay,180,176,4
24,41,214101883,41188,Rhodon,120,117,3
24,41,214101891,41189,Rilly-sur-Loire,480,474,6
24,41,214101909,41190,Rocé,226,220,6
24,41,214101917,41191,Roches,70,67,3
24,41,214101925,41192,Les Roches-l'Évêque,269,266,3
24,41,214101933,41193,Romilly,142,140,2
24,41,214101941,41194,Romorantin-Lanthenay,18685,18206,479
24,41,214101958,41195,Rougeou,150,148,2
24,41,214101966,41196,Ruan-sur-Egvonne,83,80,3
24,41,214101982,41198,Saint-Aignan,2930,2839,91
24,41,214101990,41199,Saint-Amand-Longpré,1233,1205,28
24,41,214102006,41200,Sainte-Anne,506,477,29
24,41,214102014,41201,Saint-Arnoult,323,320,3
24,41,214102030,41203,Saint-Bohaire,500,492,8
24,41,214102048,41204,Saint-Claude-de-Diray,1831,1789,42
24,41,214102055,41205,Saint-Cyr-du-Gault,177,175,2
24,41,214102063,41206,Saint-Denis-sur-Loire,902,876,26
24,41,214102071,41207,Saint-Dyé-sur-Loire,1162,1141,21
24,41,214102089,41208,Saint-Étienne-des-Guérets,118,114,4
24,41,214102097,41209,Saint-Firmin-des-Prés,835,793,42
24,41,214102113,41211,Saint-Georges-sur-Cher,2789,2735,54
24,41,214102121,41212,Saint-Gervais-la-Forêt,3262,3166,96
24,41,214102139,41213,Saint-Gourgon,105,100,5
24,41,214102147,41214,Saint-Hilaire-la-Gravelle,681,669,12
24,41,214102154,41215,Saint-Jacques-des-Guérets,98,96,2
24,41,214102162,41216,Saint-Jean-Froidmentel,552,543,9
24,41,214102170,41217,Saint-Julien-de-Chédon,765,751,14
24,41,214102188,41218,Saint-Julien-sur-Cher,777,764,13
24,41,214102196,41219,Saint-Laurent-des-Bois,325,322,3
24,41,214102204,41220,Saint-Laurent-Nouan,4381,4299,82
24,41,214102212,41221,Saint-Léonard-en-Beauce,663,646,17
24,41,214102220,41222,Saint-Loup,376,370,6
24,41,214102238,41223,Saint-Lubin-en-Vergonnois,791,781,10
24,41,214102246,41224,Saint-Marc-du-Cor,179,178,1
24,41,214102253,41225,Saint-Martin-des-Bois,585,574,11
24,41,214102261,41226,Saint-Ouen,3148,3056,92
24,41,214102287,41228,Saint-Rimay,297,294,3
24,41,214102295,41229,Saint-Romain-sur-Cher,1491,1458,33
24,41,214102303,41230,Saint-Sulpice-de-Pommeray,1889,1833,56
24,41,214102311,41231,Saint-Viâtre,1208,1181,27
24,41,214102329,41232,Salbris,5023,4925,98
24,41,214102337,41233,Sambin,895,880,15
24,41,214102345,41234,Santenay,298,289,9
24,41,214102352,41235,Sargé-sur-Braye,1029,1010,19
24,41,214102360,41236,Sasnières,93,90,3
24,41,214102378,41237,Sassay,1073,1055,18
24,41,214102386,41238,Savigny-sur-Braye,1995,1968,27
24,41,214102394,41239,Seigy,1024,1002,22
24,41,214102410,41241,Selles-Saint-Denis,1365,1342,23
24,41,214102428,41242,Selles-sur-Cher,4522,4459,63
24,41,214102436,41243,Selommes,828,808,20
24,41,214102451,41245,Séris,386,381,5
24,41,214102469,41246,Seur,499,481,18
24,41,214102477,41247,Soings-en-Sologne,1642,1618,24
24,41,200076495,41248,Couëtron-au-Perche,1053,1031,22
24,41,214102493,41249,Souesmes,1056,1042,14
24,41,214102501,41250,Sougé,489,481,8
24,41,214102519,41251,Souvigny-en-Sologne,547,538,9
24,41,214102527,41252,Suèvres,1584,1548,36
24,41,214102535,41253,Talcy,273,268,5
24,41,214102543,41254,Le Temple,186,182,4
24,41,214102550,41255,Ternay,336,330,6
24,41,214102568,41256,Theillay,1260,1244,16
24,41,214102584,41258,Thésée,1176,1153,23
24,41,214102592,41259,Thoré-la-Rochette,859,824,35
24,41,214102600,41260,Thoury,424,418,6
24,41,214102618,41261,Tourailles,135,132,3
24,41,214102626,41262,Tour-en-Sologne,1134,1119,15
24,41,214102659,41265,Troo,292,281,11
24,41,214102667,41266,Valaire,86,83,3
24,41,214102675,41267,Vallières-les-Grandes,957,941,16
24,41,214102683,41268,Veilleins,159,157,2
24,41,214102691,41269,Vendôme,16307,15680,627
24,41,214102717,41271,Vernou-en-Sologne,620,606,14
24,41,214102733,41273,Vievy-le-Rayé,465,457,8
24,41,214102741,41274,Villavard,126,126,0
24,41,214102758,41275,La Ville-aux-Clercs,1278,1253,25
24,41,214102766,41276,Villebarou,2571,2490,81
24,41,214102774,41277,Villebout,118,118,0
24,41,214102782,41278,Villechauve,265,258,7
24,41,214102790,41279,Villedieu-le-Château,396,390,6
24,41,214102808,41280,Villefranche-sur-Cher,2713,2647,66
24,41,214102816,41281,Villefrancoeur,431,422,9
24,41,214102824,41282,Villeherviers,439,428,11
24,41,214102832,41283,Villemardy,276,272,4
24,41,214102840,41284,Villeneuve-Frouville,66,64,2
24,41,214102857,41285,Villeny,491,487,4
24,41,214102865,41286,Villeporcher,154,149,5
24,41,214102873,41287,Villerable,511,498,13
24,41,214102881,41288,Villerbon,826,810,16
24,41,214102899,41289,Villermain,397,388,9
24,41,214102907,41290,Villeromain,234,234,0
24,41,214102915,41291,Villetrun,322,318,4
24,41,214102923,41292,Villexanton,201,200,1
24,41,214102931,41293,Villiersfaux,252,247,5
24,41,214102949,41294,Villiers-sur-Loir,1176,1117,59
24,41,214102956,41295,Vineuil,8286,8084,202
24,41,214102964,41296,Vouzon,1485,1453,32
24,41,214102972,41297,Yvoy-le-Marron,786,780,6
84,42,214200016,42001,Aboën,468,462,6
84,42,214200024,42002,Ailleux,180,178,2
84,42,214200032,42003,Ambierle,1944,1898,46
84,42,214200057,42005,Andrézieux-Bouthéon,10259,10108,151
84,42,214200065,42006,Apinac,406,397,9
84,42,214200073,42007,Arcinges,221,216,5
84,42,214200081,42008,Arcon,112,111,1
84,42,214200099,42009,Arthun,530,525,5
84,42,214200107,42010,Aveizieux,1702,1678,24
84,42,214200115,42011,Balbigny,2892,2837,55
84,42,214200123,42012,Bard,705,682,23
84,42,214200131,42013,Bellegarde-en-Forez,2036,1987,49
84,42,214200149,42014,Belleroche,322,314,8
84,42,214200156,42015,Belmont-de-la-Loire,1490,1467,23
84,42,214200164,42016,La Bénisson-Dieu,432,423,9
84,42,214200172,42017,Le Bessat,486,479,7
84,42,214200180,42018,Bessey,471,460,11
84,42,214200198,42019,Boën-sur-Lignon,3092,3025,67
84,42,214200206,42020,Boisset-lès-Montrond,1209,1185,24
84,42,214200214,42021,Boisset-Saint-Priest,1269,1259,10
84,42,214200222,42022,Bonson,4272,4215,57
84,42,214200230,42023,Bourg-Argental,3010,2950,60
84,42,214200255,42025,Boyer,201,197,4
84,42,214200263,42026,Briennon,1754,1719,35
84,42,214200271,42027,Bully,406,398,8
84,42,214200289,42028,Burdignes,393,384,9
84,42,214200297,42029,Bussières,1559,1512,47
84,42,214200305,42030,Bussy-Albieux,540,537,3
84,42,214200313,42031,Caloire,313,306,7
84,42,214200321,42032,Cellieu,1724,1701,23
84,42,214200339,42033,Le Cergne,649,624,25
84,42,214200347,42034,Cervières,112,105,7
84,42,214200354,42035,Cezay,218,209,9
84,42,214200362,42036,Chagnon,520,505,15
84,42,214200370,42037,Chalain-d'Uzore,634,610,24
84,42,214200388,42038,Chalain-le-Comtal,732,721,11
84,42,200055085,42039,Chalmazel-Jeansagnière,458,453,5
84,42,214200404,42040,La Chamba,48,46,2
84,42,214200412,42041,Chambéon,645,639,6
84,42,214200420,42042,Chambles,1074,1054,20
84,42,214200438,42043,Chamboeuf,1848,1812,36
84,42,214200446,42044,Le Chambon-Feugerolles,11944,11857,87
84,42,214200453,42045,La Chambonie,40,39,1
84,42,214200461,42046,Champdieu,2023,1978,45
84,42,214200479,42047,Champoly,326,324,2
84,42,214200487,42048,Chandon,1505,1475,30
84,42,214200495,42049,Changy,683,662,21
84,42,214200503,42050,La Chapelle-en-Lafaye,141,138,3
84,42,214200511,42051,La Chapelle-Villars,550,536,14
84,42,214200529,42052,Charlieu,3810,3714,96
84,42,214200537,42053,Châteauneuf,1670,1651,19
84,42,214200545,42054,Châtelneuf,362,355,7
84,42,214200552,42055,Châtelus,141,133,8
84,42,214200560,42056,Chavanay,2935,2885,50
84,42,214200586,42058,Chazelles-sur-Lavieu,261,254,7
84,42,214200594,42059,Chazelles-sur-Lyon,5530,5436,94
84,42,214200602,42060,Chenereilles,530,524,6
84,42,214200610,42061,Cherier,567,553,14
84,42,214200628,42062,Chevrières,1183,1158,25
84,42,214200636,42063,Chirassimont,408,399,9
84,42,214200644,42064,Chuyer,784,754,30
84,42,214200651,42065,Civens,1468,1415,53
84,42,214200669,42066,Cleppé,532,521,11
84,42,214200677,42067,Colombier,300,297,3
84,42,214200685,42068,Combre,430,419,11
84,42,214200693,42069,Commelle-Vernay,3106,3018,88
84,42,214200701,42070,Cordelle,949,925,24
84,42,214200719,42071,Le Coteau,7020,6886,134
84,42,214200727,42072,La Côte-en-Couzan,65,64,1
84,42,214200735,42073,Cottance,759,741,18
84,42,214200743,42074,Coutouvre,1102,1075,27
84,42,214200750,42075,Craintilleux,1370,1356,14
84,42,214200768,42076,Cremeaux,935,912,23
84,42,214200776,42077,Croizet-sur-Gand,310,304,6
84,42,214200784,42078,Le Crozet,258,248,10
84,42,214200792,42079,Cuinzier,722,709,13
84,42,214200818,42081,Cuzieu,1565,1547,18
84,42,214200834,42083,Dargoire,533,529,4
84,42,214200842,42084,Débats-Rivière-d'Orpra,164,160,4
84,42,214200859,42085,Doizieux,857,843,14
84,42,214200867,42086,Écoche,529,516,13
84,42,214200875,42087,Écotay-l'Olme,1283,1230,53
84,42,214200883,42088,Épercieux-Saint-Paul,772,755,17
84,42,214200891,42089,Essertines-en-Châtelneuf,680,652,28
84,42,214200909,42090,Essertines-en-Donzy,498,490,8
84,42,214200917,42091,Estivareilles,696,684,12
84,42,214200925,42092,L'Étrat,2812,2702,110
84,42,214200933,42093,Farnay,1384,1364,20
84,42,214200941,42094,Feurs,8488,8352,136
84,42,214200958,42095,Firminy,17126,16953,173
84,42,214200966,42096,Fontanès,694,683,11
84,42,214200974,42097,La Fouillouse,4755,4690,65
84,42,214200982,42098,Fourneaux,593,579,14
84,42,214200990,42099,Fraisses,3786,3732,54
84,42,214201006,42100,La Gimond,289,279,10
84,42,214201014,42101,Graix,143,141,2
84,42,214201022,42102,Grammond,904,882,22
84,42,214201030,42103,La Grand-Croix,5137,5100,37
84,42,214201048,42104,La Gresle,888,867,21
84,42,214201055,42105,Grézieux-le-Fromental,258,254,4
84,42,214201063,42106,Grézolles,250,243,7
84,42,214201071,42107,Gumières,329,320,9
84,42,214201089,42108,L'Hôpital-le-Grand,1126,1112,14
84,42,214201097,42109,L'Hôpital-sous-Rochefort,109,108,1
84,42,214201105,42110,L'Horme,4806,4766,40
84,42,214201121,42112,Jarnosse,422,414,8
84,42,214201139,42113,Jas,245,239,6
84,42,214201154,42115,Jonzieux,1241,1226,15
84,42,214201162,42116,Juré,255,246,9
84,42,214201170,42117,Lavieu,120,112,8
84,42,214201188,42118,Lay,772,754,18
84,42,214201196,42119,Leigneux,371,361,10
84,42,214201204,42120,Lentigny,1836,1798,38
84,42,214201212,42121,Lérigneux,165,163,2
84,42,214201220,42122,Lézigneux,1803,1725,78
84,42,214201238,42123,Lorette,4774,4746,28
84,42,214201246,42124,Lupé,305,299,6
84,42,214201253,42125,Luré,142,140,2
84,42,214201261,42126,Luriecq,1299,1271,28
84,42,214201279,42127,Mably,7650,7517,133
84,42,214201287,42128,Machézal,402,395,7
84,42,214201295,42129,Maclas,1895,1827,68
84,42,214201303,42130,Magneux-Haute-Rive,576,567,9
84,42,214201311,42131,Maizilly,338,330,8
84,42,214201329,42132,Malleval,578,562,16
84,42,214201337,42133,Marcenod,712,693,19
84,42,214201345,42134,Marcilly-le-Châtel,1433,1386,47
84,42,214201352,42135,Marclopt,571,543,28
84,42,214201360,42136,Marcoux,813,780,33
84,42,214201378,42137,Margerie-Chantagret,819,804,15
84,42,214201386,42138,Maringes,693,672,21
84,42,214201394,42139,Marlhes,1410,1340,70
84,42,214201402,42140,Marols,464,456,8
84,42,214201410,42141,Mars,582,571,11
84,42,214201428,42142,Merle-Leignec,328,322,6
84,42,214201436,42143,Mizérieux,508,503,5
84,42,214201451,42145,Montagny,1120,1100,20
84,42,214201469,42146,Montarcher,68,65,3
84,42,214201477,42147,Montbrison,16545,15943,602
84,42,214201485,42148,Montchal,510,501,9
84,42,214201493,42149,Montrond-les-Bains,5550,5444,106
84,42,214201501,42150,Montverdun,1392,1358,34
84,42,214201519,42151,Mornand-en-Forez,488,411,77
84,42,214201527,42152,Nandax,885,559,326
84,42,214201535,42153,Neaux,490,482,8
84,42,214201543,42154,Néronde,517,467,50
84,42,214201550,42155,Nervieux,1038,1015,23
84,42,214201568,42156,Neulise,1398,1379,19
84,42,214201576,42157,Noailly,807,794,13
84,42,214201584,42158,Les Noës,214,211,3
84,42,214201592,42159,Noirétable,1681,1577,104
84,42,214201600,42160,Nollieux,194,188,6
84,42,214201618,42161,Notre-Dame-de-Boisset,595,577,18
84,42,214201626,42162,Ouches,1170,1151,19
84,42,214201634,42163,La Pacaudière,1073,1054,19
84,42,214201642,42164,Palogneux,68,68,0
84,42,214201659,42165,Panissières,2964,2883,81
84,42,214201667,42166,Parigny,647,631,16
84,42,214201675,42167,Pavezin,398,388,10
84,42,214201683,42168,Pélussin,3829,3726,103
84,42,214201691,42169,Périgneux,1616,1589,27
84,42,214201709,42170,Perreux,2285,2106,179
84,42,214201717,42171,Pinay,291,284,7
84,42,214201725,42172,Planfoy,1087,1062,25
84,42,214201733,42173,Pommiers-en-Forez,367,358,9
84,42,214201741,42174,Poncins,1191,1168,23
84,42,214201758,42175,Pouilly-lès-Feurs,1241,1207,34
84,42,214201766,42176,Pouilly-les-Nonains,2236,2191,45
84,42,214201774,42177,Pouilly-sous-Charlieu,2615,2562,53
84,42,214201782,42178,Pradines,883,871,12
84,42,214201790,42179,Pralong,892,863,29
84,42,214201808,42180,Précieux,1132,1033,99
84,42,214201816,42181,Régny,1520,1490,30
84,42,214201824,42182,Renaison,3316,3209,107
84,42,214201832,42183,La Ricamarie,7990,7943,47
84,42,214201840,42184,Riorges,11161,10917,244
84,42,214201857,42185,Rivas,735,715,20
84,42,214201865,42186,Rive-de-Gier,15208,15086,122
84,42,214201873,42187,Roanne,35152,34415,737
84,42,214201881,42188,Roche,257,253,4
84,42,214201899,42189,Roche-la-Molière,9966,9878,88
84,42,214201915,42191,Roisey,1022,989,33
84,42,214201923,42192,Rozier-Côtes-d'Aurec,434,429,5
84,42,214201931,42193,Rozier-en-Donzy,1462,1425,37
84,42,214201949,42194,Sail-les-Bains,203,201,2
84,42,214201956,42195,Sail-sous-Couzan,1007,987,20
84,42,214201964,42196,Sainte-Agathe-en-Donzy,120,116,4
84,42,214201972,42197,Sainte-Agathe-la-Bouteresse,1075,1044,31
84,42,214201980,42198,Saint-Alban-les-Eaux,942,916,26
84,42,214201998,42199,Saint-André-d'Apchon,1980,1920,60
84,42,214202004,42200,Saint-André-le-Puy,1544,1518,26
84,42,214202012,42201,Saint-Appolinard,723,694,29
84,42,214202020,42202,Saint-Barthélemy-Lestra,703,687,16
84,42,214202038,42203,Saint-Bonnet-des-Quarts,314,313,1
84,42,214202046,42204,Saint-Bonnet-le-Château,1532,1497,35
84,42,214202053,42205,Saint-Bonnet-le-Courreau,704,689,15
84,42,214202061,42206,Saint-Bonnet-les-Oules,1754,1718,36
84,42,214202079,42207,Saint-Chamond,35697,35309,388
84,42,214202087,42208,Saint-Christo-en-Jarez,1954,1909,45
84,42,214202095,42209,Sainte-Colombe-sur-Gand,402,390,12
84,42,214202103,42210,Sainte-Croix-en-Jarez,484,477,7
84,42,214202111,42211,Saint-Cyprien,2462,2428,34
84,42,214202129,42212,Saint-Cyr-de-Favières,1024,994,30
84,42,214202137,42213,Saint-Cyr-de-Valorges,322,310,12
84,42,214202145,42214,Saint-Cyr-les-Vignes,1077,1048,29
84,42,214202152,42215,Saint-Denis-de-Cabanne,1288,1265,23
84,42,214202160,42216,Saint-Denis-sur-Coise,684,667,17
84,42,214202178,42217,Saint-Didier-sur-Rochefort,463,456,7
84,42,214202186,42218,Saint-Étienne,176016,174082,1934
84,42,214202194,42219,Saint-Étienne-le-Molard,1051,1028,23
84,42,214202202,42220,Saint-Forgeux-Lespinasse,625,606,19
84,42,214202210,42221,Sainte-Foy-Saint-Sulpice,540,531,9
84,42,214202228,42222,Saint-Galmier,5966,5837,129
84,42,214202236,42223,Saint-Genest-Lerpt,6252,6185,67
84,42,214202244,42224,Saint-Genest-Malifaux,3089,2945,144
84,42,214202251,42225,Genilac,3953,3866,87
84,42,214202269,42226,Saint-Georges-de-Baroille,441,438,3
84,42,214202277,42227,Saint-Georges-en-Couzan,415,408,7
84,42,214202285,42228,Saint-Georges-Haute-Ville,1491,1465,26
84,42,214202293,42229,Saint-Germain-la-Montagne,231,225,6
84,42,214202301,42230,Saint-Germain-Laval,1644,1610,34
84,42,214202319,42231,Saint-Germain-Lespinasse,1296,1226,70
84,42,214202327,42232,Saint-Haon-le-Châtel,647,636,11
84,42,214202335,42233,Saint-Haon-le-Vieux,978,954,24
84,42,214202343,42234,Saint-Héand,3713,3659,54
84,42,214202350,42235,Saint-Hilaire-Cusson-la-Valmitte,337,332,5
84,42,214202368,42236,Saint-Hilaire-sous-Charlieu,539,529,10
84,42,214202376,42237,Saint-Jean-Bonnefonds,6701,6633,68
84,42,214202384,42238,Saint-Jean-la-Vêtre,335,324,11
84,42,214202392,42239,Saint-Jean-Saint-Maurice-sur-Loire,1179,1155,24
84,42,214202400,42240,Saint-Jean-Soleymieux,878,858,20
84,42,214202418,42241,Saint-Jodard,396,391,5
84,42,214202426,42242,Saint-Joseph,1978,1949,29
84,42,214202434,42243,Saint-Julien-d'Oddes,293,288,5
84,42,200083855,42245,Vêtre-sur-Anzon,591,578,13
84,42,214202467,42246,Saint-Julien-Molin-Molette,1164,1146,18
84,42,214202475,42247,Saint-Just-en-Bas,291,282,9
84,42,214202483,42248,Saint-Just-en-Chevalet,1163,1125,38
84,42,214202491,42249,Saint-Just-la-Pendue,1693,1661,32
84,42,214202517,42251,Saint-Laurent-la-Conche,592,579,13
84,42,214202525,42252,Saint-Laurent-Rochefort,257,255,2
84,42,214202533,42253,Saint-Léger-sur-Roanne,1200,1161,39
84,42,214202541,42254,Saint-Marcel-de-Félines,809,792,17
84,42,214202558,42255,Saint-Marcel-d'Urfé,285,278,7
84,42,214202566,42256,Saint-Marcellin-en-Forez,5078,5027,51
84,42,214202574,42257,Saint-Martin-d'Estréaux,850,841,9
84,42,214202590,42259,Saint-Martin-la-Plaine,3859,3799,60
84,42,214202608,42260,Saint-Martin-la-Sauveté,945,887,58
84,42,214202616,42261,Saint-Martin-Lestra,926,907,19
84,42,214202624,42262,Saint-Maurice-en-Gourgois,1856,1819,37
84,42,214202640,42264,Saint-Médard-en-Forez,989,965,24
84,42,214202657,42265,Saint-Michel-sur-Rhône,894,869,25
84,42,214202665,42266,Saint-Nizier-de-Fornas,674,660,14
84,42,214202673,42267,Saint-Nizier-sous-Charlieu,1740,1695,45
84,42,200081347,42268,Vézelin-sur-Loire,818,803,15
84,42,214202699,42269,Saint-Paul-d'Uzore,183,181,2
84,42,214202707,42270,Saint-Paul-en-Cornillon,1385,1354,31
84,42,214202715,42271,Saint-Paul-en-Jarez,4851,4793,58
84,42,214202723,42272,Saint-Pierre-de-Boeuf,1735,1697,38
84,42,214202731,42273,Saint-Pierre-la-Noaille,395,388,7
84,42,214202749,42274,Saint-Polgues,268,263,5
84,42,214202756,42275,Saint-Priest-en-Jarez,6182,6088,94
84,42,214202764,42276,Saint-Priest-la-Prugne,430,424,6
84,42,214202772,42277,Saint-Priest-la-Roche,337,337,0
84,42,214202780,42278,Saint-Priest-la-Vêtre,143,142,1
84,42,214202798,42279,Saint-Just-Saint-Rambert,15488,15239,249
84,42,214202806,42280,Saint-Régis-du-Coin,422,411,11
84,42,214202814,42281,Saint-Rirand,134,132,2
84,42,214202822,42282,Saint-Romain-d'Urfé,244,239,5
84,42,214202830,42283,Saint-Romain-en-Jarez,1242,1214,28
84,42,214202848,42284,Saint-Romain-la-Motte,1474,1419,55
84,42,214202855,42285,Saint-Romain-le-Puy,4164,4099,65
84,42,214202863,42286,Saint-Romain-les-Atheux,963,948,15
84,42,214202871,42287,Saint-Sauveur-en-Rue,1109,1086,23
84,42,214202889,42288,Saint-Sixte,712,699,13
84,42,214202897,42289,Saint-Symphorien-de-Lay,1985,1923,62
84,42,214202905,42290,Saint-Thomas-la-Garde,610,591,19
84,42,214202939,42293,Saint-Victor-sur-Rhins,1228,1207,21
84,42,214202947,42294,Saint-Vincent-de-Boisset,1006,979,27
84,42,214202954,42295,Les Salles,568,561,7
84,42,214202962,42296,Salt-en-Donzy,567,552,15
84,42,214202970,42297,Salvizinet,628,598,30
84,42,214202988,42298,Sauvain,377,373,4
84,42,214202996,42299,Savigneux,3523,3448,75
84,42,214203002,42300,Sevelinges,661,646,15
84,42,214203010,42301,Soleymieux,716,707,9
84,42,214203028,42302,Sorbiers,8180,8009,171
84,42,214203036,42303,Souternon,271,265,6
84,42,214203044,42304,Sury-le-Comtal,6978,6706,272
84,42,214203051,42305,La Talaudière,7143,7044,99
84,42,214203069,42306,Tarentaise,504,492,12
84,42,214203077,42307,Tartaras,944,926,18
84,42,214203085,42308,La Terrasse-sur-Dorlay,780,772,8
84,42,214203101,42310,Thélis-la-Combe,146,144,2
84,42,214203119,42311,La Tour-en-Jarez,1500,1462,38
84,42,214203127,42312,La Tourette,640,623,17
84,42,214203135,42313,Trelins,687,667,20
84,42,214203143,42314,La Tuilière,287,285,2
84,42,214203150,42315,Unias,438,424,14
84,42,214203168,42316,Unieux,8525,8448,77
84,42,214203176,42317,Urbise,126,122,4
84,42,214203184,42318,Usson-en-Forez,1512,1490,22
84,42,214203192,42319,Valeille,701,690,11
84,42,214203200,42320,Valfleury,717,707,10
84,42,214203218,42321,La Valla-sur-Rochefort,103,102,1
84,42,214203226,42322,La Valla-en-Gier,1108,1082,26
84,42,214203234,42323,Veauche,9107,9001,106
84,42,214203242,42324,Veauchette,1209,1193,16
84,42,214203259,42325,Vendranges,386,382,4
84,42,214203267,42326,Véranne,927,898,29
84,42,214203275,42327,Vérin,677,663,14
84,42,214203283,42328,Verrières-en-Forez,793,719,74
84,42,214203291,42329,La Versanne,384,379,5
84,42,214203309,42330,Villars,7994,7861,133
84,42,214203317,42331,Villemontais,1055,1024,31
84,42,214203325,42332,Villerest,5233,5097,136
84,42,214203333,42333,Villers,604,591,13
84,42,214203341,42334,Violay,1252,1235,17
84,42,214203358,42335,Viricelles,463,445,18
84,42,214203366,42336,Virigneux,649,632,17
84,42,214203374,42337,Vivans,229,224,5
84,42,214203382,42338,Vougy,1560,1497,63
84,42,214203390,42339,Chausseterre,219,214,5
84,43,214300014,43001,Agnat,178,174,4
84,43,214300022,43002,Aiguilhe,1516,1454,62
84,43,214300030,43003,Allègre,891,873,18
84,43,214300048,43004,Alleyrac,126,119,7
84,43,214300055,43005,Alleyras,155,153,2
84,43,214300063,43006,Ally,130,128,2
84,43,214300071,43007,Araules,622,604,18
84,43,214300089,43008,Arlempdes,147,142,5
84,43,214300097,43009,Arlet,23,23,0
84,43,214300105,43010,Arsac-en-Velay,1230,1200,30
84,43,214300113,43011,Aubazat,185,180,5
84,43,214300121,43012,Aurec-sur-Loire,6249,6166,83
84,43,214300139,43013,Vissac-Auteyrac,312,303,9
84,43,214300147,43014,Autrac,55,53,2
84,43,214300154,43015,Auvers,49,49,0
84,43,214300162,43016,Auzon,930,905,25
84,43,214300170,43017,Azérat,294,287,7
84,43,214300188,43018,Bains,1515,1388,127
84,43,214300196,43019,Barges,112,110,2
84,43,214300204,43020,Bas-en-Basset,4530,4461,69
84,43,214300212,43021,Beaulieu,1062,1043,19
84,43,214300220,43022,Beaumont,282,270,12
84,43,214300238,43023,Beaune-sur-Arzon,209,207,2
84,43,214300246,43024,Beaux,863,849,14
84,43,214300253,43025,Beauzac,3055,2986,69
84,43,214300261,43026,Bellevue-la-Montagne,458,448,10
84,43,214300279,43027,Berbezit,44,44,0
84,43,214300287,43028,Bessamorel,496,480,16
84,43,214300295,43029,La Besseyre-Saint-Mary,103,99,4
84,43,214300303,43030,Blanzac,415,405,10
84,43,214300311,43031,Blassac,139,134,5
84,43,214300329,43032,Blavozy,1754,1703,51
84,43,214300337,43033,Blesle,645,634,11
84,43,214300345,43034,Boisset,359,358,1
84,43,214300352,43035,Bonneval,77,76,1
84,43,214300360,43036,Borne,413,406,7
84,43,214300378,43037,Le Bouchet-Saint-Nicolas,287,280,7
84,43,214300386,43038,Bournoncle-Saint-Pierre,1028,1002,26
84,43,214300394,43039,Le Brignon,624,610,14
84,43,214300402,43040,Brioude,6851,6537,314
84,43,214300410,43041,Brives-Charensac,4464,4238,226
84,43,214300428,43042,Cayres,719,700,19
84,43,214300436,43043,Céaux-d'Allègre,482,475,7
84,43,214300444,43044,Cerzat,212,207,5
84,43,214300451,43045,Ceyssac,446,431,15
84,43,214300469,43046,Chadrac,2499,2429,70
84,43,214300477,43047,Chadron,345,336,9
84,43,214300485,43048,La Chaise-Dieu,645,608,37
84,43,214300493,43049,Chamalières-sur-Loire,506,497,9
84,43,214300501,43050,Chambezon,126,126,0
84,43,214300519,43051,Le Chambon-sur-Lignon,2465,2420,45
84,43,214300527,43052,Champagnac-le-Vieux,195,190,5
84,43,214300535,43053,Champclause,208,205,3
84,43,214300543,43054,Chanaleilles,183,173,10
84,43,214300550,43055,Chaniat,166,162,4
84,43,214300568,43056,Chanteuges,432,419,13
84,43,214300576,43057,La Chapelle-Bertin,48,47,1
84,43,214300584,43058,La Chapelle-d'Aurec,1101,1072,29
84,43,214300592,43059,La Chapelle-Geneste,111,110,1
84,43,214300600,43060,Charraix,71,67,4
84,43,214300618,43061,Chaspinhac,890,868,22
84,43,214300626,43062,Chaspuzac,824,810,14
84,43,214300634,43063,Chassagnes,156,155,1
84,43,214300642,43064,Chassignolles,69,65,4
84,43,214300659,43065,Chastel,124,120,4
84,43,214300667,43066,Chaudeyrolles,125,121,4
84,43,214300675,43067,Chavaniac-Lafayette,273,266,7
84,43,214300683,43068,Chazelles,34,32,2
84,43,214300691,43069,Chenereilles,322,310,12
84,43,214300709,43070,Chilhac,170,167,3
84,43,214300717,43071,Chomelix,467,462,5
84,43,214300725,43072,La Chomette,157,153,4
84,43,214300733,43073,Cistrières,135,132,3
84,43,214300741,43074,Cohade,898,875,23
84,43,214300758,43075,Collat,76,72,4
84,43,214300766,43076,Connangles,134,132,2
84,43,214300774,43077,Costaros,552,543,9
84,43,214300782,43078,Coubon,3298,3216,82
84,43,214300790,43079,Couteuges,301,296,5
84,43,214300808,43080,Craponne-sur-Arzon,1988,1968,20
84,43,214300824,43082,Cronce,71,69,2
84,43,214300832,43083,Cubelles,153,149,4
84,43,214300840,43084,Cussac-sur-Loire,1707,1673,34
84,43,214300857,43085,Desges,59,55,4
84,43,214300865,43086,Domeyrat,179,171,8
84,43,214300873,43087,Dunières,2727,2665,62
84,43,214300881,43088,Espalem,340,331,9
84,43,214300899,43089,Espaly-Saint-Marcel,3648,3521,127
84,43,200059376,43090,Esplantas-Vazeilles,131,127,4
84,43,214300915,43091,Les Estables,336,319,17
84,43,214300923,43092,Fay-sur-Lignon,366,358,8
84,43,214300931,43093,Félines,324,317,7
84,43,214300949,43094,Ferrussac,82,80,2
84,43,214300956,43095,Fix-Saint-Geneys,142,139,3
84,43,214300964,43096,Fontannes,1108,886,222
84,43,214300972,43097,Freycenet-la-Cuche,107,105,2
84,43,214300980,43098,Freycenet-la-Tour,114,109,5
84,43,214300998,43099,Frugerès-les-Mines,558,552,6
84,43,214301004,43100,Frugières-le-Pin,183,181,2
84,43,214301012,43101,Goudet,62,56,6
84,43,214301020,43102,Grazac,1131,1114,17
84,43,214301038,43103,Grenier-Montgon,113,112,1
84,43,214301046,43104,Grèzes,197,193,4
84,43,214301053,43105,Javaugues,184,179,5
84,43,214301061,43106,Jax,149,145,4
84,43,214301079,43107,Josat,84,84,0
84,43,214301087,43108,Jullianges,445,437,8
84,43,214301095,43109,Lafarre,81,78,3
84,43,214301103,43110,Lamothe,852,838,14
84,43,214301111,43111,Landos,896,872,24
84,43,214301129,43112,Langeac,3528,3451,77
84,43,214301137,43113,Lantriac,1984,1929,55
84,43,214301145,43114,Lapte,1774,1736,38
84,43,214301152,43115,Laussonne,1033,1015,18
84,43,214301160,43116,Laval-sur-Doulon,65,63,2
84,43,214301178,43117,Lavaudieu,256,250,6
84,43,214301186,43118,Lavoûte-Chilhac,272,266,6
84,43,214301194,43119,Lavoûte-sur-Loire,847,829,18
84,43,214301202,43120,Lempdes-sur-Allagnon,1343,1317,26
84,43,214301210,43121,Léotoing,220,215,5
84,43,214301228,43122,Lissac,300,292,8
84,43,214301236,43123,Lorlanges,418,403,15
84,43,214301244,43124,Loudes,955,938,17
84,43,214301251,43125,Lubilhac,90,88,2
84,43,214301269,43126,Malrevers,777,762,15
84,43,214301277,43127,Malvalette,876,858,18
84,43,214301285,43128,Malvières,139,137,2
84,43,214301293,43129,Le Mas-de-Tence,159,152,7
84,43,214301301,43130,Mazet-Saint-Voy,1140,1111,29
84,43,214301319,43131,Mazerat-Aurouze,198,196,2
84,43,214301327,43132,Mazeyrat-d'Allier,1484,1441,43
84,43,214301335,43133,Mercoeur,145,142,3
84,43,214301343,43134,Mézères,150,146,4
84,43,214301350,43135,Le Monastier-sur-Gazeille,1786,1754,32
84,43,214301368,43136,Monistrol-d'Allier,214,213,1
84,43,214301376,43137,Monistrol-sur-Loire,9393,8962,431
84,43,214301384,43138,Monlet,426,414,12
84,43,214301392,43139,Montclard,54,54,0
84,43,214301400,43140,Le Monteil,699,682,17
84,43,214301418,43141,Montfaucon-en-Velay,1175,1152,23
84,43,214301426,43142,Montregard,590,581,9
84,43,214301434,43143,Montusclat,126,126,0
84,43,214301442,43144,Moudeyres,103,100,3
84,43,214301459,43145,Ouides,54,54,0
84,43,214301475,43147,Paulhac,664,640,24
84,43,214301483,43148,Paulhaguet,877,864,13
84,43,214301491,43149,Pébrac,121,117,4
84,43,214301509,43150,Le Pertuis,486,474,12
84,43,214301517,43151,Pinols,194,189,5
84,43,214301525,43152,Polignac,2905,2818,87
84,43,214301533,43153,Pont-Salomon,1925,1889,36
84,43,214301541,43154,Pradelles,559,545,14
84,43,214301558,43155,Prades,62,61,1
84,43,214301566,43156,Présailles,120,114,6
84,43,214301574,43157,Le Puy-en-Velay,19784,18947,837
84,43,214301582,43158,Queyrières,359,347,12
84,43,214301590,43159,Raucoules,965,941,24
84,43,214301608,43160,Rauret,198,196,2
84,43,214301624,43162,Retournac,3043,2986,57
84,43,214301632,43163,Riotord,1199,1182,17
84,43,214301640,43164,Roche-en-Régnier,483,479,4
84,43,214301657,43165,Rosières,1557,1528,29
84,43,214301665,43166,Saint-André-de-Chalencon,396,380,16
84,43,214301673,43167,Saint-Arcons-d'Allier,200,196,4
84,43,214301681,43168,Saint-Arcons-de-Barges,119,116,3
84,43,214301699,43169,Saint-Austremoine,51,51,0
84,43,214301707,43170,Saint-Beauzire,459,453,6
84,43,214301715,43171,Saint-Bérain,85,81,4
84,43,214301723,43172,Saint-Bonnet-le-Froid,218,215,3
84,43,214301731,43173,Saint-Christophe-d'Allier,94,92,2
84,43,214301749,43174,Saint-Christophe-sur-Dolaison,961,948,13
84,43,214301756,43175,Saint-Cirgues,172,165,7
84,43,214301772,43177,Saint-Didier-en-Velay,3512,3459,53
84,43,214301780,43178,Saint-Didier-sur-Doulon,202,194,8
84,43,214301806,43180,Saint-Étienne-du-Vigan,101,96,5
84,43,214301814,43181,Saint-Étienne-Lardeyrol,772,752,20
84,43,214301822,43182,Saint-Étienne-sur-Blesle,55,53,2
84,43,214301830,43183,Sainte-Eugénie-de-Villeneuve,117,115,2
84,43,214301848,43184,Saint-Ferréol-d'Auroure,2505,2468,37
84,43,214301855,43185,Sainte-Florine,3303,3226,77
84,43,214301863,43186,Saint-Front,411,406,5
84,43,214301871,43187,Saint-Geneys-près-Saint-Paulien,325,321,4
84,43,214301889,43188,Saint-Georges-d'Aurac,483,476,7
84,43,214301897,43189,Saint-Georges-Lagricol,535,520,15
84,43,214301905,43190,Saint-Germain-Laprade,3701,3597,104
84,43,214301913,43191,Saint-Géron,250,245,5
84,43,214301921,43192,Saint-Haon,291,281,10
84,43,214301939,43193,Saint-Hilaire,163,161,2
84,43,214301947,43194,Saint-Hostien,719,697,22
84,43,214301954,43195,Saint-Ilpize,190,185,5
84,43,214301962,43196,Saint-Jean-d'Aubrigoux,179,177,2
84,43,214301970,43197,Saint-Jean-de-Nay,353,346,7
84,43,214301988,43198,Saint-Jean-Lachalm,307,298,9
84,43,214301996,43199,Saint-Jeures,992,967,25
84,43,214302002,43200,Saint-Julien-Chapteuil,2055,2010,45
84,43,214302010,43201,Saint-Julien-d'Ance,253,246,7
84,43,214302028,43202,Saint-Julien-des-Chazes,68,65,3
84,43,214302036,43203,Saint-Julien-du-Pinet,503,490,13
84,43,214302044,43204,Saint-Julien-Molhesabate,172,171,1
84,43,214302051,43205,Saint-Just-Malmont,4301,4240,61
84,43,214302069,43206,Saint-Just-près-Brioude,420,404,16
84,43,214302077,43207,Saint-Laurent-Chabreuges,259,248,11
84,43,214302085,43208,Sainte-Marguerite,43,41,2
84,43,214302101,43210,Saint-Martin-de-Fugères,243,236,7
84,43,214302119,43211,Saint-Maurice-de-Lignon,2693,2623,70
84,43,214302127,43212,Saint-Pal-de-Chalencon,1021,1004,17
84,43,214302135,43213,Saint-Pal-de-Mons,2353,2300,53
84,43,214302143,43214,Saint-Pal-de-Senouire,115,110,5
84,43,214302150,43215,Saint-Paul-de-Tartas,188,184,4
84,43,214302168,43216,Saint-Paulien,2486,2428,58
84,43,214302176,43217,Saint-Pierre-du-Champ,555,544,11
84,43,214302184,43218,Saint-Pierre-Eynac,1225,1196,29
84,43,214302192,43219,Saint-Préjet-Armandon,119,114,5
84,43,214302200,43220,Saint-Préjet-d'Allier,178,174,4
84,43,200065944,43221,Saint-Privat-d'Allier,403,397,6
84,43,214302226,43222,Saint-Privat-du-Dragon,167,165,2
84,43,214302234,43223,Saint-Romain-Lachalm,1134,1111,23
84,43,214302242,43224,Sainte-Sigolène,6120,6023,97
84,43,214302259,43225,Saint-Vénérand,51,51,0
84,43,214302267,43226,Saint-Vert,109,105,4
84,43,214302275,43227,Saint-Victor-Malescours,834,816,18
84,43,214302283,43228,Saint-Victor-sur-Arlanc,93,90,3
84,43,214302291,43229,Saint-Vidal,622,610,12
84,43,214302309,43230,Saint-Vincent,1058,1040,18
84,43,214302317,43231,Salettes,147,142,5
84,43,214302325,43232,Salzuit,359,347,12
84,43,214302333,43233,Sanssac-l'Église,1124,1084,40
84,43,214302341,43234,Saugues,1820,1694,126
84,43,214302366,43236,La Séauve-sur-Semène,1505,1485,20
84,43,214302374,43237,Sembadel,231,227,4
84,43,214302382,43238,Séneujols,307,300,7
84,43,214302390,43239,Siaugues-Sainte-Marie,819,804,15
84,43,214302408,43240,Solignac-sous-Roche,271,266,5
84,43,214302416,43241,Solignac-sur-Loire,1307,1274,33
84,43,214302424,43242,Tailhac,74,72,2
84,43,214302440,43244,Tence,3175,3099,76
84,43,200059327,43245,Thoras,226,218,8
84,43,214302465,43246,Tiranges,475,457,18
84,43,214302473,43247,Torsiac,69,68,1
84,43,214302499,43249,Valprivas,539,527,12
84,43,214302507,43250,Vals-le-Chastel,46,42,4
84,43,214302515,43251,Vals-près-le-Puy,3543,3421,122
84,43,214302523,43252,Varennes-Saint-Honorat,27,25,2
84,43,214302531,43253,Les Vastres,202,193,9
84,43,214302549,43254,Vazeilles-Limandre,270,266,4
84,43,214302564,43256,Venteuges,346,341,5
84,43,214302572,43257,Vergezac,510,501,9
84,43,214302580,43258,Vergongheon,1861,1810,51
84,43,214302598,43259,Vernassal,374,362,12
84,43,214302606,43260,Le Vernet,22,22,0
84,43,214302614,43261,Vézézoux,633,622,11
84,43,214302622,43262,Vieille-Brioude,1223,1193,30
84,43,214302630,43263,Vielprat,68,68,0
84,43,214302648,43264,Villeneuve-d'Allier,301,285,16
84,43,214302655,43265,Les Villettes,1499,1452,47
84,43,214302671,43267,Vorey,1461,1450,11
84,43,214302689,43268,Yssingeaux,7743,7320,423
52,44,214400012,44001,Abbaretz,2096,2056,40
52,44,214400020,44002,Aigrefeuille-sur-Maine,4199,4057,142
52,44,200083228,44003,Ancenis-Saint-Géréon,11479,11081,398
52,44,200058121,44005,Chaumes-en-Retz,7158,7049,109
52,44,214400061,44006,Assérac,1918,1875,43
52,44,214400079,44007,Avessac,2500,2444,56
52,44,214400095,44009,Basse-Goulaine,9659,9410,249
52,44,214400103,44010,Batz-sur-Mer,2894,2822,72
52,44,214400129,44012,La Bernerie-en-Retz,3246,3206,40
52,44,214400137,44013,Besné,3290,3249,41
52,44,214400145,44014,Le Bignon,3999,3927,72
52,44,214400152,44015,Blain,10261,10086,175
52,44,214400160,44016,La Boissière-du-Doré,1089,1071,18
52,44,214400186,44018,Bouaye,8241,8102,139
52,44,214400194,44019,Bouée,1055,1044,11
52,44,214400202,44020,Bouguenais,20748,20450,298
52,44,200054229,44021,Villeneuve-en-Retz,5100,5013,87
52,44,214400228,44022,Boussay,2772,2722,50
52,44,214400236,44023,Bouvron,3126,3081,45
52,44,214400244,44024,Brains,2921,2862,59
52,44,214400251,44025,Campbon,4016,3949,67
52,44,214400269,44026,Carquefou,20963,20463,500
52,44,214400277,44027,Casson,2521,2480,41
52,44,214400285,44028,Le Cellier,4090,3984,106
52,44,200054815,44029,Divatte-sur-Loire,7162,7042,120
52,44,214400301,44030,La Chapelle-des-Marais,4432,4339,93
52,44,214400319,44031,La Chapelle-Glain,820,804,16
52,44,214400327,44032,La Chapelle-Heulin,3464,3414,50
52,44,214400335,44033,La Chapelle-Launay,3237,3194,43
52,44,214400350,44035,La Chapelle-sur-Erdre,20420,19981,439
52,44,214400368,44036,Châteaubriant,12474,12016,458
52,44,214400376,44037,Château-Thébaud,3343,3157,186
52,44,214400384,44038,Chauvé,3012,2965,47
52,44,214400392,44039,Cheix-en-Retz,1160,1152,8
52,44,214400418,44041,La Chevrolière,6041,5951,90
52,44,214400434,44043,Clisson,7752,7507,245
52,44,214400442,44044,Conquereuil,1111,1084,27
52,44,214400459,44045,Cordemais,3846,3800,46
52,44,214400467,44046,Corsept,2712,2658,54
52,44,214400475,44047,Couëron,22971,22680,291
52,44,214400483,44048,Couffé,2592,2541,51
52,44,214400491,44049,Le Croisic,4170,4114,56
52,44,214400509,44050,Crossac,3030,3003,27
52,44,214400517,44051,Derval,3939,3511,428
52,44,214400525,44052,Donges,8191,8109,82
52,44,214400533,44053,Drefféac,2325,2288,37
52,44,214400541,44054,Erbray,3116,3045,71
52,44,214400558,44055,La Baule-Escoublac,16706,16160,546
52,44,214400566,44056,Fay-de-Bretagne,3766,3705,61
52,44,214400574,44057,Fégréac,2362,2302,60
52,44,214400582,44058,Fercé,483,472,11
52,44,214400616,44061,Frossay,3283,3228,55
52,44,214400624,44062,Le Gâvre,1874,1842,32
52,44,214400632,44063,Gétigné,3834,3746,88
52,44,214400640,44064,Gorges,5307,4950,357
52,44,214400657,44065,Grand-Auverné,790,769,21
52,44,214400665,44066,Grandchamp-des-Fontaines,6723,6606,117
52,44,214400673,44067,Guémené-Penfao,5322,5239,83
52,44,214400681,44068,Guenrouet,3433,3378,55
52,44,214400699,44069,Guérande,16612,16042,570
52,44,214400707,44070,La Haie-Fouassière,4807,4694,113
52,44,214400715,44071,Haute-Goulaine,6110,5954,156
52,44,214400723,44072,Herbignac,7203,7088,115
52,44,214400731,44073,Héric,6523,6407,116
52,44,214400749,44074,Indre,4138,4087,51
52,44,214400756,44075,Issé,1843,1804,39
52,44,214400764,44076,Jans,1427,1408,19
52,44,214400772,44077,Joué-sur-Erdre,2660,2632,28
52,44,214400780,44078,Juigné-des-Moutiers,333,330,3
52,44,214400798,44079,Le Landreau,3415,3118,297
52,44,214400806,44080,Lavau-sur-Loire,789,771,18
52,44,214400814,44081,Legé,4742,4633,109
52,44,214400822,44082,Ligné,5480,5371,109
52,44,214400830,44083,La Limouzinière,2516,2487,29
52,44,214400848,44084,Le Loroux-Bottereau,8654,8517,137
52,44,214400855,44085,Louisfert,997,965,32
52,44,214400863,44086,Lusanger,1078,1056,22
52,44,200056455,44087,Machecoul-Saint-Même,7859,7626,233
52,44,214400889,44088,Maisdon-sur-Sèvre,3066,3023,43
52,44,214400897,44089,Malville,3621,3564,57
52,44,214400905,44090,La Marne,1628,1606,22
52,44,214400913,44091,Marsac-sur-Don,1555,1524,31
52,44,214400921,44092,Massérac,694,684,10
52,44,214400947,44094,Mauves-sur-Loire,3324,3259,65
52,44,214400954,44095,La Meilleraye-de-Bretagne,1573,1548,25
52,44,214400962,44096,Mésanger,4823,4726,97
52,44,214400970,44097,Mesquer,2134,2088,46
52,44,214400988,44098,Missillac,5502,5432,70
52,44,214400996,44099,Moisdon-la-Rivière,2027,1967,60
52,44,214401002,44100,Monnières,2377,2316,61
52,44,214401010,44101,La Montagne,6515,6372,143
52,44,214401028,44102,Montbert,3292,3238,54
52,44,214401036,44103,Montoir-de-Bretagne,7311,7216,95
52,44,214401044,44104,Montrelais,844,833,11
52,44,214401051,44105,Mouais,372,365,7
52,44,214401069,44106,Les Moutiers-en-Retz,1827,1805,22
52,44,214401077,44107,Mouzeil,1977,1942,35
52,44,214401085,44108,Mouzillon,2928,2874,54
52,44,214401093,44109,Nantes,325857,320732,5125
52,44,214401101,44110,Nort-sur-Erdre,9396,9198,198
52,44,214401119,44111,Notre-Dame-des-Landes,2325,2285,40
52,44,214401127,44112,Noyal-sur-Brutz,597,586,11
52,44,214401135,44113,Nozay,4305,4216,89
52,44,214401143,44114,Orvault,28136,27438,698
52,44,214401150,44115,Oudon,4003,3936,67
52,44,214401168,44116,Paimboeuf,3119,3008,111
52,44,214401176,44117,Le Pallet,3353,3305,48
52,44,214401184,44118,Pannecé,1450,1424,26
52,44,214401192,44119,Paulx,2036,2004,32
52,44,214401200,44120,Le Pellerin,5469,5251,218
52,44,214401218,44121,Petit-Auverné,430,427,3
52,44,214401226,44122,Petit-Mars,3873,3818,55
52,44,214401234,44123,Pierric,1011,997,14
52,44,214401242,44124,Le Pin,766,751,15
52,44,214401259,44125,Piriac-sur-Mer,2418,2368,50
52,44,214401267,44126,La Plaine-sur-Mer,4535,4448,87
52,44,214401275,44127,La Planche,2815,2780,35
52,44,214401283,44128,Plessé,5370,5265,105
52,44,214401291,44129,Pontchâteau,11306,11030,276
52,44,214401309,44130,Pont-Saint-Martin,6775,6690,85
52,44,214401317,44131,Pornic,17340,16886,454
52,44,214401325,44132,Pornichet,12159,11828,331
52,44,214401333,44133,Port-Saint-Père,3035,2981,54
52,44,214401341,44134,Pouillé-les-Côteaux,1107,1085,22
52,44,214401358,44135,Le Pouliguen,4116,4024,92
52,44,214401366,44136,Préfailles,1254,1226,28
52,44,214401374,44137,Prinquiau,3540,3476,64
52,44,214401382,44138,Puceul,1167,1148,19
52,44,214401390,44139,Quilly,1456,1435,21
52,44,214401408,44140,La Regrippière,1546,1520,26
52,44,214401416,44141,La Remaudière,1299,1286,13
52,44,214401424,44142,Remouillé,1986,1949,37
52,44,214401432,44143,Rezé,43756,42993,763
52,44,214401440,44144,Riaillé,2416,2358,58
52,44,214401457,44145,Rouans,3181,3134,47
52,44,214401465,44146,Rougé,2196,2156,40
52,44,214401481,44148,Ruffigné,713,705,8
52,44,214401499,44149,Saffré,4037,3989,48
52,44,214401507,44150,Saint-Aignan-Grandlieu,4034,3973,61
52,44,214401515,44151,Saint-André-des-Eaux,6987,6813,174
52,44,214401523,44152,Sainte-Anne-sur-Brivet,3017,2964,53
52,44,214401531,44153,Saint-Aubin-des-Châteaux,1791,1741,50
52,44,214401549,44154,Saint-Brevin-les-Pins,14809,14473,336
52,44,214401556,44155,Saint-Colomban,3503,3428,75
52,44,214401564,44156,Corcoué-sur-Logne,3113,3074,39
52,44,214401572,44157,Saint-Étienne-de-Mer-Morte,1745,1724,21
52,44,214401580,44158,Saint-Étienne-de-Montluc,7758,7578,180
52,44,214401598,44159,Saint-Fiacre-sur-Maine,1260,1236,24
52,44,214401614,44161,Saint-Gildas-des-Bois,3830,3761,69
52,44,214401622,44162,Saint-Herblain,49801,49067,734
52,44,200055820,44163,Vair-sur-Loire,4913,4807,106
52,44,214401648,44164,Saint-Hilaire-de-Chaléons,2382,2336,46
52,44,214401655,44165,Saint-Hilaire-de-Clisson,2372,2325,47
52,44,214401663,44166,Saint-Jean-de-Boiseau,6085,5970,115
52,44,214401689,44168,Saint-Joachim,4172,4109,63
52,44,214401697,44169,Saint-Julien-de-Concelles,7614,7505,109
52,44,214401705,44170,Saint-Julien-de-Vouvantes,979,959,20
52,44,214401713,44171,Saint-Léger-les-Vignes,2032,1999,33
52,44,214401721,44172,Sainte-Luce-sur-Loire,15680,15417,263
52,44,214401739,44173,Saint-Lumine-de-Clisson,2185,2140,45
52,44,214401747,44174,Saint-Lumine-de-Coutais,2317,2278,39
52,44,214401754,44175,Saint-Lyphard,5057,4962,95
52,44,214401762,44176,Saint-Malo-de-Guersac,3259,3206,53
52,44,214401788,44178,Saint-Mars-de-Coutais,2644,2600,44
52,44,214401796,44179,Saint-Mars-du-Désert,5320,5236,84
52,44,200078079,44180,Vallons-de-l'Erdre,6607,6485,122
52,44,214401820,44182,Saint-Michel-Chef-Chef,5385,5297,88
52,44,214401838,44183,Saint-Molf,2867,2805,62
52,44,214401846,44184,Saint-Nazaire,73643,71887,1756
52,44,214401853,44185,Saint-Nicolas-de-Redon,3346,3280,66
52,44,214401861,44186,Sainte-Pazanne,7246,7111,135
52,44,214401879,44187,Saint-Père-en-Retz,4742,4594,148
52,44,214401887,44188,Saint-Philbert-de-Grand-Lieu,9409,9213,196
52,44,214401895,44189,Sainte-Reine-de-Bretagne,2442,2408,34
52,44,214401903,44190,Saint-Sébastien-sur-Loire,28639,27958,681
52,44,214401929,44192,Saint-Viaud,2775,2730,45
52,44,214401937,44193,Saint-Vincent-des-Landes,1553,1531,22
52,44,214401945,44194,Sautron,8639,8473,166
52,44,214401952,44195,Savenay,9476,9283,193
52,44,214401960,44196,Sévérac,1677,1653,24
52,44,214401978,44197,Sion-les-Mines,1685,1651,34
52,44,214401986,44198,Les Sorinières,9010,8900,110
52,44,214401994,44199,Soudan,2048,1996,52
52,44,214402000,44200,Soulvache,346,339,7
52,44,214402018,44201,Sucé-sur-Erdre,7528,7325,203
52,44,214402026,44202,Teillé,1834,1808,26
52,44,214402034,44203,Le Temple-de-Bretagne,2051,2032,19
52,44,214402042,44204,Thouaré-sur-Loire,10884,10704,180
52,44,214402059,44205,Les Touches,2573,2535,38
52,44,214402067,44206,Touvois,1919,1890,29
52,44,214402075,44207,Trans-sur-Erdre,1112,1102,10
52,44,214402083,44208,Treffieux,950,941,9
52,44,214402091,44209,Treillières,10308,10054,254
52,44,214402109,44210,Trignac,8181,8101,80
52,44,214402117,44211,La Turballe,4982,4889,93
52,44,214402125,44212,Vallet,9631,9412,219
52,44,200059020,44213,Loireauxence,7658,7533,125
52,44,214402141,44214,Vay,2079,2051,28
52,44,214402158,44215,Vertou,26449,25879,570
52,44,214402166,44216,Vieillevigne,4114,4040,74
52,44,214402174,44217,Vigneux-de-Bretagne,6421,6328,93
52,44,214402182,44218,Villepot,699,684,15
52,44,214402208,44220,Vue,1653,1632,21
52,44,214402216,44221,La Chevallerais,1555,1536,19
52,44,214402224,44222,La Roche-Blanche,1261,1241,20
52,44,214402232,44223,Geneston,3736,3688,48
52,44,214402240,44224,La Grigonnais,1769,1748,21
24,45,214500019,45001,Adon,202,197,5
24,45,214500027,45002,Aillant-sur-Milleron,381,376,5
24,45,214500043,45004,Amilly,13858,13279,579
24,45,214500050,45005,Andonville,268,262,6
24,45,214500068,45006,Ardon,1157,1128,29
24,45,214500084,45008,Artenay,1998,1969,29
24,45,214500092,45009,Aschères-le-Marché,1173,1143,30
24,45,214500100,45010,Ascoux,1113,1075,38
24,45,214500118,45011,Attray,211,208,3
24,45,214500126,45012,Audeville,184,181,3
24,45,214500134,45013,Augerville-la-Rivière,233,225,8
24,45,214500142,45014,Aulnay-la-Rivière,510,499,11
24,45,214500159,45015,Autruy-sur-Juine,723,710,13
24,45,214500167,45016,Autry-le-Châtel,952,931,21
24,45,214500175,45017,Auvilliers-en-Gâtinais,342,339,3
24,45,214500183,45018,Auxy,983,965,18
24,45,214500191,45019,Baccon,682,651,31
24,45,214500209,45020,Le Bardon,997,979,18
24,45,214500217,45021,Barville-en-Gâtinais,315,309,6
24,45,214500225,45022,Batilly-en-Gâtinais,450,444,6
24,45,214500233,45023,Batilly-en-Puisaye,113,111,2
24,45,214500241,45024,Baule,2092,2045,47
24,45,214500258,45025,Bazoches-les-Gallerandes,1548,1526,22
24,45,214500266,45026,Bazoches-sur-le-Betz,995,980,15
24,45,214500274,45027,Beauchamps-sur-Huillard,398,390,8
24,45,214500282,45028,Beaugency,7571,7384,187
24,45,214500290,45029,Beaulieu-sur-Loire,1802,1779,23
24,45,214500308,45030,Beaune-la-Rolande,2134,2006,128
24,45,214500316,45031,Bellegarde,1534,1446,88
24,45,214500324,45032,Le Bignon-Mirabeau,324,316,8
24,45,214500332,45033,Boësses,388,368,20
24,45,214500340,45034,Boigny-sur-Bionne,2154,2105,49
24,45,214500357,45035,Boiscommun,1149,1125,24
24,45,214500365,45036,Boismorand,877,848,29
24,45,214500373,45037,Boisseaux,518,508,10
24,45,214500381,45038,Bondaroy,429,416,13
24,45,214500399,45039,Bonnée,725,706,19
24,45,214500407,45040,Bonny-sur-Loire,1885,1861,24
24,45,214500415,45041,Bordeaux-en-Gâtinais,111,108,3
24,45,214500423,45042,Les Bordes,1935,1895,40
24,45,214500431,45043,Bou,1037,1013,24
24,45,214500449,45044,Bougy-lez-Neuville,169,162,7
24,45,214500456,45045,Bouilly-en-Gâtinais,323,311,12
24,45,214500464,45046,Boulay-les-Barres,1074,1057,17
24,45,214500472,45047,Bouzonville-aux-Bois,427,414,13
24,45,214500498,45049,Bouzy-la-Forêt,1247,1216,31
24,45,214500506,45050,Boynes,1364,1326,38
24,45,200063683,45051,Bray-Saint-Aignan,1774,1740,34
24,45,214500522,45052,Breteau,99,99,0
24,45,214500530,45053,Briare,5307,5212,95
24,45,214500548,45054,Briarres-sur-Essonne,548,540,8
24,45,214500555,45055,Bricy,566,556,10
24,45,214500563,45056,Bromeilles,324,319,5
24,45,214500589,45058,Bucy-le-Roi,185,178,7
24,45,214500597,45059,Bucy-Saint-Liphard,192,191,1
24,45,214500605,45060,La Bussière,798,779,19
24,45,214500613,45061,Cepoy,2458,2400,58
24,45,214500621,45062,Cercottes,1525,1501,24
24,45,214500639,45063,Cerdon,942,924,18
24,45,214500647,45064,Cernoy-en-Berry,448,442,6
24,45,214500654,45065,Césarville-Dossainville,227,224,3
24,45,214500662,45066,Chailly-en-Gâtinais,687,677,10
24,45,214500670,45067,Chaingy,4096,3987,109
24,45,214500688,45068,Châlette-sur-Loing,12979,12743,236
24,45,214500696,45069,Chambon-la-Forêt,977,954,23
24,45,214500704,45070,Champoulet,58,58,0
24,45,214500720,45072,Chanteau,1677,1652,25
24,45,214500738,45073,Chantecoq,500,494,6
24,45,214500746,45074,La Chapelle-Onzerain,113,111,2
24,45,214500753,45075,La Chapelle-Saint-Mesmin,10306,10095,211
24,45,214500761,45076,La Chapelle-Saint-Sépulcre,235,228,7
24,45,214500779,45077,La Chapelle-sur-Aveyron,628,622,6
24,45,214500787,45078,Chapelon,254,252,2
24,45,214500795,45079,Le Charme,157,157,0
24,45,214500803,45080,Charmont-en-Beauce,355,341,14
24,45,214500811,45081,Charsonville,628,612,16
24,45,214500829,45082,Châteauneuf-sur-Loire,8502,8382,120
24,45,214500837,45083,Château-Renard,2139,2106,33
24,45,214500845,45084,Châtenoy,445,436,9
24,45,214500852,45085,Châtillon-Coligny,1894,1869,25
24,45,214500860,45086,Châtillon-le-Roi,281,277,4
24,45,214500878,45087,Châtillon-sur-Loire,3174,3122,52
24,45,214500886,45088,Chaussy,297,287,10
24,45,214500894,45089,Chécy,8875,8699,176
24,45,214500910,45091,Chevannes,330,317,13
24,45,214500928,45092,Chevillon-sur-Huillard,1501,1465,36
24,45,214500936,45093,Chevilly,2671,2634,37
24,45,214500944,45094,Chevry-sous-le-Bignon,227,225,2
24,45,214500951,45095,Chilleurs-aux-Bois,2139,2096,43
24,45,214500969,45096,Les Choux,536,529,7
24,45,214500977,45097,Chuelles,1230,1217,13
24,45,214500985,45098,Cléry-Saint-André,3535,3466,69
24,45,214500993,45099,Coinces,515,506,9
24,45,214501009,45100,Combleux,520,500,20
24,45,214501017,45101,Combreux,280,274,6
24,45,214501025,45102,Conflans-sur-Loing,365,355,10
24,45,214501033,45103,Corbeilles,1574,1556,18
24,45,214501041,45104,Corquilleroy,2882,2822,60
24,45,214501058,45105,Cortrat,79,77,2
24,45,214501074,45107,Coudroy,315,315,0
24,45,214501082,45108,Coullons,2327,2293,34
24,45,214501090,45109,Coulmiers,555,544,11
24,45,214501108,45110,Courcelles-le-Roi,321,313,8
24,45,214501116,45111,Courcy-aux-Loges,456,452,4
24,45,214501124,45112,La Cour-Marigny,353,342,11
24,45,214501132,45113,Courtemaux,267,262,5
24,45,214501140,45114,Courtempierre,240,229,11
24,45,214501157,45115,Courtenay,3914,3848,66
24,45,214501165,45116,Cravant,971,945,26
24,45,214501181,45118,Crottes-en-Pithiverais,335,331,4
24,45,214501199,45119,Dadonville,2457,2404,53
24,45,214501207,45120,Dammarie-en-Puisaye,173,171,2
24,45,214501215,45121,Dammarie-sur-Loing,481,472,9
24,45,214501223,45122,Dampierre-en-Burly,1461,1424,37
24,45,214501231,45123,Darvoy,1909,1875,34
24,45,214501249,45124,Desmonts,178,175,3
24,45,214501256,45125,Dimancheville,113,111,2
24,45,214501264,45126,Donnery,2917,2854,63
24,45,214501272,45127,Dordives,3308,3272,36
24,45,200056794,45129,Douchy-Montcorbon,1373,1346,27
24,45,214501306,45130,Dry,1434,1407,27
24,45,214501314,45131,Échilleuses,397,386,11
24,45,214501322,45132,Égry,358,354,4
24,45,214501330,45133,Engenville,580,563,17
24,45,214501348,45134,Épieds-en-Beauce,1448,1419,29
24,45,214501355,45135,Erceville,315,305,10
24,45,214501363,45136,Ervauville,553,545,8
24,45,214501371,45137,Escrennes,743,726,17
24,45,214501389,45138,Escrignelles,51,51,0
24,45,214501397,45139,Estouy,511,494,17
24,45,214501413,45141,Faverelles,157,156,1
24,45,214501421,45142,Fay-aux-Loges,3860,3792,68
24,45,214501439,45143,Feins-en-Gâtinais,33,32,1
24,45,214501447,45144,Férolles,1226,1139,87
24,45,214501454,45145,Ferrières-en-Gâtinais,3791,3712,79
24,45,214501462,45146,La Ferté-Saint-Aubin,7530,7371,159
24,45,214501470,45147,Fleury-les-Aubrais,21364,21104,260
24,45,214501488,45148,Fontenay-sur-Loing,1753,1710,43
24,45,214501496,45149,Foucherolles,273,270,3
24,45,214501504,45150,Fréville-du-Gâtinais,187,183,4
24,45,214501512,45151,Gaubertin,258,250,8
24,45,214501520,45152,Gémigny,218,213,5
24,45,214501538,45153,Germigny-des-Prés,751,727,24
24,45,214501546,45154,Gidy,2077,2043,34
24,45,214501553,45155,Gien,13716,13305,411
24,45,214501561,45156,Girolles,609,595,14
24,45,214501579,45157,Givraines,419,413,6
24,45,214501587,45158,Gondreville,328,318,10
24,45,214501595,45159,Grangermont,195,188,7
24,45,214501603,45160,Greneville-en-Beauce,717,709,8
24,45,214501611,45161,Griselles,819,799,20
24,45,214501629,45162,Guigneville,538,525,13
24,45,214501645,45164,Guilly,677,661,16
24,45,214501652,45165,Gy-les-Nonains,616,609,7
24,45,214501660,45166,Huêtre,293,285,8
24,45,214501678,45167,Huisseau-sur-Mauves,1757,1728,29
24,45,214501686,45168,Ingrannes,554,550,4
24,45,214501694,45169,Ingré,9777,9541,236
24,45,214501702,45170,Intville-la-Guétard,169,167,2
24,45,214501710,45171,Isdes,559,545,14
24,45,214501736,45173,Jargeau,4739,4688,51
24,45,214501744,45174,Jouy-en-Pithiverais,268,262,6
24,45,214501751,45175,Jouy-le-Potier,1529,1504,25
24,45,214501769,45176,Juranville,430,426,4
24,45,214501777,45177,Laas,241,238,3
24,45,214501785,45178,Ladon,1409,1385,24
24,45,214501793,45179,Lailly-en-Val,3150,3101,49
24,45,214501801,45180,Langesse,82,82,0
24,45,214501819,45181,Léouville,91,89,2
24,45,214501827,45182,Ligny-le-Ribault,1262,1238,24
24,45,214501835,45183,Lion-en-Beauce,137,133,4
24,45,214501843,45184,Lion-en-Sullias,400,394,6
24,45,214501850,45185,Lombreuil,307,298,9
24,45,214501868,45186,Lorcy,602,589,13
24,45,214501876,45187,Lorris,3050,2988,62
24,45,214501884,45188,Loury,2577,2515,62
24,45,214501892,45189,Louzouer,254,248,6
24,45,200057255,45191,Le Malesherbois,8165,8004,161
24,45,214501934,45193,Marcilly-en-Villette,2191,2145,46
24,45,214501942,45194,Mardié,2988,2938,50
24,45,214501959,45195,Mareau-aux-Bois,572,559,13
24,45,214501967,45196,Mareau-aux-Prés,1606,1576,30
24,45,214501975,45197,Marigny-les-Usages,1793,1755,38
24,45,214501983,45198,Marsainvilliers,313,304,9
24,45,214501991,45199,Melleroy,505,500,5
24,45,214502007,45200,Ménestreau-en-Villette,1438,1401,37
24,45,214502015,45201,Mérinville,180,177,3
24,45,214502023,45202,Messas,1024,1009,15
24,45,214502031,45203,Meung-sur-Loire,6660,6567,93
24,45,214502049,45204,Mézières-lez-Cléry,862,840,22
24,45,214502056,45205,Mézières-en-Gâtinais,263,257,6
24,45,214502064,45206,Mignères,324,320,4
24,45,214502072,45207,Mignerette,397,389,8
24,45,214502080,45208,Montargis,15220,14738,482
24,45,214502098,45209,Montbarrois,307,302,5
24,45,214502106,45210,Montbouy,752,733,19
24,45,214502122,45212,Montcresson,1289,1261,28
24,45,214502130,45213,Montereau,645,626,19
24,45,214502148,45214,Montigny,242,238,4
24,45,214502155,45215,Montliard,250,247,3
24,45,214502163,45216,Mormant-sur-Vernisson,130,128,2
24,45,214502171,45217,Morville-en-Beauce,171,166,5
24,45,214502189,45218,Le Moulinet-sur-Solin,113,112,1
24,45,214502197,45219,Moulon,194,192,2
24,45,214502205,45220,Nancray-sur-Rimarde,591,574,17
24,45,214502221,45222,Nargis,1505,1469,36
24,45,214502239,45223,Nesploy,366,360,6
24,45,214502247,45224,Neuville-aux-Bois,5055,4978,77
24,45,214502254,45225,La Neuville-sur-Essonne,365,351,14
24,45,214502262,45226,Neuvy-en-Sullias,1379,1356,23
24,45,214502270,45227,Nevoy,1186,1164,22
24,45,214502288,45228,Nibelle,1217,1189,28
24,45,214502296,45229,Nogent-sur-Vernisson,2612,2575,37
24,45,214502304,45230,Noyers,736,731,5
24,45,214502312,45231,Oison,134,129,5
24,45,214502320,45232,Olivet,23017,22503,514
24,45,214502338,45233,Ondreville-sur-Essonne,402,399,3
24,45,214502346,45234,Orléans,119380,117026,2354
24,45,214502353,45235,Ormes,4273,4194,79
24,45,214502379,45237,Orville,126,125,1
24,45,214502387,45238,Ousson-sur-Loire,703,691,12
24,45,214502395,45239,Oussoy-en-Gâtinais,421,415,6
24,45,214502403,45240,Outarville,1345,1322,23
24,45,214502411,45241,Ouvrouer-les-Champs,554,542,12
24,45,214502429,45242,Ouzouer-des-Champs,282,277,5
24,45,214502437,45243,Ouzouer-sous-Bellegarde,319,313,6
24,45,214502445,45244,Ouzouer-sur-Loire,2675,2593,82
24,45,214502452,45245,Ouzouer-sur-Trézée,1139,1118,21
24,45,214502460,45246,Pannecières,136,131,5
24,45,214502478,45247,Pannes,3758,3694,64
24,45,214502486,45248,Patay,2308,2270,38
24,45,214502494,45249,Paucourt,930,907,23
24,45,214502502,45250,Pers-en-Gâtinais,251,248,3
24,45,214502510,45251,Pierrefitte-ès-Bois,309,306,3
24,45,214502528,45252,Pithiviers,9213,9067,146
24,45,214502536,45253,Pithiviers-le-Vieil,1790,1747,43
24,45,214502544,45254,Poilly-lez-Gien,2468,2419,49
24,45,214502551,45255,Préfontaines,443,438,5
24,45,214502569,45256,Presnoy,254,248,6
24,45,214502577,45257,Pressigny-les-Pins,517,510,7
24,45,214502585,45258,Puiseaux,3469,3413,56
24,45,214502593,45259,Quiers-sur-Bezonde,1149,1128,21
24,45,214502601,45260,Ramoulu,258,250,8
24,45,214502619,45261,Rebréchien,1323,1306,17
24,45,214502627,45262,Rouvray-Sainte-Croix,141,139,2
24,45,214502635,45263,Rouvres-Saint-Jean,305,297,8
24,45,214502643,45264,Rozières-en-Beauce,186,182,4
24,45,214502650,45265,Rozoy-le-Vieil,410,405,5
24,45,214502668,45266,Ruan,203,202,1
24,45,214502684,45268,Saint-Aignan-le-Jaillard,622,614,8
24,45,214502692,45269,Saint-Ay,3679,3607,72
24,45,214502700,45270,Saint-Benoît-sur-Loire,2056,2004,52
24,45,214502718,45271,Saint-Brisson-sur-Loire,984,962,22
24,45,214502726,45272,Saint-Cyr-en-Val,3388,3313,75
24,45,214502734,45273,Saint-Denis-de-l'Hôtel,3068,3028,40
24,45,214502742,45274,Saint-Denis-en-Val,7821,7633,188
24,45,214502759,45275,Saint-Firmin-des-Bois,471,466,5
24,45,214502767,45276,Saint-Firmin-sur-Loire,515,510,5
24,45,214502775,45277,Saint-Florent,463,451,12
24,45,214502783,45278,Sainte-Geneviève-des-Bois,1134,1065,69
24,45,214502791,45279,Saint-Germain-des-Prés,1933,1891,42
24,45,214502809,45280,Saint-Gondon,1095,1079,16
24,45,214502817,45281,Saint-Hilaire-les-Andrésis,967,950,17
24,45,214502825,45282,Saint-Hilaire-Saint-Mesmin,3185,3099,86
24,45,214502833,45283,Saint-Hilaire-sur-Puiseaux,165,159,6
24,45,214502841,45284,Saint-Jean-de-Braye,21983,21396,587
24,45,214502858,45285,Saint-Jean-de-la-Ruelle,16812,16570,242
24,45,214502866,45286,Saint-Jean-le-Blanc,9360,9225,135
24,45,214502882,45288,Saint-Loup-des-Vignes,405,396,9
24,45,214502890,45289,Saint-Lyé-la-Forêt,1234,1216,18
24,45,214502908,45290,Saint-Martin-d'Abbat,1817,1789,28
24,45,214502916,45291,Saint-Martin-sur-Ocre,1279,1232,47
24,45,214502924,45292,Saint-Maurice-sur-Aveyron,865,852,13
24,45,214502932,45293,Saint-Maurice-sur-Fessard,1175,1151,24
24,45,214502940,45294,Saint-Michel,142,141,1
24,45,214502965,45296,Saint-Péravy-la-Colombe,765,749,16
24,45,214502973,45297,Saint-Père-sur-Loire,1041,1025,16
24,45,214502981,45298,Saint-Pryvé-Saint-Mesmin,6273,6170,103
24,45,214502999,45299,Saint-Sigismond,270,270,0
24,45,214503005,45300,Sandillon,4290,4186,104
24,45,214503013,45301,Santeau,400,397,3
24,45,214503021,45302,Saran,16787,16598,189
24,45,214503039,45303,Sceaux-du-Gâtinais,643,626,17
24,45,214503054,45305,Seichebrières,215,214,1
24,45,214503062,45306,La Selle-en-Hermoy,795,781,14
24,45,200088532,45307,La Selle-sur-le-Bied,1115,1090,25
24,45,214503088,45308,Semoy,3292,3217,75
24,45,214503096,45309,Sennely,717,702,15
24,45,214503104,45310,Sermaises,1713,1691,22
24,45,214503112,45311,Sigloy,677,659,18
24,45,214503120,45312,Solterre,483,475,8
24,45,214503138,45313,Sougy,826,813,13
24,45,214503146,45314,Sully-la-Chapelle,460,451,9
24,45,214503153,45315,Sully-sur-Loire,5203,5141,62
24,45,214503161,45316,Sury-aux-Bois,812,789,23
24,45,214503179,45317,Tavers,1381,1351,30
24,45,214503203,45320,Thignonville,432,420,12
24,45,214503211,45321,Thimory,719,699,20
24,45,214503229,45322,Thorailles,192,188,4
24,45,214503237,45323,Thou,224,220,4
24,45,214503245,45324,Tigy,2429,2381,48
24,45,214503252,45325,Tivernon,295,291,4
24,45,214503260,45326,Tournoisis,398,389,9
24,45,214503278,45327,Traînou,3528,3445,83
24,45,214503286,45328,Treilles-en-Gâtinais,298,293,5
24,45,214503294,45329,Triguères,1306,1282,24
24,45,214503302,45330,Trinay,219,215,4
24,45,214503310,45331,Vannes-sur-Cosson,623,614,9
24,45,214503328,45332,Varennes-Changy,1516,1492,24
24,45,214503336,45333,Vennecy,2014,1974,40
24,45,214503344,45334,Vieilles-Maisons-sur-Joudry,640,632,8
24,45,214503351,45335,Vienne-en-Val,1982,1938,44
24,45,214503369,45336,Viglain,880,867,13
24,45,214503377,45337,Villamblain,286,284,2
24,45,214503385,45338,Villemandeur,7202,6835,367
24,45,214503393,45339,Villemoutiers,490,483,7
24,45,214503401,45340,Villemurlin,574,563,11
24,45,214503419,45341,Villeneuve-sur-Conie,203,197,6
24,45,214503427,45342,Villereau,401,398,3
24,45,214503435,45343,Villevoques,212,206,6
24,45,214503443,45344,Villorceau,1104,1084,20
24,45,214503450,45345,Vimory,1152,1118,34
24,45,214503468,45346,Vitry-aux-Loges,2310,2269,41
24,45,214503476,45347,Vrigny,827,811,16
24,45,214503484,45348,Yèvre-la-Ville,711,694,17
76,46,214600017,46001,Albas,535,523,12
76,46,214600025,46002,Albiac,74,72,2
76,46,214600033,46003,Alvignac,716,692,24
76,46,214600041,46004,Anglars,233,227,6
76,46,214600058,46005,Anglars-Juillac,341,332,9
76,46,214600066,46006,Anglars-Nozac,393,389,4
76,46,214600074,46007,Arcambal,1009,986,23
76,46,214600082,46008,Les Arques,221,218,3
76,46,214600090,46009,Assier,680,661,19
76,46,214600108,46010,Aujols,380,370,10
76,46,214600116,46011,Autoire,374,363,11
76,46,214600124,46012,Aynac,568,554,14
76,46,214600132,46013,Bach,191,185,6
76,46,214600157,46015,Bagnac-sur-Célé,1507,1473,34
76,46,214600165,46016,Baladou,399,384,15
76,46,214600173,46017,Bannes,148,144,4
76,46,214600181,46018,Le Bastit,135,133,2
76,46,214600207,46020,Beauregard,242,230,12
76,46,214600215,46021,Béduer,720,697,23
76,46,214600223,46022,Bélaye,212,209,3
76,46,214600231,46023,Belfort-du-Quercy,521,515,6
76,46,214600249,46024,Belmont-Bretenoux,416,404,12
76,46,214600264,46026,Belmont-Sainte-Foi,125,122,3
76,46,214600272,46027,Berganty,124,122,2
76,46,214600280,46028,Bétaille,1098,1069,29
76,46,214600298,46029,Biars-sur-Cère,2050,1998,52
76,46,214600306,46030,Bio,349,337,12
76,46,214600314,46031,Blars,133,131,2
76,46,214600322,46032,Boissières,408,403,5
76,46,200082907,46033,Porte-du-Quercy,572,560,12
76,46,214600348,46034,Le Bourg,314,306,8
76,46,214600355,46035,Boussac,188,180,8
76,46,214600363,46036,Le Bouyssou,127,125,2
76,46,214600371,46037,Bouziès,94,93,1
76,46,214600389,46038,Bretenoux,1398,1370,28
76,46,214600397,46039,Brengues,213,211,2
76,46,214600405,46040,Cabrerets,233,225,8
76,46,214600413,46041,Cadrieu,163,155,8
76,46,214600421,46042,Cahors,21081,20159,922
76,46,214600439,46043,Cahus,204,199,5
76,46,214600447,46044,Caillac,622,600,22
76,46,214600454,46045,Cajarc,1149,1117,32
76,46,214600462,46046,Calamane,470,460,10
76,46,214600470,46047,Calès,174,168,6
76,46,214600496,46049,Calvignac,220,215,5
76,46,214600504,46050,Cambayrac,139,135,4
76,46,214600512,46051,Cambes,381,374,7
76,46,214600520,46052,Camboulit,262,257,5
76,46,214600538,46053,Camburat,436,424,12
76,46,214600546,46054,Caniac-du-Causse,395,393,2
76,46,214600553,46055,Capdenac,1139,1112,27
76,46,214600561,46056,Carayac,108,106,2
76,46,214600579,46057,Cardaillac,634,622,12
76,46,214600587,46058,Carennac,427,413,14
76,46,214600595,46059,Carlucet,234,224,10
76,46,214600603,46060,Carnac-Rouffiac,230,229,1
76,46,214600611,46061,Cassagnes,183,177,6
76,46,214600629,46062,Castelfranc,435,429,6
76,46,200063741,46063,Castelnau Montratier-Sainte Alauzie,1874,1836,38
76,46,214600645,46064,Catus,921,914,7
76,46,214600652,46065,Cavagnac,441,426,15
76,46,214600660,46066,Cazals,649,643,6
76,46,214600686,46068,Cénevières,169,167,2
76,46,214600694,46069,Cézac,172,169,3
76,46,214600702,46070,Cieurac,613,599,14
76,46,214600728,46072,Concorès,309,303,6
76,46,214600736,46073,Concots,432,415,17
76,46,214600744,46074,Condat,420,412,8
76,46,214600751,46075,Corn,244,239,5
76,46,214600769,46076,Cornac,354,347,7
76,46,214600785,46078,Couzou,97,96,1
76,46,214600793,46079,Cras,104,102,2
76,46,214600801,46080,Crayssac,796,781,15
76,46,214600819,46081,Crégols,75,72,3
76,46,214600827,46082,Cremps,375,366,9
76,46,200082279,46083,Cressensac-Sarrazac,1140,1125,15
76,46,214600843,46084,Creysse,314,307,7
76,46,214600850,46085,Cuzac,244,238,6
76,46,214600868,46086,Cuzance,653,640,13
76,46,214600876,46087,Dégagnac,667,649,18
76,46,214600884,46088,Douelle,847,825,22
76,46,214600892,46089,Duravel,956,947,9
76,46,214600900,46090,Durbans,153,152,1
76,46,214600918,46091,Escamps,212,208,4
76,46,214600926,46092,Esclauzels,222,219,3
76,46,214600934,46093,Espagnac-Sainte-Eulalie,88,86,2
76,46,214600942,46094,Espédaillac,273,267,6
76,46,214600959,46095,Espère,1065,1040,25
76,46,214600967,46096,Espeyroux,98,96,2
76,46,214600975,46097,Estal,115,109,6
76,46,214600983,46098,Fajoles,313,306,7
76,46,214601007,46100,Faycelles,726,697,29
76,46,214601015,46101,Felzins,482,473,9
76,46,214601023,46102,Figeac,10380,9784,596
76,46,200060002,46103,Saint-Paul-Flaugnac,1020,994,26
76,46,214601049,46104,Flaujac-Gare,96,91,5
76,46,214601056,46105,Flaujac-Poujols,809,792,17
76,46,214601064,46106,Floirac,248,239,9
76,46,214601072,46107,Floressas,178,173,5
76,46,214601080,46108,Fons,422,409,13
76,46,214601098,46109,Fontanes,522,513,9
76,46,214601114,46111,Fourmagnac,175,171,4
76,46,214601122,46112,Francoulès,256,250,6
76,46,214601130,46113,Frayssinet,311,306,5
76,46,214601148,46114,Frayssinet-le-Gélat,372,365,7
76,46,214601155,46115,Frayssinhes,168,161,7
76,46,214601163,46116,Frontenac,77,71,6
76,46,214601171,46117,Gagnac-sur-Cère,707,667,40
76,46,214601189,46118,Gignac,689,674,15
76,46,214601197,46119,Gigouzac,299,299,0
76,46,214601205,46120,Gindou,347,343,4
76,46,214601213,46121,Ginouillac,145,142,3
76,46,214601221,46122,Gintrac,108,105,3
76,46,214601239,46123,Girac,367,360,7
76,46,214601247,46124,Glanes,309,297,12
76,46,214601254,46125,Gorses,339,329,10
76,46,214601262,46126,Goujounac,221,217,4
76,46,214601270,46127,Gourdon,4086,3959,127
76,46,214601288,46128,Gramat,3539,3480,59
76,46,214601296,46129,Gréalou,300,290,10
76,46,214601304,46130,Grézels,229,226,3
76,46,214601312,46131,Grèzes,171,166,5
76,46,214601320,46132,Issendolus,538,516,22
76,46,214601338,46133,Issepts,272,269,3
76,46,214601346,46134,Les Junies,273,267,6
76,46,214601353,46135,Labastide-du-Haut-Mont,50,48,2
76,46,214601361,46136,Labastide-du-Vert,279,272,7
76,46,214601379,46137,Labastide-Marnhac,1297,1274,23
76,46,200058535,46138,Coeur de Causse,918,900,18
76,46,214601395,46139,Labathude,208,201,7
76,46,214601403,46140,Laburgade,377,362,15
76,46,214601429,46142,Lacapelle-Cabanac,175,173,2
76,46,214601437,46143,Lacapelle-Marival,1326,1285,41
76,46,214601445,46144,Lacave,260,249,11
76,46,214601452,46145,Lachapelle-Auzac,805,794,11
76,46,214601460,46146,Ladirat,95,93,2
76,46,214601478,46147,Lagardelle,128,128,0
76,46,214601486,46148,Lalbenque,1881,1836,45
76,46,214601494,46149,Lamagdelaine,717,703,14
76,46,214601510,46151,Lamothe-Cassel,118,115,3
76,46,214601528,46152,Lamothe-Fénelon,306,302,4
76,46,214601536,46153,Lanzac,590,578,12
76,46,214601544,46154,Laramière,358,351,7
76,46,214601551,46155,Larnagol,138,137,1
76,46,200068054,46156,Bellefont-La Rauze,1243,1213,30
76,46,214601577,46157,Larroque-Toirac,138,133,5
76,46,214601593,46159,Latouille-Lentillac,233,228,5
76,46,214601601,46160,Latronquière,433,419,14
76,46,214601619,46161,Lauresses,252,246,6
76,46,214601627,46162,Lauzès,211,205,6
76,46,214601635,46163,Laval-de-Cère,289,285,4
76,46,214601643,46164,Lavercantière,263,252,11
76,46,214601650,46165,Lavergne,482,471,11
76,46,214601676,46167,Lentillac-du-Causse,110,110,0
76,46,214601684,46168,Lentillac-Saint-Blaise,192,190,2
76,46,214601692,46169,Léobard,210,203,7
76,46,214601700,46170,Leyme,950,924,26
76,46,214601718,46171,Lherm,231,228,3
76,46,214601726,46172,Lhospitalet,518,502,16
76,46,214601734,46173,Limogne-en-Quercy,781,773,8
76,46,214601742,46174,Linac,243,235,8
76,46,214601759,46175,Lissac-et-Mouret,962,926,36
76,46,214601767,46176,Livernon,723,709,14
76,46,214601775,46177,Loubressac,531,511,20
76,46,214601783,46178,Loupiac,262,260,2
76,46,214601791,46179,Lugagnac,133,128,5
76,46,214601809,46180,Lunan,633,606,27
76,46,214601817,46181,Lunegarde,98,93,5
76,46,214601825,46182,Luzech,1804,1776,28
76,46,214601833,46183,Marcilhac-sur-Célé,205,202,3
76,46,214601841,46184,Marminiac,360,348,12
76,46,214601858,46185,Martel,1676,1638,38
76,46,214601866,46186,Masclat,365,360,5
76,46,214601874,46187,Mauroux,535,525,10
76,46,214601882,46188,Maxou,305,295,10
76,46,214601890,46189,Mayrinhac-Lentour,505,492,13
76,46,214601908,46190,Mechmont,130,127,3
76,46,214601916,46191,Mercuès,1160,1135,25
76,46,214601924,46192,Meyronne,271,263,8
76,46,214601932,46193,Miers,462,454,8
76,46,214601940,46194,Milhac,193,187,6
76,46,214601957,46195,Molières,366,358,8
76,46,214601965,46196,Montamel,95,94,1
76,46,214601973,46197,Le Montat,1194,1069,125
76,46,214601981,46198,Montbrun,111,110,1
76,46,214601999,46199,Montcabrier,351,345,6
76,46,214602005,46200,Montcléra,266,262,4
76,46,200054948,46201,Montcuq-en-Quercy-Blanc,1854,1804,50
76,46,214602021,46202,Montdoumerc,559,554,5
76,46,214602039,46203,Montet-et-Bouxal,219,213,6
76,46,214602047,46204,Montfaucon,601,593,8
76,46,214602054,46205,Montgesty,320,318,2
76,46,214602062,46206,Montlauzun,124,118,6
76,46,214602070,46207,Montredon,307,301,6
76,46,214602088,46208,Montvalent,301,294,7
76,46,214602096,46209,Nadaillac-de-Rouge,171,162,9
76,46,214602104,46210,Nadillac,72,71,1
76,46,214602112,46211,Nuzéjouls,359,357,2
76,46,214602120,46212,Orniac,71,71,0
76,46,214602138,46213,Padirac,169,165,4
76,46,214602146,46214,Parnac,396,386,10
76,46,214602153,46215,Payrac,649,635,14
76,46,214602161,46216,Payrignac,681,652,29
76,46,214602179,46217,Pern,442,431,11
76,46,214602187,46218,Pescadoires,190,186,4
76,46,214602195,46219,Peyrilles,357,344,13
76,46,214602203,46220,Pinsac,800,772,28
76,46,214602211,46221,Planioles,550,539,11
76,46,214602229,46222,Pomarède,196,193,3
76,46,214602237,46223,Pontcirq,180,178,2
76,46,214602245,46224,Pradines,3681,3578,103
76,46,214602252,46225,Prayssac,2485,2419,66
76,46,214602260,46226,Prendeignes,237,230,7
76,46,214602278,46227,Promilhanes,225,221,4
76,46,214602286,46228,Prudhomat,744,724,20
76,46,214602294,46229,Puybrun,1039,1020,19
76,46,214602302,46230,Puyjourdes,93,89,4
76,46,214602310,46231,Puy-l'Évêque,1953,1929,24
76,46,200086718,46232,Le Vignon-en-Quercy,1009,985,24
76,46,214602336,46233,Quissac,109,108,1
76,46,214602344,46234,Rampoux,101,99,2
76,46,214602351,46235,Reilhac,174,170,4
76,46,214602369,46236,Reilhaguet,150,150,0
76,46,214602377,46237,Reyrevignes,377,365,12
76,46,214602385,46238,Rignac,294,285,9
76,46,214602393,46239,Le Roc,213,208,5
76,46,214602401,46240,Rocamadour,637,617,20
76,46,214602419,46241,Rouffilhac,193,189,4
76,46,214602427,46242,Rudelle,186,181,5
76,46,214602435,46243,Rueyres,190,189,1
76,46,214602443,46244,Sabadel-Latronquière,94,93,1
76,46,214602450,46245,Sabadel-Lauzès,82,82,0
76,46,214602468,46246,Saignes,75,74,1
76,46,214602476,46247,Saillac,156,151,5
76,46,214602492,46249,Saint-Bressou,128,123,5
76,46,214602500,46250,Saint-Caprais,85,83,2
76,46,214602518,46251,Saint-Céré,3582,3427,155
76,46,200059988,46252,Les Pechs du Vers,322,314,8
76,46,214602534,46253,Saint-Chamarand,183,181,2
76,46,214602542,46254,Saint-Chels,142,137,5
76,46,214602559,46255,Saint-Cirgues,343,330,13
76,46,214602567,46256,Saint-Cirq-Lapopie,207,201,6
76,46,214602575,46257,Saint-Cirq-Madelon,134,133,1
76,46,214602583,46258,Saint-Cirq-Souillaguet,166,165,1
76,46,214602591,46259,Saint-Clair,142,140,2
76,46,214602609,46260,Sainte-Colombe,237,227,10
76,46,200077279,46262,Lendou-en-Quercy,642,629,13
76,46,200082881,46263,Barguelonne-en-Quercy,713,697,16
76,46,214602641,46264,Saint-Denis-Catus,207,200,7
76,46,214602658,46265,Saint-Denis-lès-Martel,338,333,5
76,46,214602666,46266,Saint-Félix,544,535,9
76,46,214602674,46267,Saint-Germain-du-Bel-Air,579,567,12
76,46,200068153,46268,Saint Géry-Vers,927,907,20
76,46,214602690,46269,Saint-Hilaire,62,60,2
76,46,214602708,46270,Saint-Jean-de-Laur,245,242,3
76,46,214602716,46271,Saint-Jean-Lespinasse,422,405,17
76,46,214602724,46272,Saint-Jean-Mirabel,290,287,3
76,46,214602732,46273,Saint-Laurent-les-Tours,870,844,26
76,46,214602765,46276,Saint-Martin-Labouval,188,183,5
76,46,214602773,46277,Saint-Martin-le-Redon,205,201,4
76,46,214602799,46279,Saint-Maurice-en-Quercy,209,206,3
76,46,214602807,46280,Saint-Médard,182,177,5
76,46,214602815,46281,Saint-Médard-de-Presque,204,198,6
76,46,214602823,46282,Saint-Médard-Nicourby,95,95,0
76,46,214602831,46283,Saint-Michel-de-Bannières,325,317,8
76,46,214602849,46284,Saint-Michel-Loubéjou,415,407,8
76,46,214602864,46286,Saint-Paul-de-Vern,179,175,4
76,46,214602880,46288,Saint-Perdoux,225,215,10
76,46,214602898,46289,Saint-Pierre-Toirac,160,159,1
76,46,214602906,46290,Saint-Projet,349,342,7
76,46,214602922,46292,Saint-Simon,199,193,6
76,46,214602930,46293,Saint-Sozy,495,483,12
76,46,214602948,46294,Saint-Sulpice,148,144,4
76,46,214602955,46295,Saint-Vincent-du-Pendit,226,222,4
76,46,214602963,46296,Saint-Vincent-Rive-d'Olt,445,429,16
76,46,214602971,46297,Salviac,1233,1208,25
76,46,214602997,46299,Sauliac-sur-Célé,123,119,4
76,46,214603011,46301,Sauzet,535,530,5
76,46,214603029,46302,Sénaillac-Latronquière,134,132,2
76,46,214603037,46303,Sénaillac-Lauzès,136,134,2
76,46,214603045,46304,Séniergues,142,141,1
76,46,214603052,46305,Sérignac,313,310,3
76,46,214603060,46306,Sonac,89,88,1
76,46,214603078,46307,Soturac,647,640,7
76,46,214603086,46308,Soucirac,103,102,1
76,46,214603094,46309,Souillac,3520,3203,317
76,46,214603102,46310,Soulomès,134,132,2
76,46,200054971,46311,Sousceyrac-en-Quercy,1353,1334,19
76,46,214603128,46312,Strenquels,277,275,2
76,46,214603136,46313,Tauriac,464,454,10
76,46,214603144,46314,Terrou,215,176,39
76,46,214603151,46315,Teyssieu,169,166,3
76,46,214603169,46316,Thédirac,294,289,5
76,46,214603177,46317,Thégra,497,484,13
76,46,214603185,46318,Thémines,249,238,11
76,46,214603193,46319,Théminettes,176,173,3
76,46,214603201,46320,Tour-de-Faure,328,314,14
76,46,214603219,46321,Touzac,378,370,8
76,46,214603227,46322,Trespoux-Rassiels,842,811,31
76,46,214603235,46323,Ussel,101,99,2
76,46,214603243,46324,Uzech,219,215,4
76,46,214603284,46328,Varaire,357,345,12
76,46,214603292,46329,Vaylats,330,328,2
76,46,214603300,46330,Vayrac,1329,1305,24
76,46,214603326,46332,Viazac,351,336,15
76,46,214603334,46333,Vidaillac,187,183,4
76,46,214603342,46334,Le Vigan,1603,1546,57
76,46,214603359,46335,Villesèque,405,389,16
76,46,214603367,46336,Vire-sur-Lot,372,340,32
76,46,214603375,46337,Mayrac,268,261,7
76,46,214603383,46338,Bessonies,76,75,1
76,46,214603391,46339,Saint-Jean-Lagineste,388,380,8
76,46,214603409,46340,Saint-Pierre-Lafeuille,384,371,13
75,47,214700015,47001,Agen,33046,32214,832
75,47,214700023,47002,Agmé,112,108,4
75,47,214700031,47003,Agnac,449,439,10
75,47,214700049,47004,Aiguillon,4368,4253,115
75,47,214700056,47005,Allemans-du-Dropt,490,485,5
75,47,214700064,47006,Allez-et-Cazeneuve,615,602,13
75,47,214700072,47007,Allons,170,165,5
75,47,214700080,47008,Ambrus,112,108,4
75,47,214700098,47009,Andiran,249,240,9
75,47,214700106,47010,Antagnac,225,222,3
75,47,214700114,47011,Anthé,207,198,9
75,47,214700122,47012,Anzex,312,310,2
75,47,214700130,47013,Argenton,331,320,11
75,47,214700148,47014,Armillac,215,208,7
75,47,214700155,47015,Astaffort,2075,2036,39
75,47,214700163,47016,Aubiac,1189,1165,24
75,47,213300171,47017,Auradou,431,422,9
75,47,214700189,47018,Auriac-sur-Dropt,179,173,6
75,47,214703308,47019,Bajamont,1002,986,16
75,47,214700205,47020,Baleyssagues,196,188,8
75,47,214700213,47021,Barbaste,1571,1501,70
75,47,214700221,47022,Bazens,544,535,9
75,47,214700239,47023,Beaugas,352,344,8
75,47,214700247,47024,Beaupuy,1681,1638,43
75,47,214700254,47025,Beauville,560,550,10
75,47,214700262,47026,Beauziac,235,227,8
75,47,214700270,47027,Bias,3030,2987,43
75,47,214700288,47028,Birac-sur-Trec,867,847,20
75,47,214700296,47029,Blanquefort-sur-Briolance,519,506,13
75,47,214700304,47030,Blaymont,217,211,6
75,47,214700312,47031,Boé,5733,5639,94
75,47,214700320,47032,Bon-Encontre,6369,6222,147
75,47,214703456,47033,Boudy-de-Beauregard,415,407,8
75,47,214700346,47034,Bouglon,653,639,14
75,47,214700353,47035,Bourgougnague,391,316,75
75,47,214700361,47036,Bourlens,380,374,6
75,47,214700379,47037,Bournel,258,254,4
75,47,214700387,47038,Bourran,636,611,25
75,47,214700395,47039,Boussès,36,36,0
75,47,214700403,47040,Brax,2147,2100,47
75,47,214700411,47041,Bruch,746,729,17
75,47,214700429,47042,Brugnac,188,182,6
75,47,214700437,47043,Buzet-sur-Baïse,1284,1257,27
75,47,214700445,47044,Cahuzac,316,310,6
75,47,214700452,47045,Calignac,481,476,5
75,47,214700460,47046,Calonges,608,595,13
75,47,214700478,47047,Cambes,188,183,5
75,47,214700486,47048,Cancon,1365,1347,18
75,47,214700494,47049,Casseneuil,2452,2402,50
75,47,214700502,47050,Cassignas,133,131,2
75,47,214700510,47051,Castelculier,2439,2391,48
75,47,214700528,47052,Casteljaloux,4575,4521,54
75,47,214700536,47053,Castella,390,383,7
75,47,214700544,47054,Castelmoron-sur-Lot,1818,1796,22
75,47,214700551,47055,Castelnaud-de-Gratecambe,523,516,7
75,47,214700569,47056,Castelnau-sur-Gupie,945,912,33
75,47,214700577,47057,Castillonnès,1386,1366,20
75,47,214703316,47058,Caubeyres,272,262,10
75,47,214700593,47059,Caubon-Saint-Sauveur,266,262,4
75,47,214700601,47060,Caudecoste,1159,1136,23
75,47,214700619,47061,Caumont-sur-Garonne,797,789,8
75,47,214700627,47062,Cauzac,417,413,4
75,47,214700635,47063,Cavarc,165,163,2
75,47,214700643,47064,Cazideroque,248,242,6
75,47,214700650,47065,Clairac,2774,2578,196
75,47,214700668,47066,Clermont-Dessous,896,878,18
75,47,214700676,47067,Clermont-Soubiran,402,394,8
75,47,214700684,47068,Cocumont,1112,1089,23
75,47,214700692,47069,Colayrac-Saint-Cirq,3177,3129,48
75,47,214700700,47070,Condezaygues,864,846,18
75,47,214700718,47071,Coulx,246,244,2
75,47,214700726,47072,Courbiac,111,108,3
75,47,214700734,47073,Cours,202,196,6
75,47,214700742,47074,Couthures-sur-Garonne,378,371,7
75,47,214700759,47075,La Croix-Blanche,1118,1094,24
75,47,214700767,47076,Cuq,285,280,5
75,47,214700775,47077,Cuzorn,870,852,18
75,47,214700783,47078,Damazan,1402,1357,45
75,47,214700791,47079,Dausse,541,524,17
75,47,214700809,47080,Dévillac,143,141,2
75,47,214700817,47081,Dolmayrac,729,714,15
75,47,214700825,47082,Dondas,216,215,1
75,47,214700833,47083,Doudrac,107,106,1
75,47,214700841,47084,Douzains,280,274,6
75,47,214700858,47085,Durance,300,297,3
75,47,214700866,47086,Duras,1236,1214,22
75,47,214700874,47087,Engayrac,167,160,7
75,47,214700882,47088,Escassefort,621,612,9
75,47,214700890,47089,Esclottes,151,148,3
75,47,214700908,47090,Espiens,371,363,8
75,47,214700916,47091,Estillac,2322,2278,44
75,47,214700924,47092,Fals,405,399,6
75,47,214700932,47093,Fargues-sur-Ourbise,353,344,9
75,47,214700940,47094,Fauguerolles,828,814,14
75,47,214703324,47095,Fauillet,874,860,14
75,47,214700965,47096,Ferrensac,209,204,5
75,47,214700973,47097,Feugarolles,1025,1007,18
75,47,214700981,47098,Fieux,361,346,15
75,47,214700999,47099,Fongrave,636,620,16
75,47,214701005,47100,Foulayronnes,5697,5479,218
75,47,214701013,47101,Fourques-sur-Garonne,1360,1333,27
75,47,214701021,47102,Francescas,749,738,11
75,47,214701039,47103,Fréchou,231,228,3
75,47,214701047,47104,Frégimont,264,259,5
75,47,214701054,47105,Frespech,288,283,5
75,47,214701062,47106,Fumel,4815,4709,106
75,47,214701070,47107,Galapian,320,317,3
75,47,214701088,47108,Gaujac,251,244,7
75,47,214701096,47109,Gavaudun,300,295,5
75,47,214701104,47110,Gontaud-de-Nogaret,1660,1630,30
75,47,214701112,47111,Granges-sur-Lot,608,592,16
75,47,214701120,47112,Grateloup-Saint-Gayrand,448,440,8
75,47,214701138,47113,Grayssas,144,141,3
75,47,214701146,47114,Grézet-Cavagnan,405,398,7
75,47,214701153,47115,Guérin,257,251,6
75,47,214701179,47117,Hautefage-la-Tour,1029,1016,13
75,47,214701187,47118,Hautesvignes,184,180,4
75,47,214701195,47119,Houeillès,559,550,9
75,47,214701203,47120,Jusix,102,99,3
75,47,214701211,47121,Labastide-Castel-Amouroux,310,307,3
75,47,214701229,47122,Labretonie,182,180,2
75,47,214701237,47123,Lacapelle-Biron,419,414,5
75,47,214701245,47124,Lacaussade,214,209,5
75,47,214701252,47125,Lacépède,320,313,7
75,47,214701260,47126,Lachapelle,98,97,1
75,47,214701278,47127,Lafitte-sur-Lot,823,812,11
75,47,214701286,47128,Lafox,1134,1104,30
75,47,214701294,47129,Lagarrigue,284,278,6
75,47,214701302,47130,Lagruère,330,326,4
75,47,214701310,47131,Lagupie,715,700,15
75,47,214701328,47132,Lalandusse,227,224,3
75,47,214701336,47133,Lamontjoie,597,586,11
75,47,214701344,47134,Lannes,374,365,9
75,47,214701351,47135,Laparade,397,389,8
75,47,214701369,47136,Laperche,143,141,2
75,47,214701377,47137,Laplume,1373,1342,31
75,47,214701385,47138,Laroque-Timbaut,1621,1597,24
75,47,214701393,47139,Lasserre,95,94,1
75,47,214701401,47140,Laugnac,713,699,14
75,47,214701419,47141,Laussou,285,279,6
75,47,214701427,47142,Lauzun,751,739,12
75,47,214701435,47143,Lavardac,2336,2278,58
75,47,214701443,47144,Lavergne,584,564,20
75,47,214701450,47145,Layrac,3781,3726,55
75,47,214701468,47146,Lédat,1444,1416,28
75,47,214701476,47147,Lévignac-de-Guyenne,697,685,12
75,47,214701484,47148,Leyritz-Moncassin,204,203,1
75,47,214701500,47150,Longueville,373,367,6
75,47,214701518,47151,Loubès-Bernac,423,419,4
75,47,214701526,47152,Lougratte,419,413,6
75,47,214701542,47154,Lusignan-Petit,377,373,4
75,47,214701559,47155,Madaillan,678,662,16
75,47,214701567,47156,Marcellus,865,857,8
75,47,214701575,47157,Marmande,17797,17265,532
75,47,214701583,47158,Marmont-Pachas,176,171,5
75,47,214701591,47159,Le Mas-d'Agenais,1516,1482,34
75,47,214701609,47160,Masquières,184,182,2
75,47,214701617,47161,Massels,117,116,1
75,47,214701625,47162,Massoulès,221,216,5
75,47,214703357,47163,Mauvezin-sur-Gupie,620,608,12
75,47,214701641,47164,Mazières-Naresse,108,105,3
75,47,214701658,47165,Meilhan-sur-Garonne,1397,1338,59
75,47,214701674,47167,Mézin,1489,1465,24
75,47,214701682,47168,Miramont-de-Guyenne,3190,3087,103
75,47,214701690,47169,Moirax,1242,1188,54
75,47,214701708,47170,Monbahus,648,625,23
75,47,214701716,47171,Monbalen,453,445,8
75,47,214701724,47172,Moncaut,605,587,18
75,47,214701732,47173,Monclar,900,890,10
75,47,214701740,47174,Moncrabeau,753,736,17
75,47,214701757,47175,Monflanquin,2391,2338,53
75,47,214701765,47176,Montgaillard-en-Albret,183,171,12
75,47,214701773,47177,Monheurt,192,190,2
75,47,214701781,47178,Monségur,406,401,5
75,47,214701799,47179,Monsempron-Libos,2088,2054,34
75,47,214701807,47180,Montagnac-sur-Auvignon,655,641,14
75,47,214701815,47181,Montagnac-sur-Lède,274,271,3
75,47,214701823,47182,Montastruc,242,241,1
75,47,214701831,47183,Montauriol,187,185,2
75,47,214701849,47184,Montaut,265,261,4
75,47,214701856,47185,Montayral,2720,2669,51
75,47,214701864,47186,Montesquieu,779,767,12
75,47,214701872,47187,Monteton,329,327,2
75,47,214701880,47188,Montignac-de-Lauzun,289,286,3
75,47,214701898,47189,Montignac-Toupinerie,147,145,2
75,47,214701906,47190,Montpezat,595,550,45
75,47,214701914,47191,Montpouillan,852,836,16
75,47,214701922,47192,Monviel,78,78,0
75,47,214701930,47193,Moulinet,205,199,6
75,47,214701948,47194,Moustier,322,317,5
75,47,214701955,47195,Nérac,7365,6854,511
75,47,214701963,47196,Nicole,224,223,1
75,47,214701971,47197,Nomdieu,254,253,1
75,47,214701989,47198,Pailloles,330,325,5
75,47,214701997,47199,Pardaillan,334,323,11
75,47,214702003,47200,Parranquet,115,114,1
75,47,214702011,47201,Le Passage,9518,9352,166
75,47,214702029,47202,Paulhiac,316,309,7
75,47,214702037,47203,Penne-d'Agenais,2432,2395,37
75,47,214702045,47204,Peyrière,287,284,3
75,47,214702052,47205,Pindères,205,197,8
75,47,214702060,47206,Pinel-Hauterive,575,570,5
75,47,214702078,47207,Pompiey,207,203,4
75,47,214702086,47208,Pompogne,204,198,6
75,47,214702094,47209,Pont-du-Casse,4275,4156,119
75,47,214702102,47210,Port-Sainte-Marie,1875,1844,31
75,47,214702110,47211,Poudenas,214,207,7
75,47,214702128,47212,Poussignac,294,288,6
75,47,214702136,47213,Prayssas,1017,991,26
75,47,214702144,47214,Puch-d'Agenais,708,692,16
75,47,214702151,47215,Pujols,3836,3717,119
75,47,214702169,47216,Puymiclan,693,681,12
75,47,214702177,47217,Puymirol,928,913,15
75,47,214702185,47218,Puysserampion,241,237,4
75,47,214702193,47219,Rayet,182,180,2
75,47,214702201,47220,Razimet,297,292,5
75,47,214702219,47221,Réaup-Lisse,616,602,14
75,47,214702227,47222,La Réunion,506,497,9
75,47,214703373,47223,Rives,207,201,6
75,47,214702243,47224,Romestaing,165,159,6
75,47,214702250,47225,Roquefort,2169,2126,43
75,47,214702268,47226,Roumagne,530,522,8
75,47,214703381,47227,Ruffiac,182,180,2
75,47,214702284,47228,Saint-Antoine-de-Ficalba,725,715,10
75,47,214702292,47229,Saint-Astier,228,223,5
75,47,214702300,47230,Saint-Aubin,396,389,7
75,47,214702318,47231,Saint-Avit,177,175,2
75,47,214702326,47232,Saint-Barthélemy-d'Agenais,521,518,3
75,47,214702334,47233,Sainte-Bazeille,3268,3174,94
75,47,214702342,47234,Saint-Caprais-de-Lerm,695,675,20
75,47,214702359,47235,Saint-Colomb-de-Lauzun,479,472,7
75,47,214702367,47236,Sainte-Colombe-de-Duras,106,104,2
75,47,214702375,47237,Sainte-Colombe-de-Villeneuve,516,505,11
75,47,214702383,47238,Sainte-Colombe-en-Bruilhois,1599,1548,51
75,47,214702391,47239,Saint-Étienne-de-Fougères,868,853,15
75,47,214702409,47240,Saint-Étienne-de-Villeréal,280,270,10
75,47,214702417,47241,Saint-Eutrope-de-Born,698,680,18
75,47,214702425,47242,Saint-Front-sur-Lémance,529,516,13
75,47,214702441,47244,Sainte-Gemme-Martaillac,392,387,5
75,47,214702458,47245,Saint-Géraud,93,91,2
75,47,214702466,47246,Saint-Hilaire-de-Lusignan,1535,1496,39
75,47,214702474,47247,Saint-Jean-de-Duras,255,245,10
75,47,214702482,47248,Saint-Jean-de-Thurac,577,567,10
75,47,214702490,47249,Saint-Laurent,524,522,2
75,47,214702508,47250,Saint-Léger,122,118,4
75,47,214702516,47251,Saint-Léon,323,319,4
75,47,214702524,47252,Sainte-Livrade-sur-Lot,6660,6487,173
75,47,214702532,47253,Sainte-Marthe,661,657,4
75,47,214702540,47254,Saint-Martin-Curton,314,306,8
75,47,214702557,47255,Saint-Martin-de-Beauville,170,168,2
75,47,214702565,47256,Saint-Martin-de-Villeréal,108,104,4
75,47,214702573,47257,Saint-Martin-Petit,626,617,9
75,47,214702581,47258,Sainte-Maure-de-Peyriac,321,310,11
75,47,214703464,47259,Saint-Maurice-de-Lestapel,107,103,4
75,47,214702607,47260,Saint-Maurin,401,396,5
75,47,214702623,47262,Saint-Nicolas-de-la-Balerme,430,424,6
75,47,214702631,47263,Saint-Pardoux-du-Breuil,621,606,15
75,47,214702649,47264,Saint-Pardoux-Isaac,1109,1090,19
75,47,214702656,47265,Saint-Pastour,380,372,8
75,47,214702664,47266,Saint-Pé-Saint-Simon,194,192,2
75,47,214702672,47267,Saint-Pierre-de-Buzet,291,289,2
75,47,214702698,47269,Saint-Pierre-de-Clairac,864,845,19
75,47,214702714,47271,Saint-Pierre-sur-Dropt,359,356,3
75,47,214702722,47272,Saint-Quentin-du-Dropt,202,195,7
75,47,214702730,47273,Saint-Robert,193,187,6
75,47,214702748,47274,Saint-Romain-le-Noble,399,393,6
75,47,214702755,47275,Saint-Salvy,202,201,1
75,47,214702763,47276,Saint-Sardos,308,301,7
75,47,214702771,47277,Saint-Sauveur-de-Meilhan,343,342,1
75,47,214702789,47278,Saint-Sernin,487,478,9
75,47,214702797,47279,Saint-Sixte,364,359,5
75,47,214702805,47280,Saint-Sylvestre-sur-Lot,2420,2367,53
75,47,214702813,47281,Saint-Urcisse,253,252,1
75,47,214702821,47282,Saint-Vincent-de-Lamontjoie,238,231,7
75,47,214702839,47283,Saint-Vite,1195,1164,31
75,47,214702847,47284,Salles,294,287,7
75,47,214702854,47285,Samazan,914,897,17
75,47,214702862,47286,Sauméjan,105,100,5
75,47,214702870,47287,Saumont,266,258,8
75,47,214702888,47288,Sauvagnas,536,522,14
75,47,214702896,47289,La Sauvetat-de-Savères,517,510,7
75,47,214702904,47290,La Sauvetat-du-Dropt,563,557,6
75,47,214702912,47291,La Sauvetat-sur-Lède,644,628,16
75,47,214702920,47292,Sauveterre-la-Lémance,582,576,6
75,47,214702938,47293,Sauveterre-Saint-Denis,400,382,18
75,47,214702946,47294,Savignac-de-Duras,218,217,1
75,47,214702953,47295,Savignac-sur-Leyze,311,305,6
75,47,214702961,47296,Ségalas,157,155,2
75,47,214702979,47297,Sembas,144,141,3
75,47,214702987,47298,Sénestis,209,209,0
75,47,214702995,47299,Sérignac-Péboudou,175,173,2
75,47,214703001,47300,Sérignac-sur-Garonne,1188,1169,19
75,47,214703019,47301,Seyches,1070,1058,12
75,47,214703027,47302,Sos,659,653,6
75,47,214703035,47303,Soumensac,229,226,3
75,47,214703043,47304,Taillebourg,62,60,2
75,47,214703050,47305,Tayrac,388,382,6
75,47,214703068,47306,Le Temple-sur-Lot,1078,1059,19
75,47,214703076,47307,Thézac,205,200,5
75,47,214703084,47308,Thouars-sur-Garonne,225,223,2
75,47,214703092,47309,Tombeboeuf,460,456,4
75,47,214703100,47310,Tonneins,9371,9213,158
75,47,214703118,47311,Tourliac,137,135,2
75,47,214703126,47312,Tournon-d'Agenais,777,764,13
75,47,214703134,47313,Tourtrès,141,140,1
75,47,214703142,47314,Trémons,411,400,11
75,47,214703159,47315,Trentels,936,911,25
75,47,214703167,47316,Varès,670,663,7
75,47,214703175,47317,Verteuil-d'Agenais,555,550,5
75,47,214703183,47318,Vianne,1004,988,16
75,47,214703191,47319,Villebramar,114,111,3
75,47,214703209,47320,Villefranche-du-Queyran,399,397,2
75,47,214703217,47321,Villeneuve-de-Duras,324,319,5
75,47,214703233,47323,Villeneuve-sur-Lot,22385,21690,695
75,47,214703241,47324,Villeréal,1307,1275,32
75,47,214703258,47325,Villeton,464,458,6
75,47,214703266,47326,Virazeil,1711,1676,35
75,47,214703274,47327,Xaintrailles,399,388,11
75,47,214703282,47328,Saint-Georges,564,545,19
76,48,214800013,48001,Albaret-le-Comtal,165,164,1
76,48,214800021,48002,Albaret-Sainte-Marie,578,557,21
76,48,214800039,48003,Allenc,263,257,6
76,48,214800047,48004,Altier,225,219,6
76,48,214800054,48005,Antrenas,331,327,4
76,48,214800070,48007,Arzenc-d'Apcher,50,50,0
76,48,214800088,48008,Arzenc-de-Randon,199,191,8
76,48,200064731,48009,Peyre en Aubrac,2393,2295,98
76,48,214800104,48010,Auroux,371,365,6
76,48,214800120,48012,Les Monts-Verts,348,342,6
76,48,214800138,48013,Badaroux,1027,986,41
76,48,214800153,48015,Pied-de-Borne,184,176,8
76,48,214800161,48016,Balsièges,584,566,18
76,48,200054484,48017,Banassac-Canilhac,1114,1078,36
76,48,214800187,48018,Barjac,792,773,19
76,48,214800195,48019,Barre-des-Cévennes,211,204,7
76,48,214800203,48020,Bassurels,67,67,0
76,48,214800211,48021,La Bastide-Puylaurent,167,162,5
76,48,214800252,48025,Les Bessons,444,420,24
76,48,214800260,48026,Blavignac,267,266,1
76,48,200062545,48027,Mont Lozère et Goulet,1092,1062,30
76,48,214800286,48028,Les Bondons,152,145,7
76,48,214800294,48029,Le Born,154,151,3
76,48,214800302,48030,Brenoux,396,389,7
76,48,214800310,48031,Brion,84,80,4
76,48,214800328,48032,Le Buisson,226,220,6
76,48,214800344,48034,La Canourgue,2197,2099,98
76,48,214800369,48036,Cassagnas,127,125,2
76,48,214800377,48037,Chadenet,121,120,1
76,48,200083343,48038,Bel-Air-Val-d'Ance,552,545,7
76,48,214800393,48039,Chanac,1496,1452,44
76,48,214800419,48041,Chastanier,79,77,2
76,48,214800427,48042,Chastel-Nouvel,952,918,34
76,48,214800435,48043,Châteauneuf-de-Randon,531,524,7
76,48,214800443,48044,Chauchailles,87,85,2
76,48,214800450,48045,Chaudeyrac,300,291,9
76,48,214800468,48046,Chaulhac,68,64,4
76,48,214800484,48048,Cheylard-l'Évêque,65,63,2
76,48,200057560,48050,Bédouès-Cocurès,463,451,12
76,48,214800518,48051,Le Collet-de-Dèze,734,686,48
76,48,214800534,48053,Cubières,201,193,8
76,48,214800542,48054,Cubiérettes,53,48,5
76,48,214800559,48055,Cultures,194,190,4
76,48,214800567,48056,Esclanèdes,419,411,8
76,48,214800583,48058,La Fage-Montivernoux,152,148,4
76,48,214800591,48059,La Fage-Saint-Julien,314,306,8
76,48,200056927,48061,Florac Trois Rivières,2136,2082,54
76,48,214800633,48063,Fontans,234,231,3
76,48,214800641,48064,Fournels,376,369,7
76,48,214800658,48065,Fraissinet-de-Fourques,80,80,0
76,48,214800674,48067,Gabriac,102,100,2
76,48,214800682,48068,Gabrias,166,160,6
76,48,214800690,48069,Gatuzières,52,52,0
76,48,214800708,48070,Grandrieu,769,751,18
76,48,214800716,48071,Grandvals,64,63,1
76,48,214800724,48072,Grèzes,242,236,6
76,48,214800732,48073,Les Hermaux,96,94,2
76,48,214800740,48074,Hures-la-Parade,237,226,11
76,48,214800757,48075,Ispagnac,925,900,25
76,48,214800773,48077,Julianges,49,47,2
76,48,214800799,48079,Lajo,119,116,3
76,48,214800807,48080,Langogne,3069,2875,194
76,48,214800815,48081,Lanuéjols,343,334,9
76,48,214800823,48082,Laubert,102,100,2
76,48,214800831,48083,Les Laubies,154,151,3
76,48,214800856,48085,Laval-du-Tarn,97,93,4
76,48,214800864,48086,Luc,213,206,7
76,48,200064186,48087,Prinsuéjols-Malbouzon,274,264,10
76,48,214800880,48088,La Malène,139,134,5
76,48,214800898,48089,Le Malzieu-Forain,507,497,10
76,48,214800906,48090,Le Malzieu-Ville,753,735,18
76,48,214800914,48091,Marchastel,49,46,3
76,48,214800922,48092,Marvejols,4956,4713,243
76,48,200072619,48094,Massegros Causses Gorges,972,944,28
76,48,214800955,48095,Mende,13143,12336,807
76,48,214800963,48096,Meyrueis,907,794,113
76,48,214800971,48097,Moissac-Vallée-Française,227,217,10
76,48,214800989,48098,Molezon,101,97,4
76,48,200058501,48099,Bourgs sur Colagne,2137,2091,46
76,48,214801003,48100,Montbel,128,127,1
76,48,214801037,48103,Montrodat,1245,1176,69
76,48,214801045,48104,Nasbinals,597,564,33
76,48,200054534,48105,Naussac-Fontanes,388,373,15
76,48,214801060,48106,Noalhac,102,95,7
76,48,214801078,48107,Palhers,182,177,5
76,48,214801086,48108,La Panouse,78,76,2
76,48,214801102,48110,Paulhac-en-Margeride,106,102,4
76,48,214801110,48111,Pelouse,240,235,5
76,48,214801128,48112,Pierrefiche,167,164,3
76,48,214801151,48115,Le Pompidou,170,166,4
76,48,200057594,48116,Pont de Montvert - Sud Mont Lozère,572,554,18
76,48,214801177,48117,Pourcharesses,127,123,4
76,48,214801193,48119,Prévenchères,265,257,8
76,48,214801219,48121,Prunières,241,231,10
76,48,214801235,48123,Recoules-d'Aubrac,175,169,6
76,48,214801243,48124,Recoules-de-Fumas,104,103,1
76,48,200083335,48126,Lachamp-Ribennes,374,363,11
76,48,200085223,48127,Monts-de-Randon,1289,1264,25
76,48,214801284,48128,Rimeize,617,597,20
76,48,214801292,48129,Rocles,231,227,4
76,48,214801300,48130,Rousses,129,127,2
76,48,214801318,48131,Le Rozier,139,132,7
76,48,214801326,48132,Saint-Alban-sur-Limagnole,1411,1378,33
76,48,214801359,48135,Saint-André-Capcèze,192,190,2
76,48,214801367,48136,Saint-André-de-Lancize,156,154,2
76,48,214801375,48137,Saint-Bauzile,632,612,20
76,48,214801383,48138,Saint-Bonnet-de-Chirac,69,67,2
76,48,200064673,48139,Saint Bonnet-Laval,255,253,2
76,48,214801409,48140,Saint-Chély-d'Apcher,4814,4220,594
76,48,214801417,48141,Mas-Saint-Chély,111,105,6
76,48,214801441,48144,Sainte-Croix-Vallée-Française,289,284,5
76,48,214801458,48145,Saint-Denis-en-Margeride,160,153,7
76,48,200063147,48146,Gorges du Tarn Causses,938,905,33
76,48,214801474,48147,Saint-Étienne-du-Valdonnez,690,640,50
76,48,214801482,48148,Saint-Étienne-Vallée-Française,526,502,24
76,48,214801490,48149,Sainte-Eulalie,37,35,2
76,48,214801508,48150,Saint-Flour-de-Mercoire,200,186,14
76,48,214801516,48151,Saint-Frézal-d'Albuges,63,60,3
76,48,200058410,48152,Ventalon en Cévennes,268,263,5
76,48,214801532,48153,Saint-Gal,93,88,5
76,48,214801557,48155,Saint-Germain-de-Calberte,476,468,8
76,48,214801565,48156,Saint-Germain-du-Teil,883,860,23
76,48,214801573,48157,Sainte-Hélène,106,104,2
76,48,214801581,48158,Saint-Hilaire-de-Lavit,103,98,5
76,48,214801607,48160,Saint-Jean-la-Fouillouse,152,146,6
76,48,214801615,48161,Saint-Juéry,66,64,2
76,48,214801631,48163,Saint-Julien-des-Points,120,117,3
76,48,214801656,48165,Saint-Laurent-de-Muret,196,187,9
76,48,200056851,48166,Cans et Cévennes,302,290,12
76,48,214801672,48167,Saint-Laurent-de-Veyrès,38,37,1
76,48,214801680,48168,Saint-Léger-de-Peyre,195,190,5
76,48,214801698,48169,Saint-Léger-du-Malzieu,218,207,11
76,48,214801706,48170,Saint-Martin-de-Boubaux,201,196,5
76,48,214801714,48171,Saint-Martin-de-Lansuscle,195,193,2
76,48,214801730,48173,Saint-Michel-de-Dèze,232,229,3
76,48,214801748,48174,Saint-Paul-le-Froid,143,139,4
76,48,214801755,48175,Saint-Pierre-de-Nogaret,183,174,9
76,48,214801763,48176,Saint-Pierre-des-Tripiers,95,91,4
76,48,214801771,48177,Saint-Pierre-le-Vieux,328,319,9
76,48,214801789,48178,Saint-Privat-de-Vallongue,230,223,7
76,48,214801797,48179,Saint-Privat-du-Fau,111,109,2
76,48,214801813,48181,Saint-Saturnin,66,62,4
76,48,214801821,48182,Saint-Sauveur-de-Ginestoux,58,58,0
76,48,214801854,48185,Les Salelles,171,166,5
76,48,214801870,48187,Les Salces,104,103,1
76,48,214801888,48188,Serverette,250,246,4
76,48,214801904,48190,Termes,225,217,8
76,48,214801912,48191,La Tieule,98,95,3
76,48,214801920,48192,Trélans,92,91,1
76,48,214801938,48193,Vebron,216,216,0
76,48,214801946,48194,Vialas,469,429,40
76,48,214801987,48198,Villefort,586,570,16
52,49,214900029,49002,Allonnes,2996,2947,49
52,49,200058949,49003,Tuffalun,1780,1743,37
52,49,214900078,49007,Angers,159103,155876,3227
52,49,214900086,49008,Angrie,946,922,24
52,49,214900094,49009,Antoigné,464,460,4
52,49,214900102,49010,Armaillé,324,319,5
52,49,214900110,49011,Artannes-sur-Thouet,429,422,7
52,49,214900128,49012,Aubigné-sur-Layon,372,365,7
52,49,214900151,49015,Avrillé,15118,14727,391
52,49,214900177,49017,Baracé,614,612,2
52,49,200052702,49018,Baugé-en-Anjou,11978,11735,243
52,49,214900201,49020,Beaucouzé,5635,5528,107
52,49,200058899,49021,Beaufort-en-Anjou,7242,7096,146
52,49,214900227,49022,Beaulieu-sur-Layon,1388,1359,29
52,49,200053619,49023,Beaupréau-en-Mauges,24167,23465,702
52,49,214900268,49026,Bécon-les-Granits,2874,2784,90
52,49,214900276,49027,Bégrolles-en-Mauges,2167,2126,41
52,49,214900284,49028,Béhuard,132,126,6
52,49,200056265,49029,Blaison-Saint-Sulpice,1331,1302,29
52,49,214900300,49030,Blou,987,955,32
52,49,214900359,49035,Bouchemaine,6897,6757,140
52,49,214900367,49036,Bouillé-Ménard,772,755,17
52,49,214900383,49038,Bourg-l'Évêque,238,234,4
52,49,214900417,49041,Brain-sur-Allonnes,2082,2046,36
52,49,214900458,49045,La Breille-les-Pins,613,600,13
52,49,214900482,49048,Briollay,3170,3129,41
52,49,200064582,49050,Brissac Loire Aubance,11179,10906,273
52,49,214900532,49053,Brossay,352,347,5
52,49,214900540,49054,Candé,2870,2821,49
52,49,214900557,49055,Cantenay-Épinard,2398,2362,36
52,49,214900565,49056,Carbay,270,267,3
52,49,214900573,49057,Cernusson,340,334,6
52,49,214900581,49058,Les Cerqueux,890,883,7
52,49,200082576,49060,Bellevigne-les-Châteaux,3550,3471,79
52,49,214900615,49061,Challain-la-Potherie,810,795,15
52,49,214900631,49063,Chalonnes-sur-Loire,6649,6475,174
52,49,214900649,49064,Chambellay,406,394,12
52,49,200059632,49067,Chenillé-Champteussé,348,342,6
52,49,214900680,49068,Champtocé-sur-Loire,1886,1855,31
52,49,200056158,49069,Orée d'Anjou,16776,16468,308
52,49,214900706,49070,Chanteloup-les-Bois,702,692,10
52,49,214900763,49076,La Chapelle-Saint-Laud,793,782,11
52,49,200084903,49080,Les Hauts-d'Anjou,8895,8743,152
52,49,214900821,49082,Chaudefonds-sur-Layon,949,932,17
52,49,200067718,49086,Terranjou,4023,3950,73
52,49,214900896,49089,Chazé-sur-Argos,1080,1052,28
52,49,214900904,49090,Cheffes,1003,995,8
52,49,200053593,49092,Chemillé-en-Anjou,21811,21187,624
52,49,214900995,49099,Cholet,56286,54357,1929
52,49,214901001,49100,Cizay-la-Madeleine,487,470,17
52,49,214901027,49102,Cléré-sur-Layon,346,341,5
52,49,214901076,49107,Cornillé-les-Caves,486,471,15
52,49,214901092,49109,Coron,1595,1566,29
52,49,214901100,49110,Corzé,1940,1907,33
52,49,214901126,49112,Le Coudray-Macouard,988,961,27
52,49,214901134,49113,Courchamps,536,527,9
52,49,214901142,49114,Courléon,146,142,4
52,49,214901209,49120,Denée,1434,1405,29
52,49,214901217,49121,Dénezé-sous-Doué,472,464,8
52,49,214901233,49123,Distré,1802,1746,56
52,49,200065225,49125,Doué-en-Anjou,11472,11224,248
52,49,214901274,49127,Durtal,3417,3343,74
52,49,214901290,49129,Écouflant,4513,4454,59
52,49,214901308,49130,Écuillé,680,673,7
52,49,214901316,49131,Épieds,727,720,7
52,49,214901324,49132,Étriché,1565,1548,17
52,49,214901357,49135,Feneu,2228,2188,40
52,49,200053213,49138,Les Bois d'Anjou,2626,2574,52
52,49,214901407,49140,Fontevraud-l'Abbaye,1538,1515,23
52,49,214901555,49155,Grez-Neuville,1463,1423,40
52,49,200060184,49160,Ingrandes-Le Fresne sur Loire,2747,2687,60
52,49,214901613,49161,La Jaille-Yvon,348,342,6
52,49,200058923,49163,Jarzé Villages,2797,2766,31
52,49,200064608,49167,Les Garennes sur Loire,4723,4614,109
52,49,214901704,49170,Juvardeil,826,814,12
52,49,214901712,49171,La Lande-Chasles,124,122,2
52,49,200085504,49174,Huillé-Lézigné,1340,1318,22
52,49,200053239,49176,Le Lion-d'Angers,5278,5201,77
52,49,214901787,49178,Loiré,903,882,21
52,49,214901803,49180,Longué-Jumelles,6865,6759,106
52,49,214901829,49182,Louresse-Rochemenier,909,893,16
52,49,200066207,49183,Val d'Erdre-Auxence,4987,4908,79
52,49,214901886,49188,Marcé,851,836,15
52,49,214901928,49192,Maulévrier,3283,3204,79
52,49,214901936,49193,Le May-sur-Èvre,3918,3827,91
52,49,200058873,49194,Mazé-Milon,5952,5860,92
52,49,214901951,49195,Mazières-en-Mauges,1295,1265,30
52,49,200056091,49200,Longuenée-en-Anjou,6506,6334,172
52,49,214902017,49201,La Ménitré,2082,2043,39
52,49,214902058,49205,Miré,1009,999,10
52,49,214902090,49209,Montigné-lès-Rairies,449,446,3
52,49,214902116,49211,Montilliers,1240,1220,20
52,49,214902140,49214,Montreuil-Juigné,7942,7791,151
52,49,214902157,49215,Montreuil-Bellay,3955,3705,250
52,49,214902165,49216,Montreuil-sur-Loir,590,581,9
52,49,214902173,49217,Montreuil-sur-Maine,780,770,10
52,49,200054302,49218,Montrevault-sur-Èvre,16038,15732,306
52,49,214902199,49219,Montsoreau,429,423,6
52,49,200064566,49220,Morannes sur Sarthe-Daumeray,3714,3669,45
52,49,214902215,49221,Mouliherne,831,808,23
52,49,214902223,49222,Mozé-sur-Louet,2073,2028,45
52,49,214902231,49223,Mûrs-Erigné,5760,5661,99
52,49,214902249,49224,Neuillé,999,988,11
52,49,200070050,49228,Noyant-Villages,5646,5529,117
52,49,214902314,49231,Nuaillé,1481,1443,38
52,49,214902355,49235,Parnay,414,408,6
52,49,214902363,49236,Passavant-sur-Layon,129,127,2
52,49,214902371,49237,La Pellerine,131,129,2
52,49,214902405,49240,La Plaine,1031,1000,31
52,49,214902413,49241,Le Plessis-Grammoire,2645,2594,51
52,49,200054336,49244,Mauges-sur-Loire,18559,18083,476
52,49,214902462,49246,Les Ponts-de-Cé,13123,12589,534
52,49,214902470,49247,La Possonnière,2490,2448,42
52,49,200069474,49248,Ombrée d'Anjou,9117,8908,209
52,49,214902538,49253,Le Puy-Notre-Dame,1177,1154,23
52,49,214902579,49257,Les Rairies,1047,1033,14
52,49,214902595,49259,Rochefort-sur-Loire,2363,2307,56
52,49,214902603,49260,La Romagne,2044,1961,83
52,49,200075547,49261,Gennes-Val-de-Loire,8647,8480,167
52,49,214902629,49262,Rou-Marson,673,649,24
52,49,214902660,49266,Saint-Augustin-des-Bois,1276,1247,29
52,49,214902678,49267,Saint-Barthélemy-d'Anjou,9433,9207,226
52,49,214902694,49269,Saint-Christophe-du-Bois,2934,2873,61
52,49,214902710,49271,Saint-Clément-de-la-Place,2122,2094,28
52,49,214902728,49272,Saint-Clément-des-Levées,1112,1097,15
52,49,214902785,49278,Sainte-Gemmes-sur-Loire,3768,3515,253
52,49,214902835,49283,Saint-Georges-sur-Loire,3746,3706,40
52,49,214902843,49284,Saint-Germain-des-Prés,1422,1402,20
52,49,214902884,49288,Saint-Jean-de-la-Croix,230,224,6
52,49,214902918,49291,Saint-Just-sur-Dive,379,375,4
52,49,200056034,49292,Val-du-Layon,3503,3455,48
52,49,214902942,49294,Saint-Lambert-la-Potherie,2962,2932,30
52,49,200082550,49298,Saint-Léger-de-Linières,3814,3749,65
52,49,214902991,49299,Saint-Léger-sous-Cholet,3133,3062,71
52,49,200054385,49301,Sèvremoine,26095,25519,576
52,49,214903023,49302,Saint-Macaire-du-Bois,454,449,5
52,49,214903064,49306,Saint-Martin-du-Fouilloux,1704,1668,36
52,49,200057438,49307,Loire-Authion,16858,16293,565
52,49,214903080,49308,Saint-Melaine-sur-Aubance,2226,2172,54
52,49,214903106,49310,Saint-Paul-du-Bois,620,601,19
52,49,214903114,49311,Saint-Philbert-du-Peuple,1355,1328,27
52,49,214903213,49321,Saint-Sigismond,398,390,8
52,49,200056679,49323,Verrières-en-Anjou,7836,7534,302
52,49,214903262,49326,Sarrigné,848,829,19
52,49,214903288,49328,Saumur,27112,26154,958
52,49,214903296,49329,Savennières,1387,1337,50
52,49,214903304,49330,Sceaux-d'Anjou,1190,1174,16
52,49,200065423,49331,Segré-en-Anjou Bleu,18478,17660,818
52,49,214903320,49332,La Séguinière,4328,4212,116
52,49,214903338,49333,Seiches-sur-le-Loir,2937,2879,58
52,49,214903346,49334,Sermaise,337,332,5
52,49,214903361,49336,Somloire,889,872,17
52,49,214903387,49338,Soulaines-sur-Aubance,1419,1399,20
52,49,214903395,49339,Soulaire-et-Bourg,1530,1491,39
52,49,214903411,49341,Souzay-Champigny,747,730,17
52,49,214903437,49343,La Tessoualle,3269,3195,74
52,49,214903445,49344,Thorigné-d'Anjou,1275,1252,23
52,49,200055218,49345,Bellevigne-en-Layon,5897,5780,117
52,49,214903478,49347,Tiercé,4542,4470,72
52,49,214903528,49352,Toutlemonde,1350,1316,34
52,49,214903536,49353,Trélazé,15241,15056,185
52,49,214903551,49355,Trémentines,3164,3085,79
52,49,214903585,49358,Turquant,586,572,14
52,49,214903593,49359,Les Ulmes,590,574,16
52,49,214903619,49361,Varennes-sur-Loire,1887,1859,28
52,49,214903627,49362,Varrains,1270,1241,29
52,49,214903643,49364,Vaudelnay,1143,1122,21
52,49,200059582,49367,Erdre-en-Anjou,5840,5759,81
52,49,214903684,49368,Vernantes,2032,1993,39
52,49,214903692,49369,Vernoil-le-Fourrier,1300,1278,22
52,49,214903700,49370,Verrie,482,473,9
52,49,214903718,49371,Vezins,1761,1733,28
52,49,200059475,49373,Lys-Haut-Layon,7917,7748,169
52,49,214903742,49374,Villebernier,1470,1438,32
52,49,200084283,49377,Rives-du-Loir-en-Anjou,5731,5642,89
52,49,214903783,49378,Vivy,2580,2545,35
52,49,214903817,49381,Yzernay,1852,1821,31
28,50,215000027,50002,Agneaux,4677,4245,432
28,50,215000035,50003,Agon-Coutainville,2933,2869,64
28,50,215000043,50004,Airel,555,552,3
28,50,215000068,50006,Amigny,159,154,5
28,50,215000084,50008,Anctoville-sur-Boscq,458,439,19
28,50,215000134,50013,Anneville-en-Saire,392,384,8
28,50,215000167,50016,Appeville,186,184,2
28,50,215000191,50019,Aucey-la-Plaine,421,415,6
28,50,215000217,50021,Audouville-la-Hubert,77,76,1
28,50,215000225,50022,Aumeville-Lestre,113,110,3
28,50,215000233,50023,Auvers,701,691,10
28,50,215000241,50024,Auxais,169,166,3
28,50,200083640,50025,Avranches,10785,10277,508
28,50,215000266,50026,Azeville,79,78,1
28,50,215000274,50027,Bacilly,992,963,29
28,50,215000282,50028,La Baleine,109,106,3
28,50,215000290,50029,Barenton,1241,1176,65
28,50,215000308,50030,Barfleur,562,553,9
28,50,215000316,50031,Barneville-Carteret,2268,2214,54
28,50,215000324,50032,La Barre-de-Semilly,1065,1034,31
28,50,215000332,50033,Baubigny,142,138,4
28,50,215000340,50034,Baudre,579,560,19
28,50,215000365,50036,Baupte,450,439,11
28,50,215000381,50038,Beauchamps,441,430,11
28,50,215000399,50039,Beaucoudray,132,129,3
28,50,215000407,50040,Beauficel,125,119,6
28,50,200065415,50041,La Hague,11576,11257,319
28,50,215000423,50042,Beauvoir,448,442,6
28,50,215000449,50044,Belval,333,325,8
28,50,215000456,50045,Benoîtville,632,610,22
28,50,215000464,50046,Bérigny,441,432,9
28,50,215000480,50048,Beslon,564,555,9
28,50,215000498,50049,Besneville,677,658,19
28,50,215000506,50050,Beuvrigny,140,135,5
28,50,215000522,50052,Beuzeville-la-Bastille,147,145,2
28,50,215000548,50054,Biéville,195,191,4
28,50,215000555,50055,Biniville,115,113,2
28,50,215000589,50058,Blainville-sur-Mer,1649,1604,45
28,50,215000597,50059,Blosville,327,326,1
28,50,215000605,50060,La Bloutière,453,445,8
28,50,215000621,50062,Boisyvon,112,110,2
28,50,215000647,50064,La Bonneville,186,180,6
28,50,215000662,50066,Jullouville,2475,2396,79
28,50,215000696,50069,Bourguenolles,356,345,11
28,50,215000704,50070,Boutteville,70,69,1
28,50,215000720,50072,Brainville,216,210,6
28,50,215000746,50074,Brécey,2313,2168,145
28,50,215000761,50076,Bréhal,3542,3463,79
28,50,215000779,50077,Bretteville,1070,1027,43
28,50,215000787,50078,Bretteville-sur-Ay,428,421,7
28,50,215000795,50079,Breuville,411,402,9
28,50,215000811,50081,Bréville-sur-Mer,808,779,29
28,50,200057297,50082,Bricquebec-en-Cotentin,5936,5847,89
28,50,215000837,50083,Bricquebosq,645,638,7
28,50,215000845,50084,Bricqueville-la-Blouette,557,538,19
28,50,215000852,50085,Bricqueville-sur-Mer,1284,1241,43
28,50,215000860,50086,Brillevast,331,323,8
28,50,215000878,50087,Brix,2198,2152,46
28,50,215000886,50088,Brouains,138,136,2
28,50,200057511,50090,Buais-Les-Monts,620,610,10
28,50,215000928,50092,Cambernon,719,703,16
28,50,215000936,50093,Cametours,434,425,9
28,50,215000944,50094,Camprond,420,411,9
28,50,200063543,50095,Canisy,1803,1748,55
28,50,215000969,50096,Canteloup,217,209,8
28,50,215000977,50097,Canville-la-Rocque,123,121,2
28,50,215000985,50098,Carantilly,633,619,14
28,50,200085579,50099,Carentan-les-Marais,10389,10227,162
28,50,215001017,50101,Carneville,238,232,6
28,50,215001025,50102,Carolles,764,748,16
28,50,215001058,50105,Catteville,101,96,5
28,50,215001066,50106,Cavigny,273,268,5
28,50,215001082,50108,Céaux,427,415,12
28,50,215001090,50109,Cérences,1809,1771,38
28,50,215001108,50110,Cerisy-la-Forêt,1054,1035,19
28,50,215001116,50111,Cerisy-la-Salle,1025,1009,16
28,50,215001124,50112,La Chaise-Baudouin,466,460,6
28,50,200057396,50115,Le Grippon,395,384,11
28,50,215001173,50117,Champeaux,357,347,10
28,50,215001181,50118,Champrepus,328,324,4
28,50,215001207,50120,Chanteloup,369,365,4
28,50,215001215,50121,La Chapelle-Cécelin,245,241,4
28,50,215001249,50124,La Chapelle-Urée,171,169,2
28,50,215001264,50126,Chavoy,141,135,6
28,50,200056844,50129,Cherbourg-en-Cotentin,80082,77789,2293
28,50,215001306,50130,Chérencé-le-Héron,437,432,5
28,50,215001355,50135,Clitourps,229,226,3
28,50,215001371,50137,La Colombe,643,628,15
28,50,215001389,50138,Colomby,563,554,9
28,50,200063592,50139,Condé-sur-Vire,4227,4076,151
28,50,200057362,50142,Vicq-sur-Mer,1077,1064,13
28,50,215001439,50143,Coudeville-sur-Mer,901,868,33
28,50,215001447,50144,Coulouvray-Boisbenâtre,534,530,4
28,50,215001454,50145,Courcy,604,591,13
28,50,215001462,50146,Courtils,239,237,2
28,50,215001470,50147,Coutances,9554,8380,1174
28,50,215001488,50148,Couvains,563,559,4
28,50,215001496,50149,Couville,1204,1186,18
28,50,215001504,50150,Crasville,228,226,2
28,50,215001512,50151,Créances,2108,2078,30
28,50,215001520,50152,Les Cresnays,230,227,3
28,50,215001553,50155,Crollon,309,296,13
28,50,215001561,50156,Crosville-sur-Douve,65,65,0
28,50,215001587,50158,Cuves,285,277,8
28,50,215001595,50159,Dangy,698,684,14
28,50,215001611,50161,Le Dézert,604,601,3
28,50,215001629,50162,Digosville,1666,1623,43
28,50,215001645,50164,Domjean,1027,1001,26
28,50,215001652,50165,Donville-les-Bains,3154,3081,73
28,50,215001660,50166,Doville,341,326,15
28,50,215001678,50167,Dragey-Ronthon,816,795,21
28,50,200056521,50168,Ducey-Les Chéris,2886,2827,59
28,50,215001694,50169,Écausseville,108,106,2
28,50,215001728,50172,Émondeville,357,349,8
28,50,215001744,50174,Équilly,203,195,8
28,50,215001751,50175,Éroudeville,198,190,8
28,50,215001769,50176,L'Étang-Bertrand,367,353,14
28,50,215001777,50177,Étienville,381,376,5
28,50,215001785,50178,Fermanville,1305,1272,33
28,50,215001819,50181,Feugères,351,338,13
28,50,215001827,50182,La Feuillie,302,296,6
28,50,215001835,50183,Fierville-les-Mines,356,350,6
28,50,215001843,50184,Flamanville,1789,1767,22
28,50,215001850,50185,Fleury,1078,1054,24
28,50,215001868,50186,Flottemanville,227,219,8
28,50,215001884,50188,Folligny,1121,1094,27
28,50,215001900,50190,Fontenay-sur-Mer,171,168,3
28,50,215001926,50192,Fourneaux,130,130,0
28,50,215001934,50193,Le Fresne-Poret,222,219,3
28,50,215001942,50194,Fresville,378,372,6
28,50,215001959,50195,Gathemo,263,261,2
28,50,215001967,50196,Gatteville-le-Phare,492,483,9
28,50,200085934,50197,Gavray-sur-Sienne,2006,1980,26
28,50,215001983,50198,Geffosses,497,486,11
28,50,215001991,50199,Genêts,457,453,4
28,50,215002007,50200,Ger,818,806,12
28,50,215002056,50205,La Godefroy,291,285,6
28,50,215002072,50207,Golleville,177,172,5
28,50,215002080,50208,Gonfreville,161,160,1
28,50,200057198,50209,Gonneville-Le Theil,1558,1515,43
28,50,215002106,50210,Gorges,349,341,8
28,50,215002148,50214,Gouvets,287,281,6
28,50,200085405,50215,Gouville-sur-Mer,3311,3241,70
28,50,200007839,50216,Graignes-Mesnil-Angot,895,801,94
28,50,215002171,50217,Le Grand-Celland,615,604,11
28,50,215002189,50218,Granville,13230,12558,672
28,50,215002197,50219,Gratot,678,666,12
28,50,215002213,50221,Grimesnil,63,63,0
28,50,215002221,50222,Grosville,811,790,21
28,50,215002254,50225,Le Guislain,147,146,1
28,50,215002270,50227,Le Ham,318,312,6
28,50,215002288,50228,Hambye,1113,1082,31
28,50,215002296,50229,Hamelin,94,94,0
28,50,215002304,50230,Hardinvast,926,897,29
28,50,215002312,50231,Hauteville-sur-Mer,712,693,19
28,50,215002320,50232,Hauteville-la-Guichard,494,477,17
28,50,215002338,50233,Hautteville-Bocage,162,157,5
28,50,215002346,50234,La Haye-Bellefond,75,75,0
28,50,215002353,50235,La Haye-d'Ectot,277,272,5
28,50,200055986,50236,La Haye,4078,3958,120
28,50,215002379,50237,La Haye-Pesnel,1289,1266,23
28,50,215002387,50238,Héauville,463,457,6
28,50,200056828,50239,Thèreval,1838,1793,45
28,50,215002403,50240,Helleville,566,558,8
28,50,215002411,50241,Hémevez,186,182,4
28,50,215002437,50243,Heugueville-sur-Sienne,488,473,15
28,50,215002460,50246,Hiesville,72,71,1
28,50,215002478,50247,Hocquigny,195,190,5
28,50,215002510,50251,Huberville,373,363,10
28,50,215002528,50252,Hudimesnil,933,914,19
28,50,215002536,50253,Huisnes-sur-Mer,176,169,7
28,50,215002569,50256,Isigny-le-Buat,3267,3170,97
28,50,215002585,50258,Joganville,104,103,1
28,50,215002593,50259,Juilley,665,640,25
28,50,200063261,50260,Juvigny les Vallées,1722,1683,39
28,50,215002619,50261,Lamberville,169,167,2
28,50,215002627,50262,La Lande-d'Airou,538,532,6
28,50,215002635,50263,Lapenty,380,370,10
28,50,215002650,50265,Laulne,194,193,1
28,50,215002668,50266,Lengronne,433,430,3
28,50,200053890,50267,Lessay,2294,2240,54
28,50,215002684,50268,Lestre,250,248,2
28,50,215002692,50269,Liesville-sur-Douve,213,207,6
28,50,215002700,50270,Lieusaint,413,401,12
28,50,215002718,50271,Lingeard,88,87,1
28,50,200098713,50272,Tourneville-sur-Mer,1696,1664,32
28,50,200055911,50273,Montsenelle,1433,1413,20
28,50,215002742,50274,Les Loges-Marchis,1169,1016,153
28,50,215002759,50275,Les Loges-sur-Brécey,128,122,6
28,50,215002767,50276,Lolif,614,593,21
28,50,215002775,50277,Longueville,602,587,15
28,50,215002783,50278,Le Loreur,282,276,6
28,50,215002791,50279,Le Lorey,614,599,15
28,50,215002817,50281,La Lucerne-d'Outremer,800,781,19
28,50,215002825,50282,Le Luot,315,306,9
28,50,215002833,50283,La Luzerne,77,76,1
28,50,215002858,50285,Magneville,316,312,4
28,50,215002882,50288,Marcey-les-Grèves,1325,1302,23
28,50,215002890,50289,Marchésieux,735,723,12
28,50,215002908,50290,Marcilly,342,334,8
28,50,215002916,50291,Margueray,120,116,4
28,50,200058220,50292,Marigny-Le-Lozon,2781,2723,58
28,50,215002940,50294,Martinvast,1363,1325,38
28,50,215002957,50295,Maupertuis,147,145,2
28,50,215002965,50296,Maupertus-sur-Mer,230,221,9
28,50,215002973,50297,La Meauffe,1039,1009,30
28,50,215002981,50298,Méautis,658,644,14
28,50,215002999,50299,Le Mesnil,227,220,7
28,50,215003005,50300,Le Mesnil-Adelée,169,162,7
28,50,215003021,50302,Le Mesnil-Amey,293,286,7
28,50,215003047,50304,Le Mesnil-Aubert,199,195,4
28,50,215003054,50305,Le Mesnil-au-Val,743,727,16
28,50,215003104,50310,Le Mesnil-Eury,169,165,4
28,50,215003112,50311,Le Mesnil-Garnier,233,225,8
28,50,215003120,50312,Le Mesnil-Gilbert,138,134,4
28,50,215003153,50315,Le Mesnillard,254,247,7
28,50,215003179,50317,Le Mesnil-Ozenne,280,277,3
28,50,215003211,50321,Le Mesnil-Rouxelin,502,490,12
28,50,215003245,50324,Le Mesnil-Véneron,113,111,2
28,50,215003260,50326,Le Mesnil-Villeman,235,234,1
28,50,215003278,50327,La Meurdraquière,199,193,6
28,50,215003286,50328,Millières,778,765,13
28,50,215003328,50332,Les Moitiers-d'Allonne,731,716,15
28,50,215003344,50334,Montabot,276,273,3
28,50,215003351,50335,Montaigu-la-Brisette,505,496,9
28,50,215003369,50336,Montaigu-les-Bois,224,221,3
28,50,215003385,50338,Montbray,300,296,4
28,50,215003401,50340,Montcuit,192,188,4
28,50,215003419,50341,Montebourg,2177,2051,126
28,50,215003427,50342,Montfarville,826,799,27
28,50,215003450,50345,Monthuchon,716,696,20
28,50,215003476,50347,Montjoie-Saint-Martin,244,239,5
28,50,215003492,50349,Montmartin-sur-Mer,1428,1393,35
28,50,215003500,50350,Montpinchon,531,525,6
28,50,215003518,50351,Montrabot,98,96,2
28,50,215003526,50352,Montreuil-sur-Lozon,344,337,7
28,50,215003534,50353,Le Mont-Saint-Michel,28,27,1
28,50,215003567,50356,Moon-sur-Elle,806,785,21
28,50,215003575,50357,Morigny,72,71,1
28,50,200058279,50359,Mortain-Bocage,3139,2932,207
28,50,215003609,50360,Morville,291,279,12
28,50,215003617,50361,La Mouche,249,244,5
28,50,215003625,50362,Moulines,287,282,5
28,50,200053908,50363,Moyon Villages,1478,1443,35
28,50,215003641,50364,Muneville-le-Bingard,728,715,13
28,50,215003658,50365,Muneville-sur-Mer,511,500,11
28,50,215003682,50368,Nay,69,67,2
28,50,215003690,50369,Négreville,849,824,25
28,50,215003708,50370,Néhou,612,608,4
28,50,215003716,50371,Le Neufbourg,417,404,13
28,50,215003724,50372,Neufmesnil,181,178,3
28,50,215003732,50373,Neuville-au-Plain,91,87,4
28,50,215003740,50374,Neuville-en-Beaumont,27,26,1
28,50,215003765,50376,Nicorps,391,378,13
28,50,215003781,50378,Notre-Dame-de-Cenilly,640,630,10
28,50,215003799,50379,Notre-Dame-de-Livoye,164,161,3
28,50,215003823,50382,Nouainville,651,633,18
28,50,215003849,50384,Octeville-l'Avenel,232,225,7
28,50,215003872,50387,Orglandes,361,354,7
28,50,200056430,50388,Orval sur Sienne,1205,1172,33
28,50,215003898,50389,Ouville,450,438,12
28,50,215003906,50390,Ozeville,157,154,3
28,50,200053973,50391,Grandparigny,2709,2635,74
28,50,200057214,50393,Percy-en-Normandie,2709,2605,104
28,50,215003948,50394,Périers,2274,2244,30
28,50,215003955,50395,La Pernelle,281,277,4
28,50,215003971,50397,Perriers-en-Beauficel,213,207,6
28,50,215003989,50398,Le Perron,202,200,2
28,50,215003997,50399,Le Petit-Celland,179,176,3
28,50,200063139,50400,Picauville,3294,3251,43
28,50,215004011,50401,Pierreville,761,746,15
28,50,215004029,50402,Les Pieux,3332,3244,88
28,50,215004037,50403,Pirou,1466,1429,37
28,50,215004052,50405,Le Plessis-Lastelle,248,240,8
28,50,215004078,50407,Poilley,978,942,36
28,50,215004086,50408,Pontaubault,589,576,13
28,50,200077360,50409,Pont-Hébert,2121,1915,206
28,50,200054856,50410,Pontorson,4427,4352,75
28,50,215004110,50411,Ponts,689,680,9
28,50,200086593,50412,Port-Bail-sur-Mer,2608,2545,63
28,50,215004136,50413,Précey,589,584,5
28,50,200086551,50417,Quettehou,1802,1773,29
28,50,200082378,50419,Quettreville-sur-Sienne,3267,3195,72
28,50,215004201,50420,Quibou,877,854,23
28,50,215004219,50421,Quinéville,271,265,6
28,50,215004227,50422,Raids,193,193,0
28,50,215004235,50423,Rampan,215,210,5
28,50,215004250,50425,Rauville-la-Bigot,1123,1097,26
28,50,215004268,50426,Rauville-la-Place,372,366,6
28,50,215004284,50428,Reffuveille,518,512,6
28,50,215004292,50429,Regnéville-sur-Mer,771,739,32
28,50,215004300,50430,Reigneville-Bocage,44,41,3
28,50,200063998,50431,Remilly Les Marais,1071,1059,12
28,50,215004334,50433,Réville,1037,1014,23
28,50,215004359,50435,Rocheville,612,596,16
28,50,200057172,50436,Romagny Fontenay,1313,1270,43
28,50,215004375,50437,Roncey,803,791,12
28,50,215004425,50442,Le Rozel,254,249,5
28,50,215004433,50443,Sacey,527,516,11
28,50,200063576,50444,Saint-Amand-Villages,2572,2514,58
28,50,215004458,50445,Saint-André-de-Bohon,374,361,13
28,50,215004466,50446,Saint-André-de-l'Épine,561,548,13
28,50,215004474,50447,Saint-Aubin-des-Préaux,476,462,14
28,50,215004482,50448,Saint-Aubin-de-Terregatte,667,650,17
28,50,215004508,50450,Saint-Barthélemy,340,332,8
28,50,215004516,50451,Saint-Brice,130,129,1
28,50,215004524,50452,Saint-Brice-de-Landelles,686,664,22
28,50,215004532,50453,Sainte-Cécile,806,788,18
28,50,215004540,50454,Saint-Christophe-du-Foc,429,420,9
28,50,215004557,50455,Saint-Clair-sur-l'Elle,988,968,20
28,50,215004565,50456,Saint-Clément-Rancoudray,558,547,11
28,50,215004573,50457,Sainte-Colombe,195,189,6
28,50,215004615,50461,Saint-Cyr,215,206,9
28,50,215004623,50462,Saint-Cyr-du-Bailleul,362,354,8
28,50,215004631,50463,Saint-Denis-le-Gast,537,526,11
28,50,215004649,50464,Saint-Denis-le-Vêtu,641,636,5
28,50,215004672,50467,Saint-Floxel,509,496,13
28,50,215004680,50468,Saint-Fromond,779,762,17
28,50,215004698,50469,Sainte-Geneviève,315,308,7
28,50,215004714,50471,Saint-Georges-de-la-Rivière,278,273,5
28,50,215004722,50472,Saint-Georges-de-Livoye,215,207,8
28,50,215004730,50473,Saint-Georges-d'Elle,392,385,7
28,50,215004748,50474,Saint-Georges-de-Rouelley,556,544,12
28,50,215004755,50475,Saint-Georges-Montcocq,984,964,20
28,50,215004763,50476,Saint-Germain-d'Elle,227,220,7
28,50,215004789,50478,Saint-Germain-de-Tournebut,425,419,6
28,50,215004797,50479,Saint-Germain-de-Varreville,112,109,3
28,50,215004805,50480,Saint-Germain-le-Gaillard,785,770,15
28,50,215004813,50481,Saint-Germain-sur-Ay,922,904,18
28,50,215004821,50482,Saint-Germain-sur-Sèves,164,161,3
28,50,215004839,50483,Saint-Gilles,1007,978,29
28,50,200058204,50484,Saint-Hilaire-du-Harcouët,6077,5769,308
28,50,215004862,50486,Saint-Jacques-de-Néhou,634,625,9
28,50,200063295,50487,Saint-James,4999,4896,103
28,50,215004888,50488,Saint-Jean-de-Daye,644,636,8
28,50,215004896,50489,Saint-Jean-de-la-Haize,557,544,13
28,50,215004904,50490,Saint-Jean-de-la-Rivière,371,358,13
28,50,215004912,50491,Saint-Jean-de-Savigny,450,439,11
28,50,200056513,50492,Saint-Jean-d'Elle,2583,2527,56
28,50,215004938,50493,Saint-Jean-des-Champs,1517,1471,46
28,50,215004953,50495,Saint-Jean-du-Corail-des-Bois,80,75,5
28,50,215004961,50496,Saint-Jean-le-Thomas,395,386,9
28,50,215004987,50498,Saint-Joseph,825,801,24
28,50,215004995,50499,Saint-Laurent-de-Cuves,501,487,14
28,50,215005000,50500,Saint-Laurent-de-Terregatte,665,653,12
28,50,215005026,50502,Saint-Lô,20112,19206,906
28,50,215005042,50504,Saint-Louet-sur-Vire,212,207,5
28,50,215005059,50505,Saint-Loup,711,677,34
28,50,215005067,50506,Saint-Malo-de-la-Lande,487,476,11
28,50,215005075,50507,Saint-Marcouf,351,345,6
28,50,215005091,50509,Sainte-Marie-du-Mont,724,707,17
28,50,215005109,50510,Saint-Martin-d'Aubigny,610,606,4
28,50,215005117,50511,Saint-Martin-d'Audouville,136,136,0
28,50,215005125,50512,Saint-Martin-de-Bonfossé,543,534,9
28,50,215005133,50513,Saint-Martin-de-Cenilly,188,186,2
28,50,215005141,50514,Chaulieu,313,312,1
28,50,215005174,50517,Saint-Martin-de-Varreville,175,170,5
28,50,215005182,50518,Saint-Martin-le-Bouillant,336,333,3
28,50,215005190,50519,Saint-Martin-le-Gréard,595,587,8
28,50,215005216,50521,Saint-Maur-des-Bois,158,154,4
28,50,215005224,50522,Saint-Maurice-en-Cotentin,258,251,7
28,50,200087138,50523,Sainte-Mère-Église,3067,3021,46
28,50,215005257,50525,Saint-Michel-de-Montjoie,336,334,2
28,50,215005281,50528,Saint-Nicolas-de-Pierrepont,316,304,12
28,50,215005299,50529,Saint-Nicolas-des-Bois,81,79,2
28,50,215005315,50531,Saint-Ovin,798,767,31
28,50,215005323,50532,Saint-Pair-sur-Mer,4253,4103,150
28,50,215005331,50533,Saint-Patrice-de-Claids,182,179,3
28,50,200055960,50535,Le Parc,939,917,22
28,50,215005364,50536,Saint-Pierre-d'Arthéglise,161,161,0
28,50,215005372,50537,Saint-Pierre-de-Coutances,432,413,19
28,50,215005380,50538,Saint-Pierre-de-Semilly,459,447,12
28,50,215005398,50539,Saint-Pierre-Église,1849,1824,25
28,50,215005406,50540,Saint-Pierre-Langers,647,630,17
28,50,215005414,50541,Saint-Planchers,1471,1423,48
28,50,215005422,50542,Saint-Pois,488,480,8
28,50,215005430,50543,Saint-Quentin-sur-le-Homme,1388,1357,31
28,50,200086213,50546,Bourgvallées,3373,3304,69
28,50,215005489,50548,Saint-Sauveur-de-Pierrepont,121,118,3
28,50,215005497,50549,Saint-Sauveur-la-Pommeraye,414,408,6
28,50,200087047,50550,Saint-Sauveur-Villages,3609,3474,135
28,50,215005513,50551,Saint-Sauveur-le-Vicomte,2115,2076,39
28,50,215005521,50552,Saint-Sébastien-de-Raids,335,329,6
28,50,215005539,50553,Saint-Senier-de-Beuvron,339,336,3
28,50,215005547,50554,Saint-Senier-sous-Avranches,1467,1436,31
28,50,215005562,50556,Sainte-Suzanne-sur-Vire,709,699,10
28,50,215005620,50562,Saint-Vaast-la-Hougue,1728,1700,28
28,50,215005638,50563,Saint-Vigor-des-Monts,288,280,8
28,50,200058428,50564,Terre-et-Marais,1350,1321,29
28,50,200058048,50565,Sartilly-Baie-Bocage,2891,2835,56
28,50,215005679,50567,Saussemesnil,907,882,25
28,50,215005687,50568,Saussey,474,459,15
28,50,215005695,50569,Savigny,458,445,13
28,50,215005703,50570,Savigny-le-Vieux,421,413,8
28,50,215005711,50571,Sébeville,35,34,1
28,50,215005729,50572,Sénoville,192,189,3
28,50,215005745,50574,Servon,280,268,12
28,50,215005752,50575,Sideville,821,807,14
28,50,215005760,50576,Siouville-Hague,978,947,31
28,50,215005778,50577,Sortosville-en-Beaumont,319,311,8
28,50,215005786,50578,Sortosville,80,79,1
28,50,215005794,50579,Sottevast,1462,1433,29
28,50,215005802,50580,Sotteville,487,471,16
28,50,200059541,50582,Sourdeval,3175,3113,62
28,50,215005844,50584,Subligny,405,397,8
28,50,215005851,50585,Surtainville,1185,1159,26
28,50,215005877,50587,Taillepied,17,16,1
28,50,215005885,50588,Tamerville,706,688,18
28,50,215005893,50589,Tanis,295,283,12
28,50,215005901,50590,Le Tanu,416,410,6
28,50,200057636,50591,Le Teilleul,1690,1663,27
28,50,200077931,50592,Tessy-Bocage,2282,2237,45
28,50,215005935,50593,Teurthéville-Bocage,600,590,10
28,50,215005943,50594,Teurthéville-Hague,1055,1032,23
28,50,215005968,50596,Théville,339,329,10
28,50,200082782,50597,Tirepied-sur-Sée,966,953,13
28,50,215005984,50598,Tocqueville,269,266,3
28,50,215005992,50599,Tollevast,1632,1596,36
28,50,200053825,50601,Torigny-les-Villes,4491,4434,57
28,50,215006032,50603,Tourville-sur-Sienne,795,772,23
28,50,215006040,50604,Tréauville,765,746,19
28,50,215006065,50606,Tribehou,522,515,7
28,50,215006073,50607,La Trinité,402,396,6
28,50,215006099,50609,Turqueville,125,122,3
28,50,215006107,50610,Urville,213,208,5
28,50,215006123,50612,Vains,831,747,84
28,50,215006131,50613,Valcanville,404,395,9
28,50,215006156,50615,Valognes,7064,6802,262
28,50,215006164,50616,Le Val-Saint-Père,2000,1935,65
28,50,215006172,50617,Varenguebec,336,334,2
28,50,215006180,50618,Varouville,244,233,11
28,50,215006198,50619,Le Vast,338,328,10
28,50,215006214,50621,Vaudreville,71,71,0
28,50,215006248,50624,La Vendelée,498,474,24
28,50,215006263,50626,Ver,387,379,8
28,50,215006289,50628,Vernix,159,155,4
28,50,215006297,50629,Vesly,747,741,6
28,50,215006339,50633,Le Vicel,121,118,3
28,50,215006347,50634,Videcosville,89,88,1
28,50,215006370,50637,Villebaudon,323,320,3
28,50,200054732,50639,Villedieu-les-Poêles-Rouffigny,3913,3849,64
28,50,215006412,50641,Villiers-Fossard,672,652,20
28,50,215006438,50643,Virandeville,801,777,24
28,50,215006479,50647,Yquelon,1195,1151,44
28,50,215006487,50648,Yvetot-Bocage,1212,1182,30
44,51,215100017,51001,Ablancourt,169,165,4
44,51,215100025,51002,Saint-Martin-d'Ablois,1410,1387,23
44,51,215100033,51003,Aigny,285,280,5
44,51,215100041,51004,Allemanche-Launay-et-Soyer,121,117,4
44,51,215100058,51005,Allemant,178,175,3
44,51,215100066,51006,Alliancelles,152,148,4
44,51,215100074,51007,Ambonnay,990,965,25
44,51,215100082,51008,Ambrières,220,214,6
44,51,215100090,51009,Anglure,822,812,10
44,51,215100108,51010,Angluzelles-et-Courcelles,145,141,4
44,51,215100116,51012,Anthenay,72,72,0
44,51,215100124,51013,Aougny,103,98,5
44,51,215100132,51014,Arcis-le-Ponsart,299,291,8
44,51,215100140,51015,Argers,111,110,1
44,51,215100157,51016,Arrigny,243,239,4
44,51,215100165,51017,Arzillières-Neuville,332,326,6
44,51,215100173,51018,Athis,907,896,11
44,51,215100181,51019,Aubérive,260,253,7
44,51,215100199,51020,Aubilly,56,53,3
44,51,215100207,51022,Aulnay-l'Aître,197,192,5
44,51,215100215,51023,Aulnay-sur-Marne,274,269,5
44,51,215100223,51025,Auménancourt,1103,1093,10
44,51,215100231,51027,Auve,331,300,31
44,51,215100249,51028,Avenay-Val-d'Or,1026,1008,18
44,51,215100256,51029,Avize,1911,1752,159
44,51,200055622,51030,Aÿ-Champagne,5338,5250,88
44,51,215100272,51031,Baconnes,287,275,12
44,51,215100280,51032,Bagneux,421,416,5
44,51,215100298,51033,Le Baizil,252,249,3
44,51,215100306,51034,Bannay,21,21,0
44,51,215106162,51035,Bannes,250,247,3
44,51,215100314,51036,Barbonne-Fayel,509,498,11
44,51,215100322,51037,Baslieux-lès-Fismes,350,347,3
44,51,215100330,51038,Baslieux-sous-Châtillon,181,180,1
44,51,215100348,51039,Bassu,96,92,4
44,51,215100355,51040,Bassuet,250,247,3
44,51,215100363,51041,Baudement,104,100,4
44,51,215100371,51042,Baye,393,386,7
44,51,215100389,51043,Bazancourt,2411,2384,27
44,51,215100397,51044,Beaumont-sur-Vesle,798,782,16
44,51,215100405,51045,Beaunay,102,102,0
44,51,215100413,51046,Beine-Nauroy,1010,992,18
44,51,215100421,51047,Belval-en-Argonne,47,44,3
44,51,215100439,51048,Belval-sous-Châtillon,168,168,0
44,51,215100447,51049,Bergères-lès-Vertus,583,579,4
44,51,215100454,51050,Bergères-sous-Montmirail,140,138,2
44,51,215100462,51051,Berméricourt,246,243,3
44,51,215100470,51052,Berru,603,599,4
44,51,215100488,51053,Berzieux,75,74,1
44,51,215100496,51054,Bétheniville,1304,1290,14
44,51,215100504,51055,Bétheny,7257,7148,109
44,51,215100512,51056,Bethon,245,242,3
44,51,215100520,51057,Bettancourt-la-Longue,76,76,0
44,51,215100538,51058,Bezannes,3591,3513,78
44,51,215100546,51059,Bignicourt-sur-Marne,376,370,6
44,51,215100553,51060,Bignicourt-sur-Saulx,165,162,3
44,51,215100561,51061,Billy-le-Grand,120,118,2
44,51,215100579,51062,Binarville,97,94,3
44,51,215100603,51065,Blacy,636,623,13
44,51,215100611,51066,Blaise-sous-Arzillières,327,324,3
44,51,215100629,51068,Blesme,201,199,2
44,51,215100637,51069,Bligny,118,117,1
44,51,215100645,51070,Boissy-le-Repos,230,230,0
44,51,215100652,51071,Bouchy-Saint-Genest,203,199,4
44,51,215100660,51072,Bouilly,227,225,2
44,51,215100678,51073,Bouleuse,227,223,4
44,51,215100686,51074,Boult-sur-Suippe,1812,1780,32
44,51,200062990,51075,Bourgogne-Fresne,1465,1432,33
44,51,215100702,51076,Boursault,444,435,9
44,51,215100710,51077,Bouvancourt,179,176,3
44,51,215100728,51078,Bouy,570,562,8
44,51,215100736,51079,Bouzy,877,853,24
44,51,215100744,51080,Brandonvillers,193,192,1
44,51,215100751,51081,Branscourt,335,330,5
44,51,215100769,51082,Braux-Sainte-Cohière,95,93,2
44,51,215100777,51083,Braux-Saint-Remy,82,79,3
44,51,215100785,51084,Bréban,81,80,1
44,51,215100793,51085,Le Breuil,380,377,3
44,51,215100801,51086,Breuil-sur-Vesle,343,331,12
44,51,215100819,51087,Breuvery-sur-Coole,223,215,8
44,51,215100827,51088,Brimont,461,453,8
44,51,215100835,51089,Brouillet,71,68,3
44,51,215100843,51090,Broussy-le-Grand,324,312,12
44,51,215100850,51091,Broussy-le-Petit,144,137,7
44,51,215100868,51092,Broyes,360,351,9
44,51,215100876,51093,Brugny-Vaudancourt,453,442,11
44,51,215100884,51094,Brusson,184,180,4
44,51,215100892,51095,Le Buisson,91,91,0
44,51,215100900,51097,Bussy-le-Château,181,177,4
44,51,215100918,51098,Bussy-le-Repos,141,136,5
44,51,215100926,51099,Bussy-Lettrée,329,320,9
44,51,215100934,51100,La Caure,110,108,2
44,51,215100942,51101,Caurel,701,692,9
44,51,215100959,51102,Cauroy-lès-Hermonville,487,477,10
44,51,215100967,51103,La Celle-sous-Chantemerle,142,139,3
44,51,215100975,51104,Cernay-en-Dormois,140,136,4
44,51,215100983,51105,Cernay-lès-Reims,1474,1449,25
44,51,215100991,51106,Cernon,132,127,5
44,51,215101007,51107,Chaintrix-Bierges,343,341,2
44,51,215101015,51108,Châlons-en-Champagne,45481,44336,1145
44,51,215101023,51109,Châlons-sur-Vesle,192,190,2
44,51,215101031,51110,Chaltrait,57,57,0
44,51,215101049,51111,Chambrecy,156,149,7
44,51,215101056,51112,Chamery,444,438,6
44,51,215101064,51113,Champaubert,124,122,2
44,51,215101072,51115,Champfleury,586,583,3
44,51,215101080,51116,Champguyon,286,282,4
44,51,215101098,51117,Champigneul-Champagne,330,322,8
44,51,215101106,51118,Champigny,1612,1585,27
44,51,215101114,51119,Champillon,517,510,7
44,51,215101122,51120,Champlat-et-Boujacourt,152,152,0
44,51,215101130,51121,Champvoisy,254,251,3
44,51,215101148,51122,Changy,121,117,4
44,51,215101155,51124,Chantemerle,52,49,3
44,51,215101163,51125,Chapelaine,54,53,1
44,51,215101171,51126,La Chapelle-Felcourt,49,46,3
44,51,215101189,51127,La Chapelle-Lasson,86,86,0
44,51,215101197,51128,La Chapelle-sous-Orbais,56,54,2
44,51,215101205,51129,Charleville,263,254,9
44,51,215101213,51130,Charmont,241,236,5
44,51,215101221,51132,Les Charmontois,116,116,0
44,51,215101239,51133,Le Châtelier,63,63,0
44,51,215101247,51134,Châtelraould-Saint-Louvent,252,244,8
44,51,215101254,51135,Châtillon-sur-Broué,76,76,0
44,51,215101262,51136,Châtillon-sur-Marne,645,629,16
44,51,215101270,51137,Châtillon-sur-Morin,222,218,4
44,51,215101288,51138,Châtrices,36,35,1
44,51,215101296,51139,Chaudefontaine,326,313,13
44,51,215101304,51140,Chaumuzy,384,376,8
44,51,215101312,51141,La Chaussée-sur-Marne,791,776,15
44,51,215101320,51142,Chavot-Courcourt,340,330,10
44,51,215101338,51143,Le Chemin,59,59,0
44,51,215101346,51144,Cheminon,612,601,11
44,51,215101353,51145,Chenay,229,224,5
44,51,215101361,51146,Cheniers,113,110,3
44,51,215101379,51147,La Cheppe,339,327,12
44,51,215101387,51148,Cheppes-la-Prairie,149,147,2
44,51,215101395,51149,Chepy,460,446,14
44,51,215101403,51150,Cherville,84,83,1
44,51,215101411,51151,Chichey,176,173,3
44,51,215101429,51152,Chigny-les-Roses,545,535,10
44,51,215101437,51153,Chouilly,1057,1035,22
44,51,215101445,51154,Clamanges,220,217,3
44,51,215101452,51155,Clesles,623,614,9
44,51,215101460,51156,Cloyes-sur-Marne,123,122,1
44,51,215101478,51157,Coizard-Joches,78,78,0
44,51,215101486,51158,Val-des-Marais,580,570,10
44,51,215101494,51160,Compertrix,1400,1353,47
44,51,215101502,51161,Condé-sur-Marne,769,755,14
44,51,215101510,51162,Conflans-sur-Seine,646,638,8
44,51,215101528,51163,Congy,268,264,4
44,51,215101536,51164,Connantray-Vaurefroy,148,145,3
44,51,215101544,51165,Connantre,1053,1023,30
44,51,215101551,51166,Contault,69,67,2
44,51,215101569,51167,Coole,153,150,3
44,51,215101577,51168,Coolus,226,220,6
44,51,215101585,51169,Corbeil,102,97,5
44,51,215101593,51170,Corfélix,112,110,2
44,51,200073385,51171,Cormicy,1529,1503,26
44,51,215101619,51172,Cormontreuil,6537,6459,78
44,51,215101627,51173,Cormoyeux,129,128,1
44,51,215101635,51174,Corribert,62,62,0
44,51,215101643,51175,Corrobert,220,213,7
44,51,215101650,51176,Corroy,152,145,7
44,51,215101668,51177,Coulommes-la-Montagne,209,206,3
44,51,215101676,51178,Coupetz,83,81,2
44,51,215101684,51179,Coupéville,165,165,0
44,51,215101692,51181,Courcelles-Sapicourt,414,403,11
44,51,215101700,51182,Courcemain,93,91,2
44,51,215101718,51183,Courcy,1260,1243,17
44,51,215101726,51184,Courdemanges,401,388,13
44,51,215101734,51185,Courgivaux,286,285,1
44,51,215101742,51186,Courjeonnet,48,48,0
44,51,215101759,51187,Courlandon,296,289,7
44,51,215101767,51188,Courmas,221,213,8
44,51,215101775,51190,Courtagnon,71,71,0
44,51,215101783,51191,Courtémont,64,61,3
44,51,215101791,51192,Courthiézy,351,346,5
44,51,215101809,51193,Courtisols,2453,2361,92
44,51,215101817,51194,Courville,473,466,7
44,51,215101825,51195,Couvrot,837,815,22
44,51,215101833,51196,Cramant,891,879,12
44,51,215101841,51197,La Croix-en-Champagne,83,81,2
44,51,215101858,51198,Crugny,676,671,5
44,51,215101866,51199,Cuchery,415,409,6
44,51,215101874,51200,Cuis,382,370,12
44,51,200002160,51201,Cuisles,128,124,4
44,51,215101882,51202,Cumières,762,750,12
44,51,215101890,51203,Cuperly,227,225,2
44,51,215101908,51204,Damery,1372,1346,26
44,51,215101916,51205,Dampierre-au-Temple,276,272,4
44,51,215101924,51206,Dampierre-le-Château,116,114,2
44,51,215101932,51208,Dampierre-sur-Moivre,118,116,2
44,51,215101940,51210,Dizy,1517,1492,25
44,51,215101957,51211,Dommartin-Dampierre,68,68,0
44,51,215101965,51212,Dommartin-Lettrée,159,158,1
44,51,215101973,51213,Dommartin-sous-Hans,58,55,3
44,51,215101981,51214,Dommartin-Varimont,145,137,8
44,51,215101999,51215,Dompremy,126,123,3
44,51,215102005,51216,Dontrien,262,258,4
44,51,215102013,51217,Dormans,2960,2916,44
44,51,215102021,51218,Val-de-Vière,131,130,1
44,51,215102039,51219,Drosnay,218,214,4
44,51,215102047,51220,Drouilly,147,141,6
44,51,215102054,51222,Éclaires,98,95,3
44,51,215102062,51223,Écollemont,59,58,1
44,51,215102070,51224,Écriennes,174,169,5
44,51,215102088,51225,Écueil,325,320,5
44,51,215102096,51226,Écury-le-Repos,59,58,1
44,51,215106154,51227,Écury-sur-Coole,502,481,21
44,51,215102104,51228,Élise-Daucourt,83,83,0
44,51,215102112,51229,Épense,126,120,6
44,51,215102120,51230,Épernay,22836,22362,474
44,51,215102138,51231,L'Épine,672,657,15
44,51,215102146,51232,Époye,425,419,6
44,51,215102153,51233,Escardes,69,66,3
44,51,215102161,51234,Esclavolles-Lurey,644,633,11
44,51,215102179,51235,Les Essarts-lès-Sézanne,251,241,10
44,51,215102187,51236,Les Essarts-le-Vicomte,142,137,5
44,51,215102195,51237,Esternay,1847,1817,30
44,51,215102203,51238,Étoges,467,464,3
44,51,215102211,51239,Étréchy,105,104,1
44,51,215102229,51240,Étrepy,124,121,3
44,51,215102237,51241,Euvy,81,80,1
44,51,215102245,51242,Fagnières,4976,4868,108
44,51,215102252,51243,Faux-Fresnay,314,305,9
44,51,215102260,51244,Faux-Vésigneul,247,240,7
44,51,215102278,51245,Faverolles-et-Coëmy,588,578,10
44,51,215102286,51246,Favresse,227,222,5
44,51,215102294,51247,Fèrebrianges,147,144,3
44,51,215102302,51248,Fère-Champenoise,2212,2171,41
44,51,215102310,51249,Festigny,397,391,6
44,51,215102328,51250,Fismes,5775,5721,54
44,51,215102336,51251,Flavigny,179,174,5
44,51,215102344,51252,Fleury-la-Rivière,525,519,6
44,51,215102351,51253,Florent-en-Argonne,229,224,5
44,51,215102369,51254,Fontaine-Denis-Nuisy,232,230,2
44,51,215102377,51255,Fontaine-en-Dormois,12,12,0
44,51,215102385,51256,Fontaine-sur-Ay,339,331,8
44,51,215102393,51258,La Forestière,220,207,13
44,51,215102401,51259,Francheville,197,191,6
44,51,215102419,51260,Le Fresne,78,75,3
44,51,215102435,51262,Frignicourt,1821,1787,34
44,51,215102443,51263,Fromentières,383,376,7
44,51,215102450,51264,Le Gault-Soigny,522,507,15
44,51,215102468,51265,Gaye,608,596,12
44,51,215102476,51266,Germaine,548,532,16
44,51,215102484,51267,Germigny,177,176,1
44,51,215102492,51268,Germinon,188,184,4
44,51,215102500,51269,Giffaumont-Champaubert,278,277,1
44,51,215102518,51270,Gigny-Bussy,244,239,5
44,51,215102534,51272,Givry-en-Argonne,464,457,7
44,51,215102542,51273,Givry-lès-Loisy,71,71,0
44,51,215102559,51274,Gizaucourt,120,117,3
44,51,215102567,51275,Glannes,189,187,2
44,51,215102575,51276,Gourgançon,150,143,7
44,51,215102583,51277,Sainte-Marie-du-Lac-Nuisement,279,272,7
44,51,215102591,51278,Les Grandes-Loges,281,276,5
44,51,215102609,51279,Granges-sur-Aube,189,184,5
44,51,215102617,51280,Gratreuil,24,24,0
44,51,215102625,51281,Grauves,631,619,12
44,51,215102633,51282,Gueux,1898,1850,48
44,51,215102641,51283,Hans,146,139,7
44,51,215102658,51284,Haussignémont,304,303,1
44,51,215102666,51285,Haussimont,143,139,4
44,51,215102674,51286,Hauteville,247,240,7
44,51,215102682,51287,Hautvillers,684,669,15
44,51,215102690,51288,Heiltz-le-Hutier,245,238,7
44,51,215102708,51289,Heiltz-le-Maurupt,443,434,9
44,51,215102716,51290,Heiltz-l'Évêque,287,281,6
44,51,215102724,51291,Hermonville,1425,1392,33
44,51,215102732,51292,Herpont,126,122,4
44,51,215102740,51293,Heutrégiville,490,483,7
44,51,215102757,51294,Hourges,80,80,0
44,51,215102765,51295,Huiron,305,303,2
44,51,215102773,51296,Humbauville,77,77,0
44,51,215102781,51298,Igny-Comblizy,436,433,3
44,51,215102799,51299,Isles-sur-Suippe,959,946,13
44,51,215106196,51300,Isle-sur-Marne,96,94,2
44,51,215102807,51301,Isse,116,107,9
44,51,215102815,51302,Les Istres-et-Bury,95,94,1
44,51,215102823,51303,Jâlons,557,547,10
44,51,215102831,51304,Janvilliers,176,172,4
44,51,215102849,51305,Janvry,129,127,2
44,51,215102856,51306,Joiselle,106,103,3
44,51,215102864,51307,Jonchery-sur-Suippe,230,227,3
44,51,215102872,51308,Jonchery-sur-Vesle,1899,1843,56
44,51,215102880,51309,Jonquery,116,112,4
44,51,215102898,51310,Jouy-lès-Reims,224,221,3
44,51,215102906,51311,Jussecourt-Minecourt,209,207,2
44,51,215102914,51312,Juvigny,967,938,29
44,51,215102922,51313,Lachy,342,331,11
44,51,215102930,51314,Lagery,239,235,4
44,51,215102948,51315,Landricourt,146,145,1
44,51,215102955,51316,Larzicourt,277,272,5
44,51,215102963,51317,Laval-sur-Tourbe,52,52,0
44,51,215102971,51318,Lavannes,584,568,16
44,51,215102989,51319,Lenharrée,106,103,3
44,51,215102997,51320,Leuvrigny,315,307,8
44,51,215103003,51321,Lhéry,86,84,2
44,51,215103011,51322,Lignon,123,122,1
44,51,215103029,51323,Linthelles,112,106,6
44,51,215103037,51324,Linthes,113,113,0
44,51,215103045,51325,Lisse-en-Champagne,109,108,1
44,51,215103052,51326,Livry-Louvercy,1107,1093,14
44,51,215103060,51327,Loisy-en-Brie,179,177,2
44,51,215103078,51328,Loisy-sur-Marne,1133,1109,24
44,51,215103086,51329,Loivre,1399,1380,19
44,51,215103102,51333,Ludes,695,680,15
44,51,215103110,51334,Luxémont-et-Villotte,480,463,17
44,51,215103128,51336,Maffrécourt,59,58,1
44,51,215103136,51337,Magneux,271,269,2
44,51,215103144,51338,Mailly-Champagne,645,629,16
44,51,215103151,51339,Mairy-sur-Marne,577,562,15
44,51,215103169,51340,Maisons-en-Champagne,555,541,14
44,51,215103177,51341,Malmy,36,34,2
44,51,215103185,51342,Mancy,250,243,7
44,51,215103193,51343,Marcilly-sur-Seine,644,623,21
44,51,215103201,51344,Mardeuil,1494,1474,20
44,51,215103219,51345,Mareuil-en-Brie,288,286,2
44,51,215103227,51346,Mareuil-le-Port,1170,1152,18
44,51,215103243,51348,Marfaux,110,109,1
44,51,215103250,51349,Margerie-Hancourt,175,170,5
44,51,215103268,51350,Margny,132,127,5
44,51,215103276,51351,Marigny,113,112,1
44,51,215103284,51352,Marolles,871,852,19
44,51,215103292,51353,Marsangis,49,47,2
44,51,215103300,51354,Marson,288,279,9
44,51,215103318,51355,Massiges,49,49,0
44,51,215103326,51356,Matignicourt-Goncourt,158,153,5
44,51,215103334,51357,Matougues,637,623,14
44,51,215103342,51358,Maurupt-le-Montois,593,583,10
44,51,215103359,51359,Mécringes,213,210,3
44,51,215103367,51360,Le Meix-Saint-Epoing,300,298,2
44,51,215103375,51361,Le Meix-Tiercelin,167,166,1
44,51,215103383,51362,Merfy,622,603,19
44,51,215103391,51363,Merlaut,270,263,7
44,51,215103409,51364,Méry-Prémecy,68,67,1
44,51,215103417,51365,Les Mesneux,921,905,16
44,51,215103425,51367,Le Mesnil-sur-Oger,1063,1028,35
44,51,215103433,51368,Minaucourt-le-Mesnil-lès-Hurlus,50,47,3
44,51,215103441,51369,Moeurs-Verdey,327,312,15
44,51,215103458,51370,Moiremont,201,191,10
44,51,215103466,51371,Moivre,60,59,1
44,51,215103474,51372,Moncetz-Longevas,553,542,11
44,51,215103482,51373,Moncetz-l'Abbaye,94,90,4
44,51,215103490,51374,Mondement-Montgivroux,26,26,0
44,51,215103508,51375,Montbré,360,354,6
44,51,215103516,51376,Montgenost,156,154,2
44,51,215103524,51377,Montépreux,48,48,0
44,51,215103532,51378,Monthelon,352,347,5
44,51,215103540,51379,Montigny-sur-Vesle,517,509,8
44,51,215103557,51380,Montmirail,3609,3561,48
44,51,215103565,51381,Montmort-Lucy,634,624,10
44,51,215103573,51382,Mont-sur-Courville,117,113,4
44,51,215103581,51384,Morangis,406,394,12
44,51,215103599,51386,Morsains,143,141,2
44,51,215103607,51387,Moslins,294,291,3
44,51,215103615,51388,Mourmelon-le-Grand,5213,5163,50
44,51,215103623,51389,Mourmelon-le-Petit,820,813,7
44,51,215103631,51390,Moussy,793,783,10
44,51,215103649,51391,Muizon,2167,2105,62
44,51,215103656,51392,Mutigny,198,193,5
44,51,215103664,51393,Nanteuil-la-Forêt,306,299,7
44,51,215103672,51395,Nesle-la-Reposte,96,95,1
44,51,215103680,51396,Nesle-le-Repons,142,139,3
44,51,215103698,51397,La Neuville-aux-Bois,139,137,2
44,51,215103706,51398,La Neuville-aux-Larris,189,187,2
44,51,215103714,51399,La Neuville-au-Pont,551,542,9
44,51,215103722,51402,Neuvy,273,266,7
44,51,215103730,51403,Nogent-l'Abbesse,539,530,9
44,51,215103748,51404,Noirlieu,111,107,4
44,51,215103755,51406,Norrois,156,155,1
44,51,215103763,51407,La Noue,416,409,7
44,51,215103771,51409,Nuisement-sur-Coole,383,375,8
44,51,215103789,51410,oeuilly,667,657,10
44,51,215103805,51412,Ognes,61,59,2
44,51,215103813,51413,Oiry,905,887,18
44,51,215103821,51414,Olizy,153,148,5
44,51,215103839,51415,Omey,202,202,0
44,51,215103847,51416,Orbais-l'Abbaye,548,545,3
44,51,215103854,51417,Orconte,375,372,3
44,51,215103862,51418,Ormes,464,460,4
44,51,215103870,51419,Outines,127,126,1
44,51,215103888,51420,Outrepont,81,81,0
44,51,215103896,51421,Oyes,106,103,3
44,51,215103904,51422,Pargny-lès-Reims,488,478,10
44,51,215103912,51423,Pargny-sur-Saulx,1738,1723,15
44,51,215103920,51424,Passavant-en-Argonne,208,207,1
44,51,215103938,51425,Passy-Grigny,394,380,14
44,51,215103946,51426,Péas,69,66,3
44,51,215103953,51428,Les Petites-Loges,500,491,9
44,51,215103961,51429,Pévy,211,208,3
44,51,215103979,51430,Pierre-Morains,87,85,2
44,51,215103987,51431,Pierry,1225,1207,18
44,51,215103995,51432,Pleurs,847,828,19
44,51,215104001,51433,Plichancourt,251,246,5
44,51,215104019,51434,Plivot,766,746,20
44,51,215104027,51435,Pocancy,183,181,2
44,51,215104035,51436,Pogny,946,929,17
44,51,215104043,51437,Poilly,94,94,0
44,51,215104050,51438,Poix,72,71,1
44,51,215104068,51439,Pomacle,492,486,6
44,51,215104076,51440,Pontfaverger-Moronvilliers,1756,1739,17
44,51,215104084,51441,Ponthion,107,105,2
44,51,215104092,51442,Possesse,132,132,0
44,51,215104100,51443,Potangis,119,116,3
44,51,215104118,51444,Pouillon,515,505,10
44,51,215104126,51445,Pourcy,201,198,3
44,51,215104134,51446,Pringy,443,435,8
44,51,215104142,51447,Prosnes,497,484,13
44,51,215104159,51448,Prouilly,563,553,10
44,51,215104167,51449,Prunay,1041,1026,15
44,51,215104175,51450,Puisieulx,433,425,8
44,51,215104183,51451,Queudes,89,85,4
44,51,215104191,51452,Rapsécourt,32,32,0
44,51,215104209,51453,Recy,1075,1044,31
44,51,215104217,51454,Reims,183287,180318,2969
44,51,215104225,51455,Reims-la-Brûlée,224,221,3
44,51,215104233,51456,Remicourt,60,59,1
44,51,200098796,51457,Coeur-de-la-Vallée,680,657,23
44,51,215104258,51458,Reuves,62,62,0
44,51,215104266,51459,Réveillon,109,108,1
44,51,215104274,51460,Rieux,199,194,5
44,51,215104282,51461,Rilly-la-Montagne,1042,1020,22
44,51,215104290,51463,Les Rivières-Henruel,167,162,5
44,51,215104308,51464,Romain,327,310,17
44,51,215104316,51465,Romery,164,162,2
44,51,215104324,51466,Romigny,221,216,5
44,51,215104332,51468,Rosnay,374,362,12
44,51,215104340,51469,Rouffy,116,111,5
44,51,215104357,51470,Rouvroy-Ripont,3,3,0
44,51,215104365,51471,Sacy,375,372,3
44,51,215104373,51472,Saint-Amand-sur-Fion,1054,1028,26
44,51,215104381,51473,Saint-Bon,106,100,6
44,51,215104399,51474,Saint-Brice-Courcelles,3431,3392,39
44,51,215104407,51475,Saint-Chéron,62,61,1
44,51,215104415,51476,Saint-Étienne-au-Temple,834,821,13
44,51,215104423,51477,Saint-Étienne-sur-Suippe,339,335,4
44,51,215104431,51478,Saint-Eulien,434,422,12
44,51,215104449,51479,Saint-Euphraise-et-Clairizet,248,243,5
44,51,215104456,51480,Sainte-Gemme,140,137,3
44,51,215104464,51482,Saint-Germain-la-Ville,696,683,13
44,51,215104472,51483,Saint-Gibrien,546,539,7
44,51,215104480,51484,Saint-Gilles,277,272,5
44,51,215104498,51485,Saint-Hilaire-au-Temple,341,332,9
44,51,215104506,51486,Saint-Hilaire-le-Grand,382,378,4
44,51,215104514,51487,Saint-Hilaire-le-Petit,353,347,6
44,51,215104522,51488,Saint-Imoges,351,316,35
44,51,215104530,51489,Saint-Jean-devant-Possesse,34,31,3
44,51,215104548,51490,Saint-Jean-sur-Moivre,201,199,2
44,51,215104555,51491,Saint-Jean-sur-Tourbe,91,88,3
44,51,215104563,51492,Saint-Just-Sauvage,1449,1414,35
44,51,215104571,51493,Saint-Léonard,113,109,4
44,51,215104589,51495,Saint-Loup,74,74,0
44,51,215104597,51496,Saint-Lumier-en-Champagne,275,267,8
44,51,215104605,51497,Saint-Lumier-la-Populeuse,41,41,0
44,51,215104613,51498,Saint-Mard-sur-Auve,65,64,1
44,51,215104621,51499,Saint-Mard-lès-Rouffy,166,159,7
44,51,215104639,51500,Saint-Mard-sur-le-Mont,119,117,2
44,51,215104647,51501,Sainte-Marie-à-Py,202,194,8
44,51,215104654,51502,Saint-Martin-aux-Champs,115,115,0
44,51,215104662,51503,Saint-Martin-l'Heureux,85,84,1
44,51,215104670,51504,Saint-Martin-sur-le-Pré,814,801,13
44,51,215104696,51505,Saint-Masmes,505,500,5
44,51,215104704,51506,Saint-Memmie,5523,5448,75
44,51,215104712,51507,Sainte-Menehould,4277,4166,111
44,51,215104720,51508,Saint-Ouen-Domprot,206,203,3
44,51,215104688,51509,Saint-Pierre,317,308,9
44,51,215104738,51510,Saint-Quentin-les-Marais,124,124,0
44,51,215104746,51511,Saint-Quentin-le-Verger,119,117,2
44,51,215104753,51512,Saint-Quentin-sur-Coole,103,101,2
44,51,215104761,51513,Saint-Remy-en-Bouzemont-Saint-Genest-et-Isson,517,508,9
44,51,215104779,51514,Saint-Remy-sous-Broyes,109,108,1
44,51,215104787,51515,Saint-Remy-sur-Bussy,344,336,8
44,51,215104795,51516,Saint-Saturnin,47,47,0
44,51,215104803,51517,Saint-Souplet-sur-Py,122,118,4
44,51,215104811,51518,Saint-Thierry,635,611,24
44,51,215104829,51519,Saint-Thomas-en-Argonne,40,38,2
44,51,215104837,51520,Saint-Utin,77,76,1
44,51,215104845,51521,Saint-Vrain,226,223,3
44,51,215104852,51522,Sapignicourt,436,431,5
44,51,215104860,51523,Sarcy,273,269,4
44,51,215104878,51524,Saron-sur-Aube,292,289,3
44,51,215104886,51525,Sarry,2109,2023,86
44,51,215104894,51526,Saudoy,397,387,10
44,51,215104902,51527,Savigny-sur-Ardres,274,270,4
44,51,215104910,51528,Scrupt,127,127,0
44,51,215104928,51529,Selles,432,427,5
44,51,215104936,51530,Sept-Saulx,698,686,12
44,51,215104944,51531,Sermaize-les-Bains,1810,1779,31
44,51,215104951,51532,Sermiers,583,568,15
44,51,215104969,51533,Servon-Melzicourt,106,100,6
44,51,215104977,51534,Serzy-et-Prin,215,211,4
44,51,215104985,51535,Sézanne,4881,4775,106
44,51,215104993,51536,Sillery,1834,1796,38
44,51,215105008,51537,Sivry-Ante,182,178,4
44,51,215105016,51538,Sogny-aux-Moulins,111,111,0
44,51,215105024,51539,Sogny-en-l'Angle,74,74,0
44,51,215105032,51542,Soizy-aux-Bois,193,193,0
44,51,215105040,51543,Somme-Bionne,76,69,7
44,51,215105057,51544,Sommepy-Tahure,664,646,18
44,51,215105065,51545,Sommesous,503,487,16
44,51,215105073,51546,Somme-Suippe,660,510,150
44,51,215105081,51547,Somme-Tourbe,142,140,2
44,51,215105099,51548,Somme-Vesle,599,357,242
44,51,215105107,51549,Somme-Yèvre,126,123,3
44,51,215105115,51550,Sompuis,278,267,11
44,51,215105123,51551,Somsois,206,200,6
44,51,215105131,51552,Songy,274,270,4
44,51,215105149,51553,Souain-Perthes-lès-Hurlus,255,250,5
44,51,215105156,51555,Soudé,157,157,0
44,51,215105164,51556,Soudron,297,293,4
44,51,215105172,51557,Soulanges,473,464,9
44,51,215105180,51558,Soulières,144,141,3
44,51,215105198,51559,Suippes,3917,3881,36
44,51,215105206,51560,Suizy-le-Franc,110,107,3
44,51,215105214,51562,Taissy,2216,2180,36
44,51,215105222,51563,Talus-Saint-Prix,107,105,2
44,51,200055739,51564,Val de Livre,620,603,17
44,51,215105248,51565,Thaas,102,102,0
44,51,215105255,51566,Thibie,295,293,2
44,51,215105263,51567,Thiéblemont-Farémont,524,518,6
44,51,215105271,51568,Thil,314,307,7
44,51,215105289,51569,Thillois,575,506,69
44,51,215105297,51570,Le Thoult-Trosnay,108,106,2
44,51,215105305,51571,Val-de-Vesle,961,951,10
44,51,215105313,51572,Tilloy-et-Bellay,244,233,11
44,51,215105321,51573,Tinqueux,10591,10456,135
44,51,215105339,51574,Togny-aux-Boeufs,140,138,2
44,51,215105347,51576,Tours-sur-Marne,1399,1386,13
44,51,215105354,51577,Tramery,157,154,3
44,51,215105362,51578,Trécon,92,91,1
44,51,215105370,51579,Tréfols,180,177,3
44,51,215105388,51580,Trépail,445,440,5
44,51,215105396,51581,Treslon,257,255,2
44,51,215105404,51582,Trigny,576,566,10
44,51,215105412,51583,Trois-Fontaines-l'Abbaye,192,192,0
44,51,215105420,51584,Trois-Puits,146,144,2
44,51,215105438,51585,Troissy,848,786,62
44,51,215105446,51586,Unchair,188,183,5
44,51,215105453,51587,Vadenay,237,232,5
44,51,215105461,51588,Valmy,288,282,6
44,51,215105479,51589,Vanault-le-Châtel,173,172,1
44,51,215105487,51590,Vanault-les-Dames,377,368,9
44,51,215105495,51591,Vandeuil,175,172,3
44,51,215105503,51592,Vandières,304,298,6
44,51,215105511,51594,Vassimont-et-Chapelaine,64,64,0
44,51,215105529,51595,Vatry,155,153,2
44,51,215105537,51596,Vauchamps,360,358,2
44,51,215105545,51597,Vauciennes,338,331,7
44,51,215105552,51598,Vauclerc,498,489,9
44,51,215106170,51599,Vaudemange,339,334,5
44,51,215105560,51600,Vaudesincourt,99,98,1
44,51,215105578,51601,Vavray-le-Grand,161,158,3
44,51,215105586,51602,Vavray-le-Petit,64,64,0
44,51,215105594,51603,Vélye,212,210,2
44,51,215105602,51604,Ventelay,260,257,3
44,51,215105610,51605,Venteuil,535,525,10
44,51,215106188,51607,Verdon,204,202,2
44,51,215105628,51608,Vernancourt,89,84,5
44,51,215105636,51609,Verneuil,858,844,14
44,51,215105644,51610,Verrières,394,388,6
44,51,215105651,51611,Vert-Toulon,290,286,4
44,51,200077782,51612,Blancs-Coteaux,3444,3244,200
44,51,215105677,51613,Verzenay,1047,1031,16
44,51,215105685,51614,Verzy,974,953,21
44,51,215105693,51616,Vésigneul-sur-Marne,233,230,3
44,51,215105701,51617,La Veuve,616,599,17
44,51,215105719,51618,Le Vézier,193,190,3
44,51,215105727,51619,Le Vieil-Dampierre,114,111,3
44,51,215105735,51620,Vienne-la-Ville,174,169,5
44,51,215105743,51621,Vienne-le-Château,524,516,8
44,51,215105750,51622,Ville-Dommange,411,402,9
44,51,215105768,51623,Ville-en-Selve,333,287,46
44,51,215105776,51624,Ville-en-Tardenois,649,642,7
44,51,215105784,51625,Villeneuve-la-Lionne,284,280,4
44,51,215105792,51626,La Villeneuve-lès-Charleville,126,121,5
44,51,215105800,51627,Villeneuve-Renneville-Chevigny,337,326,11
44,51,215105818,51628,Villeneuve-Saint-Vistre-et-Villevotte,126,122,4
44,51,215105826,51629,Villers-Allerand,948,925,23
44,51,215105834,51630,Villers-aux-Bois,335,330,5
44,51,215105842,51631,Villers-aux-Noeuds,275,271,4
44,51,215105859,51632,Villers-en-Argonne,237,230,7
44,51,215105867,51633,Villers-Franqueux,311,296,15
44,51,215105875,51634,Villers-le-Château,290,281,9
44,51,215105883,51635,Villers-le-Sec,109,109,0
44,51,215105891,51636,Villers-Marmery,550,538,12
44,51,215105917,51638,Villeseneux,210,204,6
44,51,215105925,51639,La Ville-sous-Orbais,43,42,1
44,51,215105933,51640,Ville-sur-Tourbe,212,211,1
44,51,215105941,51641,Villevenard,202,197,5
44,51,215105958,51642,Villiers-aux-Corneilles,114,110,4
44,51,215105966,51643,Vinay,554,549,5
44,51,215105974,51644,Vincelles,326,317,9
44,51,215105982,51645,Vindey,111,109,2
44,51,215105990,51646,Virginy,85,82,3
44,51,215106006,51647,Vitry-en-Perthois,850,826,24
44,51,215106014,51648,Vitry-la-Ville,392,383,9
44,51,215106022,51649,Vitry-le-François,11678,11458,220
44,51,215106030,51650,Voilemont,48,47,1
44,51,215106055,51652,Vouarces,57,57,0
44,51,215106063,51654,Vouillers,260,258,2
44,51,215106071,51655,Vouzy,296,291,5
44,51,215106089,51656,Vraux,475,456,19
44,51,215106097,51657,Vrigny,252,252,0
44,51,215106105,51658,Vroil,104,104,0
44,51,215106113,51659,Wargemoulin-Hurlus,49,48,1
44,51,215106121,51660,Warmeriville,2672,2644,28
44,51,215106139,51662,Witry-lès-Reims,5022,4951,71
44,51,215106147,51663,Magenta,1709,1694,15
44,52,215200015,52001,Ageville,321,313,8
44,52,215200023,52002,Aigremont,23,23,0
44,52,215200031,52003,Aillianville,150,148,2
44,52,215200049,52004,Aingoulaincourt,13,13,0
44,52,215200056,52005,Aizanville,38,34,4
44,52,215200064,52006,Allichamps,361,357,4
44,52,215200072,52007,Ambonville,90,88,2
44,52,215200080,52008,Andelot-Blancheville,878,867,11
44,52,215204090,52009,Andilly-en-Bassigny,104,103,1
44,52,215200098,52011,Annéville-la-Prairie,93,93,0
44,52,215200106,52012,Annonville,31,29,2
44,52,215200114,52013,Anrosey,127,125,2
44,52,215200122,52014,Aprey,194,189,5
44,52,215200130,52015,Arbigny-sous-Varennes,85,85,0
44,52,215204140,52016,Arbot,70,68,2
44,52,215200148,52017,Arc-en-Barrois,736,723,13
44,52,215200155,52019,Arnancourt,92,88,4
44,52,215200163,52021,Attancourt,273,270,3
44,52,215204009,52022,Aubepierre-sur-Aube,188,185,3
44,52,215200171,52023,Auberive,156,151,5
44,52,215200189,52025,Audeloncourt,89,87,2
44,52,215200197,52027,Aujeurres,73,71,2
44,52,215200205,52028,Aulnoy-sur-Aube,55,55,0
44,52,215200213,52029,Autigny-le-Grand,136,132,4
44,52,215204124,52030,Autigny-le-Petit,55,52,3
44,52,215200221,52031,Autreville-sur-la-Renne,377,367,10
44,52,200031318,52033,Avrecourt,108,104,4
44,52,215200239,52034,Bailly-aux-Forges,150,145,5
44,52,215200247,52035,Baissey,186,183,3
44,52,215204108,52037,Bannes,376,368,8
44,52,215200262,52038,Bassoncourt,64,64,0
44,52,215200270,52039,Baudrecourt,87,87,0
44,52,215200288,52040,Bay-sur-Aube,51,51,0
44,52,215204272,52042,Beauchemin,114,108,6
44,52,215200296,52043,Belmont,55,54,1
44,52,215200304,52044,Roches-Bettaincourt,555,544,11
44,52,215200312,52045,Bettancourt-la-Ferrée,1825,1794,31
44,52,215200320,52047,Beurville,103,103,0
44,52,215200338,52050,Biesles,1363,1332,31
44,52,215200346,52051,Bize,86,82,4
44,52,215200353,52053,Blaisy,68,68,0
44,52,215200361,52055,Blécourt,117,116,1
44,52,215200379,52056,Blessonville,191,183,8
44,52,215200387,52057,Blumeray,106,102,4
44,52,215200395,52058,Bologne,1859,1827,32
44,52,215204082,52059,Bonnecourt,145,145,0
44,52,215200403,52060,Bourbonne-les-Bains,2024,1971,53
44,52,215200411,52061,Bourdons-sur-Rognon,296,294,2
44,52,215200429,52062,Bourg,162,159,3
44,52,215200437,52063,Bourg-Sainte-Marie,94,94,0
44,52,200082832,52064,Bourmont-entre-Meuse-et-Mouzon,804,770,34
44,52,215200452,52065,Bouzancourt,67,65,2
44,52,215200460,52066,Brachay,66,63,3
44,52,215200478,52067,Brainville-sur-Meuse,72,72,0
44,52,215200486,52069,Braux-le-Châtel,140,138,2
44,52,215200494,52070,Brennes,123,120,3
44,52,215200502,52072,Brethenay,390,379,11
44,52,215200510,52074,Breuvannes-en-Bassigny,690,670,20
44,52,215200528,52075,Briaucourt,181,175,6
44,52,215200536,52076,Bricon,442,436,6
44,52,215200544,52079,Brousseval,651,642,9
44,52,215200551,52082,Bugnières,160,155,5
44,52,215200569,52083,Champsevraine,752,738,14
44,52,215200577,52084,Busson,43,43,0
44,52,215200585,52085,Buxières-lès-Clefmont,28,26,2
44,52,215200593,52087,Buxières-lès-Villiers,218,198,20
44,52,215200601,52088,Ceffonds,666,650,16
44,52,215200619,52089,Celles-en-Bassigny,72,72,0
44,52,215200627,52090,Celsoy,102,101,1
44,52,215200635,52091,Cerisières,91,85,6
44,52,215200643,52092,Chalancey,108,106,2
44,52,215200650,52093,Chalindrey,2461,2406,55
44,52,215200668,52094,Vals-des-Tilles,181,179,2
44,52,215200676,52095,Chalvraines,194,192,2
44,52,215200684,52097,Chambroncourt,50,49,1
44,52,215200692,52099,Chamouilley,771,764,7
44,52,215200700,52101,Champigneulles-en-Bassigny,41,40,1
44,52,215200718,52102,Champigny-lès-Langres,422,416,6
44,52,215204157,52103,Champigny-sous-Varennes,121,119,2
44,52,215200726,52104,Chancenay,1048,1024,24
44,52,215204066,52105,Changey,302,296,6
44,52,215200734,52106,Chanoy,121,119,2
44,52,215200742,52107,Chantraines,222,218,4
44,52,215204041,52108,Charmes,151,147,4
44,52,215200759,52109,Charmes-en-l'Angle,6,6,0
44,52,215200767,52110,Charmes-la-Grande,159,156,3
44,52,215200775,52113,Chassigny,261,256,5
44,52,215200783,52114,Châteauvillain,1592,1573,19
44,52,215200791,52115,Chatenay-Mâcheron,100,98,2
44,52,215204074,52116,Chatenay-Vaudin,50,48,2
44,52,215200809,52118,Chatonrupt-Sommermont,282,276,6
44,52,215200817,52119,Chaudenay,354,345,9
44,52,215200825,52120,Chauffourt,189,182,7
44,52,215200833,52121,Chaumont,22966,21770,1196
44,52,215200841,52122,Chaumont-la-Ville,116,115,1
44,52,215200858,52123,Chevillon,1330,1305,25
44,52,200031375,52124,Chézeaux,76,76,0
44,52,215200866,52125,Chamarandes-Choignes,1220,1046,174
44,52,215200874,52126,Choilley-Dardenay,161,157,4
44,52,215200882,52127,Choiseul,82,78,4
44,52,215200890,52128,Cirey-lès-Mareilles,149,146,3
44,52,215200908,52129,Cirey-sur-Blaise,117,117,0
44,52,215200916,52130,Cirfontaines-en-Azois,192,190,2
44,52,215200924,52131,Cirfontaines-en-Ornois,81,79,2
44,52,215200932,52132,Clefmont,167,164,3
44,52,215200940,52133,Clinchamp,70,70,0
44,52,215200957,52134,Cohons,219,218,1
44,52,215200965,52135,Coiffy-le-Bas,89,87,2
44,52,215200973,52136,Coiffy-le-Haut,108,108,0
44,52,215200981,52137,Colmier-le-Bas,21,21,0
44,52,215200999,52138,Colmier-le-Haut,65,64,1
44,52,200069334,52140,Colombey les Deux Églises,709,693,16
44,52,215201013,52141,Condes,301,295,6
44,52,215201021,52142,Consigny,74,73,1
44,52,215204306,52145,Coublanc,124,119,5
44,52,215201039,52146,Coupray,163,160,3
44,52,215201047,52147,Courcelles-en-Montagne,92,90,2
44,52,215201054,52149,Courcelles-sur-Blaise,92,90,2
44,52,215201062,52151,Cour-l'Évêque,150,148,2
44,52,215201070,52155,Culmont,534,522,12
44,52,215201088,52156,Curel,415,407,8
44,52,215201096,52157,Curmont,13,12,1
44,52,215201104,52158,Cusey,284,281,3
44,52,215201112,52159,Cuves,27,26,1
44,52,215201120,52160,Daillancourt,66,63,3
44,52,215201138,52161,Daillecourt,72,72,0
44,52,215201146,52162,Dammartin-sur-Meuse,199,197,2
44,52,215204033,52163,Dampierre,391,387,4
44,52,215201153,52164,Damrémont,202,197,5
44,52,215201161,52165,Dancevoir,201,196,5
44,52,215201179,52167,Darmannes,266,263,3
44,52,215201187,52168,Dinteville,65,62,3
44,52,215201195,52169,Domblain,79,77,2
44,52,215204298,52170,Dommarien,175,168,7
44,52,215201203,52171,Dommartin-le-Franc,243,241,2
44,52,215201211,52172,Dommartin-le-Saint-Père,289,282,7
44,52,215201229,52173,Domremy-Landéville,78,76,2
44,52,215201237,52174,Doncourt-sur-Meuse,38,37,1
44,52,215201245,52175,Donjeux,396,392,4
44,52,215201252,52177,Doulaincourt-Saucourt,814,780,34
44,52,215201260,52178,Doulevant-le-Château,370,361,9
44,52,215201278,52179,Doulevant-le-Petit,21,19,2
44,52,215201294,52181,Échenay,92,91,1
44,52,215201302,52182,Éclaron-Braucourt-Sainte-Livière,2066,2017,49
44,52,215201310,52183,Ecot-la-Combe,40,39,1
44,52,215201328,52184,Effincourt,63,58,5
44,52,215201336,52185,Enfonvelle,64,64,0
44,52,200037646,52187,Épizon,163,159,4
44,52,215201351,52189,Le Val-d'Esnoms,418,407,11
44,52,215201369,52190,Esnouveaux,298,291,7
44,52,215201377,52193,Euffigneix,310,298,12
44,52,215201385,52194,Eurville-Bienville,2066,2029,37
44,52,215201393,52195,Farincourt,36,36,0
44,52,215201401,52196,Faverolles,100,96,4
44,52,215201419,52197,Fayl-Billot,1365,1285,80
44,52,215201427,52198,Fays,69,67,2
44,52,215201435,52199,Ferrière-et-Lafolie,53,51,2
44,52,215201443,52200,Flagey,79,74,5
44,52,215201450,52201,Flammerécourt,69,69,0
44,52,215201468,52203,Fontaines-sur-Marne,148,146,2
44,52,215201476,52204,Forcey,67,63,4
44,52,215201484,52205,Foulain,705,688,17
44,52,215201492,52206,Frampas,158,154,4
44,52,215204025,52207,Frécourt,98,95,3
44,52,215201500,52208,Fresnes-sur-Apance,154,151,3
44,52,215201518,52211,Froncles,1430,1406,24
44,52,215201526,52212,Fronville,310,306,4
44,52,215201534,52213,Genevrières,133,129,4
44,52,215201542,52214,La Genevroye,32,31,1
44,52,215203969,52216,Germaines,51,50,1
44,52,215201559,52217,Germainvilliers,90,86,4
44,52,215201567,52218,Germay,50,50,0
44,52,215201575,52219,Germisay,18,18,0
44,52,215201583,52220,Giey-sur-Aujon,143,142,1
44,52,215201591,52221,Gillancourt,123,121,2
44,52,215201609,52222,Gillaumé,34,34,0
44,52,215204181,52223,Gilley,68,66,2
44,52,215201625,52227,Graffigny-Chemin,216,206,10
44,52,215204280,52228,Grandchamp,76,75,1
44,52,215201633,52229,Grenant,154,153,1
44,52,215201641,52230,Gudmont-Villiers,288,283,5
44,52,215201658,52231,Guindrecourt-aux-Ormes,91,89,2
44,52,215201666,52232,Guindrecourt-sur-Blaise,64,64,0
44,52,215201674,52233,Guyonvelle,105,103,2
44,52,215201682,52234,Hâcourt,44,41,3
44,52,215201690,52235,Hallignicourt,252,248,4
44,52,215201708,52237,Harréville-les-Chanteurs,283,274,9
44,52,215204314,52240,Heuilley-le-Grand,197,190,7
44,52,215201724,52242,Haute-Amance,980,964,16
44,52,215201732,52243,Huilliécourt,123,122,1
44,52,215201740,52244,Humbécourt,764,753,11
44,52,215201757,52245,Humberville,66,61,5
44,52,215201765,52246,Humes-Jorquenay,595,583,12
44,52,215201773,52247,Illoud,212,204,8
44,52,215201781,52248,Is-en-Bassigny,564,547,17
44,52,215201799,52249,Isômes,147,147,0
44,52,215201807,52250,Joinville,3070,3001,69
44,52,215201815,52251,Jonchery,1018,983,35
44,52,215201823,52253,Juzennecourt,213,210,3
44,52,215201831,52254,Lachapelle-en-Blaisy,87,86,1
44,52,215201849,52256,Lafauche,77,75,2
44,52,215201856,52257,Laferté-sur-Amance,107,105,2
44,52,215201864,52258,Laferté-sur-Aube,311,309,2
44,52,215201872,52260,Lamancine,125,123,2
44,52,215201898,52264,Laneuvelle,63,61,2
44,52,215201906,52265,Bayard-sur-Marne,1313,1286,27
44,52,200029759,52266,Laneuville-à-Rémy,66,65,1
44,52,215201914,52267,Laneuville-au-Pont,225,222,3
44,52,215201922,52269,Langres,8081,7682,399
44,52,215201930,52271,Lanques-sur-Rognon,209,203,6
44,52,215201948,52272,Lanty-sur-Aube,115,114,1
44,52,215201955,52273,Larivière-Arnoncourt,123,122,1
44,52,215201963,52274,Latrecey-Ormoy-sur-Aube,298,289,9
44,52,215201971,52275,Lavernoy,73,71,2
44,52,215201989,52276,Laville-aux-Bois,240,232,8
44,52,215201997,52277,Lavilleneuve,59,58,1
44,52,200031359,52278,Lavilleneuve-au-Roi,69,69,0
44,52,215204058,52280,Lecey,200,197,3
44,52,215202003,52282,Leffonds,340,335,5
44,52,215202011,52284,Leschères-sur-le-Blaiseron,91,90,1
44,52,215204256,52285,Leuchey,77,75,2
44,52,215202029,52286,Leurville,75,75,0
44,52,215202037,52287,Levécourt,91,89,2
44,52,215202045,52288,Lezéville,120,117,3
44,52,215202052,52289,Liffol-le-Petit,326,314,12
44,52,215202060,52290,Les Loges,131,129,2
44,52,215202078,52291,Longchamp,61,61,0
44,52,215202086,52292,Longeau-Percey,722,712,10
44,52,215202102,52294,Louvemont,705,694,11
44,52,215202110,52295,Louvières,94,94,0
44,52,215204116,52297,Luzy-sur-Marne,286,276,10
44,52,215202136,52298,Maâtz,73,72,1
44,52,215202144,52300,Magneux,163,161,2
44,52,215202151,52301,Maisoncelles,62,61,1
44,52,215202169,52302,Maizières,188,185,3
44,52,215202177,52303,Maizières-sur-Amance,97,96,1
44,52,215202185,52304,Malaincourt-sur-Meuse,53,52,1
44,52,215202193,52305,Mandres-la-Côte,560,555,5
44,52,215202201,52306,Manois,459,449,10
44,52,215202219,52307,Marac,222,213,9
44,52,215202227,52308,Maranville,404,400,4
44,52,215202235,52310,Marbéville,101,99,2
44,52,215202243,52311,Marcilly-en-Bassigny,228,224,4
44,52,215202250,52312,Mardor,59,56,3
44,52,215202268,52313,Mareilles,142,141,1
44,52,215202276,52315,Marnay-sur-Marne,340,339,1
44,52,215202284,52316,Mathons,72,70,2
44,52,215202292,52318,Melay,250,244,6
44,52,215202300,52319,Mennouveaux,70,69,1
44,52,215202318,52320,Merrey,95,92,3
44,52,215202326,52321,Mertrud,183,180,3
44,52,215202334,52322,Meures,136,132,4
44,52,215202342,52325,Millières,122,117,5
44,52,215202359,52326,Mirbel,41,41,0
44,52,215202367,52327,Moëslains,462,453,9
44,52,215202375,52328,Montcharvot,33,32,1
44,52,215202383,52330,Montheries,69,67,2
44,52,200059947,52331,La Porte du Der,2281,2225,56
44,52,215202409,52332,Val-de-Meuse,1873,1819,54
44,52,215203977,52335,Montot-sur-Rognon,115,114,1
44,52,215202417,52336,Montreuil-sur-Blaise,141,138,3
44,52,215202425,52337,Montreuil-sur-Thonnance,56,56,0
44,52,215202441,52341,Morancourt,133,131,2
44,52,215202458,52342,Morionvilliers,27,26,1
44,52,215202466,52344,Mouilleron,31,30,1
44,52,215202474,52346,Mussey-sur-Marne,391,385,6
44,52,215202482,52347,Narcy,235,231,4
44,52,215202490,52348,Neuilly-l'Évêque,592,571,21
44,52,215202508,52349,Neuilly-sur-Suize,310,302,8
44,52,215202516,52350,Neuvelle-lès-Voisey,66,66,0
44,52,215203951,52352,Ninville,70,65,5
44,52,215202532,52353,Nogent,3628,3567,61
44,52,215204322,52354,Noidant-Chatenoy,83,83,0
44,52,215202540,52355,Noidant-le-Rocheux,155,151,4
44,52,215202557,52356,Nomécourt,112,108,4
44,52,215202565,52357,Noncourt-sur-le-Rongeant,176,175,1
44,52,215202573,52358,Noyers,94,94,0
44,52,215204389,52359,Nully,147,145,2
44,52,215202599,52360,Occey,170,166,4
44,52,215202607,52362,Orbigny-au-Mont,139,137,2
44,52,215204132,52363,Orbigny-au-Val,105,98,7
44,52,215202615,52364,Orcevaux,105,102,3
44,52,215202623,52365,Orges,346,343,3
44,52,215202631,52366,Ormancey,77,76,1
44,52,215202649,52367,Ormoy-lès-Sexfontaines,42,41,1
44,52,215202656,52369,Orquevaux,69,69,0
44,52,215202664,52370,Osne-le-Val,260,255,5
44,52,215202672,52371,Oudincourt,140,138,2
44,52,215202680,52372,Outremécourt,89,83,6
44,52,215202698,52373,Ozières,33,32,1
44,52,215202706,52374,Le Pailly,277,272,5
44,52,215204330,52375,Palaiseul,54,54,0
44,52,215202714,52376,Pansey,110,108,2
44,52,215202722,52377,Parnoy-en-Bassigny,295,287,8
44,52,215202730,52378,Paroy-sur-Saulx,47,45,2
44,52,215202755,52380,Peigney,391,387,4
44,52,215202763,52383,Perrancey-les-Vieux-Moulins,299,292,7
44,52,215202771,52384,Perrogney-les-Fontaines,112,112,0
44,52,215202789,52385,Perrusse,31,30,1
44,52,215202797,52386,Perthes,512,507,5
44,52,215202805,52388,Pierremont-sur-Amance,154,152,2
44,52,215204249,52390,Pisseloup,60,59,1
44,52,215202813,52391,Planrupt,316,307,9
44,52,215204264,52392,Plesnoy,118,116,2
44,52,215202821,52393,Poinsenot,56,56,0
44,52,215204199,52394,Poinson-lès-Fayl,220,211,9
44,52,215202839,52395,Poinson-lès-Grancey,56,56,0
44,52,215202847,52396,Poinson-lès-Nogent,140,137,3
44,52,215204017,52397,Poiseul,69,68,1
44,52,215202854,52398,Poissons,635,622,13
44,52,215202862,52399,Pont-la-Ville,108,101,7
44,52,215202870,52400,Le Châtelet-sur-Meuse,157,157,0
44,52,215202888,52401,Poulangy,371,359,12
44,52,215202896,52403,Praslay,81,80,1
44,52,200055770,52405,Le Montsaugeonnais,1168,1149,19
44,52,215202912,52406,Pressigny,204,199,5
44,52,215202920,52407,Prez-sous-Lafauche,283,276,7
44,52,200059251,52411,Rives Dervoises,1367,1327,40
44,52,215202946,52413,Rachecourt-Suzémont,108,106,2
44,52,215202953,52414,Rachecourt-sur-Marne,771,760,11
44,52,215202961,52415,Rançonnières,120,120,0
44,52,215202979,52416,Rangecourt,63,62,1
44,52,215202987,52419,Rennepont,131,127,4
44,52,215202995,52420,Reynel,129,129,0
44,52,215203001,52421,Riaucourt,469,454,15
44,52,215203019,52422,Richebourg,264,259,5
44,52,215203027,52423,Rimaucourt,665,652,13
44,52,215203035,52424,Rivières-le-Bois,69,69,0
44,52,215203043,52425,Rivière-les-Fosses,194,192,2
44,52,215203050,52426,Rizaucourt-Buchey,131,130,1
44,52,215203076,52428,Rochefort-sur-la-Côte,65,64,1
44,52,215203084,52429,Roches-sur-Marne,576,565,11
44,52,215203092,52431,Rochetaillée,168,166,2
44,52,215203100,52432,Rolampont,1427,1398,29
44,52,215203118,52433,Romain-sur-Meuse,90,89,1
44,52,215203126,52436,Rouécourt,51,50,1
44,52,215203134,52437,Rouelles,25,25,0
44,52,215203142,52438,Rougeux,110,108,2
44,52,215203159,52439,Rouvres-sur-Aube,74,73,1
44,52,215203167,52440,Rouvroy-sur-Marne,381,375,6
44,52,215203175,52442,Rupt,355,345,10
44,52,215203183,52443,Sailly,33,33,0
44,52,215203191,52444,Saint-Blin,356,347,9
44,52,215203209,52445,Saint-Broingt-le-Bois,70,68,2
44,52,215203217,52446,Saint-Broingt-les-Fosses,236,234,2
44,52,215203225,52447,Saint-Ciergues,184,182,2
44,52,215203233,52448,Saint-Dizier,23566,23085,481
44,52,200059277,52449,Saints-Geosmes,1146,1115,31
44,52,215203258,52450,Saint-Loup-sur-Aujon,133,129,4
44,52,215203266,52452,Saint-Martin-lès-Langres,108,108,0
44,52,215203274,52453,Saint-Maurice,131,130,1
44,52,215203282,52455,Saint-Thiébault,241,235,6
44,52,215203290,52456,Saint-Urbain-Maconcourt,644,627,17
44,52,215203308,52457,Saint-Vallier-sur-Marne,174,172,2
44,52,215203316,52459,Sarcey,110,108,2
44,52,215203324,52461,Sarrey,392,382,10
44,52,215203332,52463,Saudron,45,44,1
44,52,215203340,52464,Saulles,51,49,2
44,52,200031334,52465,Saulxures,129,129,0
44,52,215204215,52467,Savigny,60,58,2
44,52,215204363,52468,Semilly,114,110,4
44,52,215203357,52469,Semoutiers-Montsaon,749,733,16
44,52,215203365,52470,Serqueux,382,368,14
44,52,215203373,52472,Sexfontaines,142,142,0
44,52,215203985,52473,Signéville,92,91,1
44,52,215203381,52474,Silvarouvres,34,34,0
44,52,215203399,52475,Sommancourt,62,56,6
44,52,215203407,52476,Sommerécourt,85,82,3
44,52,215203415,52479,Sommevoire,669,653,16
44,52,215203423,52480,Soncourt-sur-Marne,358,351,7
44,52,215203431,52482,Soulaucourt-sur-Mouzon,99,97,2
44,52,215203449,52483,Soyers,69,68,1
44,52,215203456,52484,Suzannecourt,376,361,15
44,52,215203464,52486,Ternat,64,62,2
44,52,215203472,52487,Thilleux,68,65,3
44,52,215203480,52488,Thivet,275,273,2
44,52,215203498,52489,Thol-lès-Millières,36,35,1
44,52,215203506,52490,Thonnance-lès-Joinville,688,668,20
44,52,215203514,52491,Thonnance-les-Moulins,121,116,5
44,52,215203522,52492,Torcenay,566,554,12
44,52,215204223,52493,Tornay,29,29,0
44,52,215203530,52494,Treix,224,216,8
44,52,215202581,52495,Trémilly,85,84,1
44,52,215203548,52497,Troisfontaines-la-Ville,444,434,10
44,52,215203555,52499,Vaillant,44,44,0
44,52,215203563,52500,Valcourt,628,620,8
44,52,215203571,52502,Valleret,66,66,0
44,52,215204165,52503,Valleroy,25,25,0
44,52,215203589,52504,Varennes-sur-Amance,265,260,5
44,52,215203597,52505,Vaudrecourt,34,34,0
44,52,215203605,52506,Vaudrémont,93,92,1
44,52,215203613,52507,Vauxbons,55,55,0
44,52,215203647,52510,Vaux-sur-Blaise,378,368,10
44,52,215203654,52511,Vaux-sur-Saint-Urbain,57,55,2
44,52,215203662,52512,Vecqueville,523,510,13
44,52,215204231,52513,Velles,62,61,1
44,52,215203670,52514,Verbiesles,356,345,11
44,52,215203688,52515,Verseilles-le-Bas,109,106,3
44,52,215203696,52516,Verseilles-le-Haut,54,50,4
44,52,215203704,52517,Vesaignes-sous-Lafauche,135,134,1
44,52,215203712,52518,Vesaignes-sur-Marne,104,102,2
44,52,215203720,52519,Vesvres-sous-Chalancey,46,46,0
44,52,215203738,52520,Vicq,156,153,3
44,52,215203746,52522,Viéville,346,336,10
44,52,215203993,52523,Vignes-la-Côte,72,68,4
44,52,215203753,52524,Vignory,231,228,3
44,52,215203761,52525,Villars-en-Azois,72,71,1
44,52,215203779,52526,Villars-Santenoge,79,78,1
44,52,215203787,52528,Ville-en-Blaisois,146,145,1
44,52,200056638,52529,Villegusien-le-Lac,996,980,16
44,52,215203811,52534,Villiers-en-Lieu,1514,1482,32
44,52,215203829,52535,Villiers-le-Sec,734,722,12
44,52,215203837,52536,Villiers-lès-Aprey,46,46,0
44,52,215203845,52538,Villiers-sur-Suize,268,265,3
44,52,215204348,52539,Violot,67,67,0
44,52,215203852,52540,Vitry-en-Montagne,21,21,0
44,52,215203860,52541,Vitry-lès-Nogent,214,210,4
44,52,215203878,52542,Vivey,53,51,2
44,52,215203886,52543,Voillecomte,525,515,10
44,52,215203894,52544,Voisey,279,277,2
44,52,215203902,52545,Voisines,109,107,2
44,52,215204173,52546,Voncourt,16,16,0
44,52,215203910,52547,Vouécourt,213,204,9
44,52,215203928,52548,Vraincourt,93,91,2
44,52,215203936,52549,Vroncourt-la-Côte,27,27,0
44,52,215203944,52550,Wassy,2885,2780,105
52,53,215300013,53001,Ahuillé,1903,1844,59
52,53,215300021,53002,Alexain,622,608,14
52,53,215300039,53003,Ambrières-les-Vallées,2693,2625,68
52,53,215300054,53005,Andouillé,2381,2321,60
52,53,215300070,53007,Argentré,2905,2831,74
52,53,215300088,53008,Aron,1878,1827,51
52,53,215300096,53009,Arquenay,684,670,14
52,53,215300104,53010,Assé-le-Bérenger,478,466,12
52,53,215300112,53011,Astillé,903,884,19
52,53,215300120,53012,Athée,490,466,24
52,53,215300138,53013,Averton,573,558,15
52,53,215300153,53015,La Baconnière,1983,1941,42
52,53,215300161,53016,Bais,1234,1217,17
52,53,200063675,53017,Val-du-Maine,987,959,28
52,53,215300187,53018,Ballots,1337,1305,32
52,53,215300195,53019,Bannes,121,118,3
52,53,215300211,53021,La Bazoge-Montpinçon,1055,1020,35
52,53,215300229,53022,La Bazouge-de-Chemeré,522,509,13
52,53,215300237,53023,La Bazouge-des-Alleux,569,557,12
52,53,215300252,53025,Bazougers,1106,1095,11
52,53,215300260,53026,Beaulieu-sur-Oudon,544,535,9
52,53,215300278,53027,Beaumont-Pied-de-Boeuf,207,204,3
52,53,215300286,53028,Belgeard,580,569,11
52,53,200084648,53029,Bierné-les-Villages,1285,1254,31
52,53,215300302,53030,Le Bignon-du-Maine,324,320,4
52,53,215300310,53031,La Bigottière,495,493,2
52,53,215300336,53033,La Boissière,119,115,4
52,53,215300344,53034,Bonchamp-lès-Laval,6381,6187,194
52,53,215300351,53035,Bouchamps-lès-Craon,601,592,9
52,53,215300369,53036,Bouère,1083,1062,21
52,53,215300377,53037,Bouessay,752,725,27
52,53,215300385,53038,Boulay-les-Ifs,143,139,4
52,53,215300393,53039,Le Bourgneuf-la-Forêt,1765,1732,33
52,53,215300401,53040,Bourgon,640,628,12
52,53,215300419,53041,Brains-sur-les-Marches,283,278,5
52,53,215300427,53042,Brecé,853,842,11
52,53,215300435,53043,Brée,575,564,11
52,53,215300450,53045,La Brûlatte,696,677,19
52,53,215300468,53046,Le Buret,309,306,3
52,53,215300476,53047,Carelles,273,269,4
52,53,215300484,53048,Chailland,1176,1144,32
52,53,215300492,53049,Châlons-du-Maine,716,708,8
52,53,215300518,53051,Champéon,615,607,8
52,53,215300526,53052,Champfrémont,292,285,7
52,53,215300534,53053,Champgenéteux,519,500,19
52,53,215300542,53054,Changé,6475,6313,162
52,53,215300559,53055,Chantrigné,615,600,15
52,53,215300567,53056,La Chapelle-Anthenaise,992,967,25
52,53,215300575,53057,La Chapelle-au-Riboul,514,506,8
52,53,215300583,53058,La Chapelle-Craonnaise,341,328,13
52,53,215300591,53059,La Chapelle-Rainsouin,422,416,6
52,53,215300617,53061,Charchigné,464,458,6
52,53,200084655,53062,Château-Gontier-sur-Mayenne,17535,16845,690
52,53,215300633,53063,Châtelain,466,451,15
52,53,215300641,53064,Châtillon-sur-Colmont,998,973,25
52,53,215300666,53066,Chemazé,1419,1386,33
52,53,215300674,53067,Chémeré-le-Roi,419,407,12
52,53,215300682,53068,Chérancé,150,150,0
52,53,215300690,53069,Chevaigné-du-Maine,158,154,4
52,53,215300716,53071,Colombiers-du-Plessis,507,484,23
52,53,215300724,53072,Commer,1307,1279,28
52,53,215300732,53073,Congrier,910,888,22
52,53,215300740,53074,Contest,879,843,36
52,53,215300757,53075,Cosmes,286,283,3
52,53,215300765,53076,Cossé-en-Champagne,333,323,10
52,53,215300773,53077,Cossé-le-Vivien,3302,3229,73
52,53,215300781,53078,Coudray,878,860,18
52,53,215300799,53079,Couesmes-Vaucé,386,378,8
52,53,215300807,53080,Couptrain,136,135,1
52,53,215300823,53082,Courbeveille,651,638,13
52,53,215300831,53083,Courcité,856,828,28
52,53,215300849,53084,Craon,4611,4456,155
52,53,215300856,53085,Crennes-sur-Fraubée,197,195,2
52,53,215300864,53086,La Croixille,648,635,13
52,53,215300872,53087,La Cropte,213,208,5
52,53,215300880,53088,Cuillé,855,827,28
52,53,215300898,53089,Daon,518,513,5
52,53,215300906,53090,Denazé,169,164,5
52,53,215300914,53091,Désertines,462,447,15
52,53,215300930,53093,La Dorée,279,278,1
52,53,215300948,53094,Entrammes,2291,2251,40
52,53,215300963,53096,Ernée,5746,5641,105
52,53,200084697,53097,Évron,8896,8667,229
52,53,215300989,53098,Fontaine-Couverte,436,427,9
52,53,215300997,53099,Forcé,1122,1089,33
52,53,215301003,53100,Fougerolles-du-Plessis,1181,1167,14
52,53,215301011,53101,Fromentières,846,835,11
52,53,215301029,53102,Gastines,168,167,1
52,53,215301037,53103,Le Genest-Saint-Isle,2181,2122,59
52,53,200084614,53104,Gennes-Longuefuye,1366,1337,29
52,53,215301052,53105,Gesnes,236,230,6
52,53,215301060,53106,Gesvres,530,518,12
52,53,215301078,53107,Gorron,2596,2543,53
52,53,215301086,53108,La Gravelle,577,571,6
52,53,215301094,53109,Grazay,638,621,17
52,53,215301102,53110,Grez-en-Bouère,1009,990,19
52,53,215301110,53111,La Haie-Traversaine,477,463,14
52,53,215301128,53112,Le Ham,386,376,10
52,53,215301136,53113,Hambers,627,616,11
52,53,215301144,53114,Hardanges,195,193,2
52,53,215301151,53115,Hercé,322,312,10
52,53,215301169,53116,Le Horps,737,720,17
52,53,215301177,53117,Houssay,507,502,5
52,53,215301185,53118,Le Housseau-Brétignolles,231,229,2
52,53,215301193,53119,L'Huisserie,4575,4415,160
52,53,215301201,53120,Izé,466,456,10
52,53,215301219,53121,Javron-les-Chapelles,1404,1375,29
52,53,215301227,53122,Jublains,774,758,16
52,53,215301235,53123,Juvigné,1446,1421,25
52,53,200076123,53124,Prée-d'Anjou,1432,1389,43
52,53,215301250,53125,Landivy,1164,1137,27
52,53,215301268,53126,Larchamp,1103,1080,23
52,53,215301276,53127,Lassay-les-Châteaux,2296,2239,57
52,53,215301284,53128,Laubrières,360,349,11
52,53,215301292,53129,Launay-Villiers,385,375,10
52,53,215301300,53130,Laval,52169,49617,2552
52,53,215301318,53131,Lesbois,196,194,2
52,53,215301326,53132,Levaré,294,283,11
52,53,215301334,53133,Lignières-Orgères,727,710,17
52,53,215301342,53134,Livet,180,179,1
52,53,215301359,53135,Livré-la-Touche,754,731,23
52,53,200084689,53136,La Roche-Neuville,1240,1201,39
52,53,200055705,53137,Loiron-Ruillé,2792,2740,52
52,53,215301391,53139,Loupfougères,419,411,8
52,53,215301409,53140,Louverné,4481,4365,116
52,53,215301417,53141,Louvigné,1184,1152,32
52,53,215301425,53142,Madré,296,291,5
52,53,215301433,53143,Maisoncelles-du-Maine,527,514,13
52,53,215301441,53144,Marcillé-la-Ville,780,755,25
52,53,215301458,53145,Marigné-Peuton,558,544,14
52,53,215301466,53146,Martigné-sur-Mayenne,1938,1902,36
52,53,215301474,53147,Mayenne,13495,12805,690
52,53,215301482,53148,Mée,238,237,1
52,53,215301508,53150,Ménil,923,894,29
52,53,215301516,53151,Méral,1136,1120,16
52,53,215301524,53152,Meslay-du-Maine,2862,2788,74
52,53,215301532,53153,Mézangers,640,629,11
52,53,215301540,53154,Montaudin,924,903,21
52,53,215301557,53155,Montenay,1370,1347,23
52,53,215301565,53156,Montflours,259,252,7
52,53,215301573,53157,Montigné-le-Brillant,1392,1337,55
52,53,215301581,53158,Montjean,1049,1036,13
52,53,215301607,53160,Montreuil-Poulay,382,375,7
52,53,200086106,53161,Montsûrs,3250,3191,59
52,53,215301623,53162,Moulay,1004,986,18
52,53,215301631,53163,Neau,783,779,4
52,53,215301649,53164,Neuilly-le-Vendin,353,345,8
52,53,215301656,53165,Niafles,360,353,7
52,53,215301680,53168,Nuillé-sur-Vicoin,1246,1220,26
52,53,215301698,53169,Olivet,421,412,9
52,53,215301706,53170,Oisseau,1173,1151,22
52,53,215301722,53172,Origné,410,402,8
52,53,215301730,53173,La Pallu,186,180,6
52,53,215301748,53174,Parigné-sur-Braye,860,836,24
52,53,215301755,53175,Parné-sur-Roc,1431,1383,48
52,53,215301763,53176,Le Pas,547,539,8
52,53,215301771,53177,La Pellerine,308,302,6
52,53,215301789,53178,Peuton,241,231,10
52,53,215301797,53179,Placé,357,352,5
52,53,215301805,53180,Pommerieux,666,642,24
52,53,215301813,53181,Pontmain,816,806,10
52,53,215301821,53182,Port-Brillet,1823,1795,28
52,53,215301847,53184,Préaux,168,163,5
52,53,200057032,53185,Pré-en-Pail-Saint-Samson,2379,2295,84
52,53,215301862,53186,Quelaines-Saint-Gault,2192,2131,61
52,53,215301870,53187,Ravigny,241,228,13
52,53,215301888,53188,Renazé,2580,2521,59
52,53,215301896,53189,Rennes-en-Grenouilles,106,106,0
52,53,215301904,53190,Le Ribay,478,468,10
52,53,215301912,53191,La Roë,253,251,2
52,53,215301920,53192,La Rouaudière,320,315,5
52,53,215301938,53193,Ruillé-Froid-Fonds,576,565,11
52,53,215301953,53195,Sacé,519,509,10
52,53,215301961,53196,Saint-Aignan-de-Couptrain,363,351,12
52,53,215301979,53197,Saint-Aignan-sur-Roë,926,903,23
52,53,215301987,53198,Saint-Aubin-du-Désert,234,227,7
52,53,215301995,53199,Saint-Aubin-Fosse-Louvain,220,216,4
52,53,215302001,53200,Saint-Baudelle,1216,1159,57
52,53,215302019,53201,Saint-Berthevin,7640,7381,259
52,53,215302027,53202,Saint-Berthevin-la-Tannière,307,303,4
52,53,215302035,53203,Saint-Brice,539,526,13
52,53,215302043,53204,Saint-Calais-du-Désert,400,388,12
52,53,215302068,53206,Saint-Charles-la-Forêt,206,196,10
52,53,215302084,53208,Saint-Cyr-en-Pail,511,497,14
52,53,215302092,53209,Saint-Cyr-le-Gravelais,571,557,14
52,53,215302100,53210,Saint-Denis-d'Anjou,1575,1545,30
52,53,215302118,53211,Saint-Denis-de-Gastines,1461,1429,32
52,53,215302126,53212,Saint-Denis-du-Maine,445,437,8
52,53,215302134,53213,Saint-Ellier-du-Maine,499,490,9
52,53,215302142,53214,Saint-Erblon,167,163,4
52,53,215302167,53216,Saint-Fraimbault-de-Prières,1012,987,25
52,53,215302183,53218,Sainte-Gemmes-le-Robert,816,791,25
52,53,215302191,53219,Saint-Georges-Buttavent,1434,1396,38
52,53,215302209,53220,Saint-Georges-le-Fléchard,388,380,8
52,53,215302217,53221,Saint-Georges-sur-Erve,405,396,9
52,53,215302225,53222,Saint-Germain-d'Anxure,373,365,8
52,53,215302233,53223,Saint-Germain-de-Coulamer,337,328,9
52,53,215302241,53224,Saint-Germain-le-Fouilloux,1217,1186,31
52,53,215302258,53225,Saint-Germain-le-Guillaume,526,517,9
52,53,215302266,53226,Saint-Hilaire-du-Maine,848,817,31
52,53,200062651,53228,Blandouet-Saint Jean,574,561,13
52,53,215302290,53229,Saint-Jean-sur-Mayenne,1697,1650,47
52,53,215302308,53230,Saint-Julien-du-Terroux,241,235,6
52,53,215302324,53232,Saint-Léger,315,312,3
52,53,215302332,53233,Saint-Loup-du-Dorat,341,339,2
52,53,215302340,53234,Saint-Loup-du-Gast,361,353,8
52,53,215302357,53235,Sainte-Marie-du-Bois,232,228,4
52,53,215302365,53236,Saint-Mars-du-Désert,171,170,1
52,53,215302373,53237,Saint-Mars-sur-Colmont,464,452,12
52,53,215302381,53238,Saint-Mars-sur-la-Futaie,528,519,9
52,53,215302407,53240,Saint-Martin-du-Limet,440,434,6
52,53,215302423,53242,Saint-Michel-de-la-Roë,261,258,3
52,53,215302431,53243,Saint-Ouën-des-Toits,1821,1782,39
52,53,215302456,53245,Saint-Pierre-des-Landes,946,923,23
52,53,215302464,53246,Saint-Pierre-des-Nids,1820,1785,35
52,53,215302472,53247,Saint-Pierre-la-Cour,2346,2298,48
52,53,215302480,53248,Saint-Pierre-sur-Erve,143,140,3
52,53,200094795,53249,Vimartin-sur-Orthe,1133,1120,13
52,53,215302506,53250,Saint-Poix,412,407,5
52,53,215302514,53251,Saint-Quentin-les-Anges,474,466,8
52,53,215302530,53253,Saint-Saturnin-du-Limet,523,519,4
52,53,200054716,53255,Sainte-Suzanne-et-Chammes,1267,1251,16
52,53,215302563,53256,Saint-Thomas-de-Courceriers,173,169,4
52,53,215302571,53257,Saulges,324,316,8
52,53,215302589,53258,La Selle-Craonnaise,935,908,27
52,53,215302597,53259,Senonnes,352,345,7
52,53,215302605,53260,Simplé,398,397,1
52,53,215302613,53261,Soucé,171,168,3
52,53,215302621,53262,Soulgé-sur-Ouette,1124,1093,31
52,53,215302639,53263,Thuboeuf,282,274,8
52,53,215302647,53264,Thorigné-en-Charnie,194,191,3
52,53,215302654,53265,Torcé-Viviers-en-Charnie,782,767,15
52,53,215302662,53266,Trans,230,226,4
52,53,215302670,53267,Vaiges,1197,1165,32
52,53,215302696,53269,Vautorte,618,613,5
52,53,215302704,53270,Vieuvy,117,108,9
52,53,215302712,53271,Villaines-la-Juhel,2755,2713,42
52,53,215302720,53272,Villepail,189,188,1
52,53,215302738,53273,Villiers-Charlemagne,1105,1083,22
52,53,215302761,53276,Voutré,946,930,16
44,54,215400011,54001,Abaucourt,311,306,5
44,54,215400029,54002,Abbéville-lès-Conflans,233,229,4
44,54,215400037,54003,Aboncourt,97,92,5
44,54,215400045,54004,Affléville,180,178,2
44,54,215400052,54005,Affracourt,111,110,1
44,54,215400060,54006,Agincourt,452,445,7
44,54,215400078,54007,Aingeray,535,531,4
44,54,215400086,54008,Allain,483,470,13
44,54,215400094,54009,Allamont,169,166,3
44,54,215400102,54010,Allamps,512,500,12
44,54,215400110,54011,Allondrelle-la-Malmaison,657,647,10
44,54,215400128,54012,Amance,359,354,5
44,54,215400136,54013,Amenoncourt,88,86,2
44,54,215400144,54014,Ancerviller,269,255,14
44,54,215400151,54015,Anderny,264,258,6
44,54,215400169,54016,Andilly,295,287,8
44,54,215400177,54017,Angomont,76,75,1
44,54,215400185,54018,Anoux,280,273,7
44,54,215400193,54019,Ansauville,79,78,1
44,54,215400201,54020,Anthelupt,455,447,8
44,54,215400219,54021,Armaucourt,234,233,1
44,54,215400227,54022,Arnaville,574,563,11
44,54,215400235,54023,Arracourt,250,248,2
44,54,215400243,54024,Arraye-et-Han,369,363,6
44,54,215400250,54025,Art-sur-Meurthe,1828,1620,208
44,54,215400268,54026,Athienville,179,176,3
44,54,215400276,54027,Atton,891,878,13
44,54,215400284,54028,Auboué,2688,2669,19
44,54,215400292,54029,Audun-le-Roman,2512,2465,47
44,54,215400300,54030,Autrepierre,81,81,0
44,54,215400318,54031,Autreville-sur-Moselle,264,260,4
44,54,215400326,54032,Autrey,192,188,4
44,54,215400334,54033,Avillers,134,134,0
44,54,215400342,54034,Avrainville,219,215,4
44,54,215400359,54035,Avricourt,392,388,4
44,54,215400367,54036,Avril,1203,1174,29
44,54,215400375,54037,Azelot,428,424,4
44,54,215400383,54038,Azerailles,768,750,18
44,54,215400391,54039,Baccarat,4221,4160,61
44,54,215400409,54040,Badonviller,1591,1559,32
44,54,215400417,54041,Bagneux,145,138,7
44,54,215400425,54042,Bainville-aux-Miroirs,281,279,2
44,54,215400433,54043,Bainville-sur-Madon,1459,1442,17
44,54,215400441,54044,Barbas,199,197,2
44,54,215400458,54045,Barbonville,435,427,8
44,54,215400466,54046,Barisey-au-Plain,401,394,7
44,54,215400474,54047,Barisey-la-Côte,265,260,5
44,54,215400482,54048,Les Baroches,347,344,3
44,54,215400490,54049,Baslieux,543,529,14
44,54,215400508,54050,Bathelémont,66,66,0
44,54,215400516,54051,Batilly,1312,1284,28
44,54,215400524,54052,Battigny,151,149,2
44,54,215400532,54053,Bauzemont,162,156,6
44,54,215400540,54054,Bayon,1548,1530,18
44,54,215400557,54055,Bayonville-sur-Mad,334,330,4
44,54,215400565,54056,Bazailles,147,144,3
44,54,215400573,54057,Beaumont,74,73,1
44,54,215400581,54058,Béchamps,87,87,0
44,54,215400599,54059,Belleau,762,752,10
44,54,215400607,54060,Belleville,1503,1484,19
44,54,215400615,54061,Bénaménil,596,586,10
44,54,215400623,54062,Benney,662,652,10
44,54,215400631,54063,Bernécourt,178,174,4
44,54,215400649,54064,Bertrambois,323,318,5
44,54,215400656,54065,Bertrichamps,1105,1086,19
44,54,215400664,54066,Bettainvillers,412,410,2
44,54,215400672,54067,Beuveille,782,765,17
44,54,215400680,54068,Beuvezin,95,92,3
44,54,215400698,54069,Beuvillers,480,471,9
44,54,215400706,54070,Bey-sur-Seille,179,179,0
44,54,215400714,54071,Bezange-la-Grande,162,161,1
44,54,215400722,54072,Bezaumont,267,262,5
44,54,215400730,54073,Bicqueley,939,923,16
44,54,215400748,54074,Bienville-la-Petite,37,37,0
44,54,215400755,54075,Bionville,121,119,2
44,54,215400763,54076,Blainville-sur-l'Eau,3991,3944,47
44,54,215400771,54077,Blâmont,1065,1053,12
44,54,215400789,54078,Blémerey,57,56,1
44,54,215400797,54079,Blénod-lès-Pont-à-Mousson,4669,4642,27
44,54,215400805,54080,Blénod-lès-Toul,1048,1031,17
44,54,215400813,54081,Boismont,425,419,6
44,54,215400821,54082,Boncourt,172,169,3
44,54,215400839,54083,Bonviller,178,175,3
44,54,215400847,54084,Mont-Bonvillers,958,943,15
44,54,215400854,54085,Borville,90,88,2
44,54,215400862,54086,Boucq,364,354,10
44,54,215400870,54087,Bouillonville,149,149,0
44,54,215400888,54088,Bouvron,244,242,2
44,54,215400896,54089,Bouxières-aux-Chênes,1426,1406,20
44,54,215400904,54090,Bouxières-aux-Dames,4190,4147,43
44,54,215400912,54091,Bouxières-sous-Froidmont,404,400,4
44,54,215400920,54092,Bouzanville,66,65,1
44,54,215400938,54093,Brainville,172,170,2
44,54,215400946,54094,Bralleville,174,171,3
44,54,215400953,54095,Bratte,46,46,0
44,54,215400961,54096,Bréhain-la-Ville,447,438,9
44,54,215400979,54097,Bréménil,101,98,3
44,54,215400987,54098,Brémoncourt,170,167,3
44,54,200063345,54099,Val de Briey,8269,8041,228
44,54,215401001,54100,Brin-sur-Seille,788,776,12
44,54,215401019,54101,Brouville,129,128,1
44,54,215401027,54102,Bruley,625,609,16
44,54,215401035,54103,Bruville,224,222,2
44,54,215401043,54104,Buissoncourt,259,257,2
44,54,215401050,54105,Bulligny,540,525,15
44,54,215401068,54106,Bures,64,63,1
44,54,215401076,54107,Buriville,78,74,4
44,54,215401084,54108,Burthecourt-aux-Chênes,150,144,6
44,54,215401092,54109,Ceintrey,944,931,13
44,54,215401100,54110,Cerville,572,560,12
44,54,215401118,54111,Chaligny,2821,2803,18
44,54,215401126,54112,Chambley-Bussières,726,718,8
44,54,215401134,54113,Champenoux,1544,1528,16
44,54,215401142,54114,Champey-sur-Moselle,331,326,5
44,54,215401159,54115,Champigneulles,6693,6633,60
44,54,215401167,54116,Chanteheux,2187,2148,39
44,54,215401175,54117,Chaouilley,119,116,3
44,54,215401183,54118,Charency-Vezin,615,605,10
44,54,215401191,54119,Charey,91,89,2
44,54,215401209,54120,Charmes-la-Côte,335,328,7
44,54,215401217,54121,Charmois,193,190,3
44,54,215401225,54122,Chaudeney-sur-Moselle,743,726,17
44,54,215401233,54123,Chavigny,1731,1719,12
44,54,215401241,54124,Chazelles-sur-Albe,49,46,3
44,54,215401258,54125,Chenevières,496,489,7
44,54,215401266,54126,Chenicourt,224,223,1
44,54,215401274,54127,Chenières,642,621,21
44,54,215401282,54128,Choloy-Ménillot,716,708,8
44,54,215401290,54129,Cirey-sur-Vezouze,1625,1600,25
44,54,215401308,54130,Clayeures,180,179,1
44,54,215401316,54131,Clémery,506,496,10
44,54,215401324,54132,Clérey-sur-Brenon,60,59,1
44,54,215407990,54133,Coincourt,121,117,4
44,54,215401340,54134,Colmey,249,242,7
44,54,215401357,54135,Colombey-les-Belles,1463,1443,20
44,54,215401365,54136,Conflans-en-Jarnisy,2410,2377,33
44,54,215401373,54137,Cons-la-Grandville,528,513,15
44,54,215401381,54138,Cosnes-et-Romain,2829,2773,56
44,54,215401399,54139,Courbesseaux,378,373,5
44,54,215401407,54140,Courcelles,92,92,0
44,54,215401415,54141,Coyviller,155,153,2
44,54,215401423,54142,Crantenoy,157,154,3
44,54,215401431,54143,Crépey,391,385,6
44,54,215401449,54144,Crévéchamps,388,382,6
44,54,215401456,54145,Crévic,951,939,12
44,54,215401464,54146,Crézilles,295,292,3
44,54,215401472,54147,Crion,110,108,2
44,54,215401480,54148,Croismare,654,645,9
44,54,215401498,54149,Crusnes,1588,1565,23
44,54,215401506,54150,Custines,3136,3106,30
44,54,215401514,54151,Cutry,1079,1051,28
44,54,215401522,54152,Damelevières,3165,3124,41
44,54,215401530,54153,Dampvitoux,58,56,2
44,54,215401548,54154,Deneuvre,497,476,21
44,54,215401555,54155,Deuxville,410,402,8
44,54,215401563,54156,Diarville,500,484,16
44,54,215401571,54157,Dieulouard,4750,4712,38
44,54,215401589,54158,Dolcourt,143,141,2
44,54,215401597,54159,Dombasle-sur-Meurthe,9923,9733,190
44,54,215401605,54160,Domèvre-en-Haye,412,404,8
44,54,215401613,54161,Domèvre-sur-Vezouze,324,314,10
44,54,215401621,54162,Domgermain,1175,1158,17
44,54,215401639,54163,Domjevin,261,260,1
44,54,215401647,54164,Dommarie-Eulmont,90,88,2
44,54,215401654,54165,Dommartemont,583,572,11
44,54,215401662,54166,Dommartin-la-Chaussée,32,30,2
44,54,215401670,54167,Dommartin-lès-Toul,1986,1943,43
44,54,215401688,54168,Dommartin-sous-Amance,304,302,2
44,54,215401696,54169,Domprix,100,97,3
44,54,215401704,54170,Domptail-en-l'Air,73,72,1
44,54,215401712,54171,Doncourt-lès-Conflans,1161,1141,20
44,54,215401720,54172,Doncourt-lès-Longuyon,294,288,6
44,54,215401738,54173,Drouville,222,218,4
44,54,215401746,54174,Écrouves,4512,4454,58
44,54,215401753,54175,Einvaux,376,373,3
44,54,215401761,54176,Einville-au-Jard,1122,1098,24
44,54,215401779,54177,Emberménil,257,254,3
44,54,215401787,54178,Épiez-sur-Chiers,201,198,3
44,54,215401795,54179,Éply,307,303,4
44,54,215401803,54180,Erbéviller-sur-Amezule,72,70,2
44,54,215401811,54181,Errouville,707,690,17
44,54,215401829,54182,Essey-et-Maizerais,335,324,11
44,54,215401837,54183,Essey-la-Côte,74,74,0
44,54,215401845,54184,Essey-lès-Nancy,9037,8841,196
44,54,215401852,54185,Étreval,60,59,1
44,54,215401860,54186,Eulmont,1130,1109,21
44,54,215401878,54187,Euvezin,111,111,0
44,54,215401886,54188,Faulx,1375,1365,10
44,54,215401894,54189,Favières,607,600,7
44,54,215401902,54190,Fécocourt,114,111,3
44,54,215401910,54191,Fenneviller,104,102,2
44,54,215401928,54192,Ferrières,317,313,4
44,54,215401936,54193,Fey-en-Haye,73,71,2
44,54,215401944,54194,Fillières,519,510,9
44,54,215401951,54195,Flainval,193,189,4
44,54,215401969,54196,Flavigny-sur-Moselle,1832,1724,108
44,54,215401977,54197,Fléville-devant-Nancy,2226,2205,21
44,54,215401985,54198,Fléville-Lixières,307,303,4
44,54,215401993,54199,Flin,394,384,10
44,54,215402009,54200,Flirey,161,160,1
44,54,215402017,54201,Fontenoy-la-Joûte,309,306,3
44,54,215402025,54202,Fontenoy-sur-Moselle,383,373,10
44,54,215402033,54203,Forcelles-Saint-Gorgon,143,140,3
44,54,215402041,54204,Forcelles-sous-Gugney,94,92,2
44,54,215402058,54205,Foug,2648,2619,29
44,54,215402066,54206,Fraimbois,399,394,5
44,54,215402074,54207,Fraisnes-en-Saintois,101,95,6
44,54,215402082,54208,Francheville,294,289,5
44,54,215402090,54209,Franconville,64,64,0
44,54,215402108,54210,Fréménil,217,215,2
44,54,215402116,54211,Frémonville,199,196,3
44,54,215402124,54212,Fresnois-la-Montagne,424,411,13
44,54,215402132,54213,Friauville,376,371,5
44,54,215402140,54214,Frolois,714,705,9
44,54,215402157,54215,Frouard,6610,6543,67
44,54,215402165,54216,Froville,124,124,0
44,54,215402173,54217,Gélacourt,172,170,2
44,54,215402181,54218,Gélaucourt,54,53,1
44,54,215402199,54219,Gellenoncourt,82,82,0
44,54,215402207,54220,Gémonville,77,77,0
44,54,215402215,54221,Gerbécourt-et-Haplemont,231,230,1
44,54,215402223,54222,Gerbéviller,1353,1330,23
44,54,215402231,54223,Germiny,209,208,1
44,54,215402249,54224,Germonville,124,123,1
44,54,215402256,54225,Gézoncourt,183,180,3
44,54,215402264,54226,Gibeaumeix,174,172,2
44,54,215402272,54227,Giraumont,1365,1349,16
44,54,215402280,54228,Giriviller,73,70,3
44,54,215402298,54229,Glonville,373,367,6
44,54,215402306,54230,Gogney,52,52,0
44,54,215402314,54231,Gondrecourt-Aix,182,179,3
44,54,215402322,54232,Gondreville,2722,2672,50
44,54,215402330,54233,Gondrexon,36,34,2
44,54,215402348,54234,Gorcy,2950,2907,43
44,54,215402355,54235,Goviller,429,420,9
44,54,215402363,54236,Grand-Failly,368,360,8
44,54,215402371,54237,Grimonviller,96,95,1
44,54,215402389,54238,Gripport,269,268,1
44,54,215402397,54239,Griscourt,142,141,1
44,54,215402405,54240,Grosrouvres,54,54,0
44,54,215402413,54241,Gugney,78,75,3
44,54,215402421,54242,Gye,277,274,3
44,54,215402439,54243,Hablainville,224,217,7
44,54,215402447,54244,Hagéville,113,110,3
44,54,215402454,54245,Haigneville,62,62,0
44,54,215402462,54246,Halloville,71,65,6
44,54,215402470,54247,Hammeville,182,178,4
44,54,215402488,54248,Hamonville,100,100,0
44,54,215402496,54249,Hannonville-Suzémont,256,253,3
44,54,215402504,54250,Haraucourt,742,736,6
44,54,215402512,54251,Harbouey,130,129,1
44,54,215402520,54252,Haroué,513,507,6
44,54,215402538,54253,Hatrize,787,775,12
44,54,215402546,54254,Haucourt-Moulaine,3458,3416,42
44,54,215402553,54255,Haudonville,89,83,6
44,54,215402561,54256,Haussonville,315,307,8
44,54,215402579,54257,Heillecourt,5428,5346,82
44,54,215402587,54258,Hénaménil,148,146,2
44,54,215402595,54259,Herbéviller,234,231,3
44,54,215402603,54260,Hériménil,952,937,15
44,54,215402611,54261,Herserange,4386,4330,56
44,54,215402629,54262,Hoéville,196,196,0
44,54,215402637,54263,Homécourt,6302,6245,57
44,54,215402645,54264,Houdelmont,320,320,0
44,54,215402652,54265,Houdemont,2131,2091,40
44,54,215402660,54266,Houdreville,414,404,10
44,54,215402686,54268,Housséville,142,138,4
44,54,215402694,54269,Hudiviller,352,345,7
44,54,215402702,54270,Hussigny-Godbrange,3925,3860,65
44,54,215402710,54271,Igney,127,121,6
44,54,215402728,54272,Jaillon,467,464,3
44,54,215402736,54273,Jarny,8369,8190,179
44,54,215402744,54274,Jarville-la-Malgrange,9620,9396,224
44,54,215402751,54275,Jaulny,190,184,6
44,54,215402769,54276,Jeandelaincourt,794,787,7
44,54,215402777,54277,Jeandelize,374,372,2
44,54,215402785,54278,Jevoncourt,102,101,1
44,54,215402793,54279,Jezainville,1010,990,20
44,54,215402801,54280,Joeuf,6636,6583,53
44,54,215402819,54281,Jolivet,910,894,16
44,54,215402827,54282,Joppécourt,165,161,4
44,54,215402835,54283,Jouaville,292,286,6
44,54,215402843,54284,Joudreville,1142,1121,21
44,54,215402850,54285,Juvrecourt,56,55,1
44,54,215402868,54286,Labry,1612,1580,32
44,54,215402876,54287,Lachapelle,269,268,1
44,54,215402884,54288,Lagney,499,495,4
44,54,215402892,54289,Laître-sous-Amance,372,362,10
44,54,215402900,54290,Laix,214,210,4
44,54,215402918,54291,Laloeuf,296,294,2
44,54,215402926,54292,Lamath,187,184,3
44,54,215402934,54293,Landécourt,88,84,4
44,54,215402942,54294,Landremont,146,144,2
44,54,215402959,54295,Landres,1081,971,110
44,54,215402967,54296,Laneuvelotte,435,432,3
44,54,215402975,54297,Laneuveville-aux-Bois,307,304,3
44,54,215402983,54298,Laneuveville-derrière-Foug,156,155,1
44,54,215402991,54299,Laneuveville-devant-Bayon,233,227,6
44,54,215403007,54300,Laneuveville-devant-Nancy,6657,6548,109
44,54,215403015,54301,Lanfroicourt,128,127,1
44,54,215403023,54302,Lantéfontaine,754,737,17
44,54,215403031,54303,Laronxe,369,366,3
44,54,215403049,54304,Laxou,14631,14445,186
44,54,215403056,54305,Lay-Saint-Christophe,2428,2380,48
44,54,215403064,54306,Lay-Saint-Remy,344,339,5
44,54,215403072,54307,Lebeuville,171,167,4
44,54,215403080,54308,Leintrey,150,147,3
44,54,215403098,54309,Lemainville,396,393,3
44,54,215403106,54310,Leménil-Mitry,3,3,0
44,54,215403114,54311,Lenoncourt,601,593,8
44,54,215403122,54312,Lesménils,491,487,4
44,54,215403130,54313,Létricourt,232,231,1
44,54,215403148,54314,Lexy,3906,3845,61
44,54,215403155,54315,Leyr,916,905,11
44,54,215403163,54316,Limey-Remenauville,308,303,5
44,54,215403171,54317,Lironville,138,132,6
44,54,215403189,54318,Liverdun,5819,5749,70
44,54,215403205,54320,Loisy,329,325,4
44,54,215403213,54321,Longlaville,2394,2367,27
44,54,215403221,54322,Longuyon,5285,5223,62
44,54,215403239,54323,Longwy,15357,15117,240
44,54,215403247,54324,Lorey,88,87,1
44,54,215403254,54325,Loromontzey,87,79,8
44,54,215403262,54326,Lubey,229,219,10
44,54,215403270,54327,Lucey,642,628,14
44,54,215403288,54328,Ludres,6219,6128,91
44,54,215403296,54329,Lunéville,18160,17858,302
44,54,215403304,54330,Lupcourt,432,423,9
44,54,215403312,54331,Magnières,285,279,6
44,54,215403320,54332,Maidières,1546,1530,16
44,54,215403338,54333,Mailly-sur-Seille,264,250,14
44,54,215403346,54334,Mairy-Mainville,571,560,11
44,54,215403353,54335,Maixe,412,408,4
44,54,215403361,54336,Maizières,926,915,11
44,54,215403379,54337,Malavillers,132,129,3
44,54,215403387,54338,Malleloy,1005,992,13
44,54,215403395,54339,Malzéville,8330,8036,294
44,54,215403403,54340,Mamey,344,340,4
44,54,215403437,54343,Mandres-aux-Quatre-Tours,194,188,6
44,54,215403445,54344,Mangonville,219,215,4
44,54,215403452,54345,Manoncourt-en-Vermois,346,341,5
44,54,215403460,54346,Manoncourt-en-Woëvre,252,249,3
44,54,215403486,54348,Manonville,246,237,9
44,54,215403494,54349,Manonviller,168,166,2
44,54,215403502,54350,Marainviller,708,700,8
44,54,215403510,54351,Marbache,1700,1685,15
44,54,215403528,54352,Maron,833,824,9
44,54,215403536,54353,Mars-la-Tour,916,901,15
44,54,215403544,54354,Marthemont,48,48,0
44,54,215403551,54355,Martincourt,93,92,1
44,54,215403569,54356,Mattexey,69,67,2
44,54,215403577,54357,Maxéville,9931,9816,115
44,54,215403585,54358,Mazerulles,284,279,5
44,54,215403593,54359,Méhoncourt,247,244,3
44,54,215403601,54360,Ménil-la-Tour,345,337,8
44,54,215403627,54362,Mercy-le-Bas,1289,1282,7
44,54,215403635,54363,Mercy-le-Haut,280,274,6
44,54,215403643,54364,Méréville,1307,1288,19
44,54,215403650,54365,Merviller,335,325,10
44,54,215403668,54366,Messein,2000,1982,18
44,54,215403676,54367,Mexy,2331,2265,66
44,54,215403684,54368,Mignéville,177,174,3
44,54,215403692,54369,Millery,619,611,8
44,54,215403700,54370,Minorville,227,225,2
44,54,215403718,54371,Moineville,1085,1065,20
44,54,215403726,54372,Moivrons,519,516,3
44,54,215403734,54373,Moncel-lès-Lunéville,615,611,4
44,54,215403742,54374,Moncel-sur-Seille,530,521,9
44,54,215403759,54375,Montauville,1103,1087,16
44,54,215403767,54376,Montenoy,414,407,7
44,54,215403775,54377,Montigny,160,160,0
44,54,215403783,54378,Montigny-sur-Chiers,477,470,7
44,54,215403791,54379,Mont-l'Étroit,96,96,0
44,54,215403809,54380,Mont-le-Vignoble,413,403,10
44,54,215403817,54381,Montreux,56,54,2
44,54,215403825,54382,Mont-Saint-Martin,9130,9020,110
44,54,215403833,54383,Mont-sur-Meurthe,1133,1122,11
44,54,215403858,54385,Morfontaine,1105,1081,24
44,54,215403866,54386,Moriviller,94,93,1
44,54,215403874,54387,Morville-sur-Seille,153,153,0
44,54,215408006,54388,Mouacourt,76,74,2
44,54,215403890,54389,Mouaville,103,101,2
44,54,215403908,54390,Mousson,103,101,2
44,54,215403916,54391,Moutiers,1593,1568,25
44,54,215403924,54392,Moutrot,314,312,2
44,54,215403932,54393,Moyen,542,533,9
44,54,215403940,54394,Murville,251,246,5
44,54,215403957,54395,Nancy,105885,104403,1482
44,54,215403965,54396,Neufmaisons,232,224,8
44,54,215403973,54397,Neuves-Maisons,6684,6629,55
44,54,215403981,54398,Neuviller-lès-Badonviller,98,97,1
44,54,215403999,54399,Neuviller-sur-Moselle,251,250,1
44,54,215404005,54400,Nomeny,1161,1139,22
44,54,215404013,54401,Nonhigny,126,121,5
44,54,215404021,54402,Norroy-le-Sec,424,413,11
44,54,215404039,54403,Norroy-lès-Pont-à-Mousson,1223,1188,35
44,54,215404047,54404,Noviant-aux-Prés,272,267,5
44,54,215404054,54405,Ochey,524,524,0
44,54,215404062,54406,Ogéviller,285,278,7
44,54,215404070,54407,Ognéville,98,95,3
44,54,215404088,54408,Olley,231,228,3
44,54,215404096,54409,Omelmont,193,190,3
44,54,215404104,54410,Onville,519,516,3
44,54,215408022,54411,Ormes-et-Ville,225,219,6
44,54,215404120,54412,Othe,42,39,3
44,54,215404138,54413,Ozerailles,152,151,1
44,54,215404146,54414,Pagney-derrière-Barine,661,653,8
44,54,215404153,54415,Pagny-sur-Moselle,4109,4053,56
44,54,215404161,54416,Pannes,180,179,1
44,54,215404179,54417,Parey-Saint-Césaire,245,239,6
44,54,215404187,54418,Parroy,172,171,1
44,54,215404195,54419,Parux,74,74,0
44,54,215404203,54420,Petit-Failly,88,87,1
44,54,215404211,54421,Petitmont,318,313,5
44,54,215404229,54422,Pettonville,70,69,1
44,54,215404237,54423,Pexonne,349,339,10
44,54,215404245,54424,Phlin,45,44,1
44,54,215404252,54425,Piennes,2496,2476,20
44,54,215404260,54426,Pierre-la-Treiche,480,474,6
44,54,215404278,54427,Pierre-Percée,96,95,1
44,54,215404286,54428,Pierrepont,862,851,11
44,54,215404294,54429,Pierreville,299,297,2
44,54,215404302,54430,Pompey,4908,4857,51
44,54,215404310,54431,Pont-à-Mousson,14550,14357,193
44,54,215404328,54432,Pont-Saint-Vincent,1852,1813,39
44,54,215404336,54433,Port-sur-Seille,235,228,7
44,54,215404344,54434,Praye,252,250,2
44,54,215404351,54435,Prény,370,365,5
44,54,215404369,54436,Preutin-Higny,156,152,4
44,54,215404377,54437,Pulligny,1168,1149,19
44,54,215404385,54438,Pulney,55,55,0
44,54,215404393,54439,Pulnoy,5200,5135,65
44,54,215404401,54440,Puxe,122,122,0
44,54,215404419,54441,Puxieux,236,231,5
44,54,215404427,54442,Quevilloncourt,98,96,2
44,54,215404435,54443,Raon-lès-Leau,38,38,0
44,54,215404443,54444,Raucourt,227,224,3
44,54,215404450,54445,Raville-sur-Sânon,101,101,0
44,54,215404468,54446,Réchicourt-la-Petite,66,64,2
44,54,215404476,54447,Réclonville,77,74,3
44,54,215404492,54449,Rehainviller,1065,1049,16
44,54,215404500,54450,Reherrey,145,144,1
44,54,215404518,54451,Réhon,3872,3799,73
44,54,215404526,54452,Reillon,75,73,2
44,54,215404534,54453,Rembercourt-sur-Mad,160,159,1
44,54,215404559,54455,Remenoville,160,156,4
44,54,215404567,54456,Réméréville,614,604,10
44,54,215404575,54457,Remoncourt,43,43,0
44,54,215404583,54458,Repaix,110,109,1
44,54,215404591,54459,Richardménil,2333,2308,25
44,54,215404609,54460,Rogéville,154,151,3
44,54,215404617,54461,Romain,71,69,2
44,54,215404625,54462,Rosières-aux-Salines,2885,2851,34
44,54,215404633,54463,Rosières-en-Haye,231,229,2
44,54,215404641,54464,Rouves,106,106,0
44,54,215404658,54465,Roville-devant-Bayon,772,761,11
44,54,215404666,54466,Royaumeix,407,402,5
44,54,215404674,54467,Rozelieures,191,188,3
44,54,215404682,54468,Saffais,113,111,2
44,54,215404690,54469,Saint-Ail,419,414,5
44,54,215404708,54470,Saint-Baussant,77,75,2
44,54,215404716,54471,Saint-Boingt,73,72,1
44,54,215404724,54472,Saint-Clément,865,853,12
44,54,215404732,54473,Saint-Firmin,291,285,6
44,54,215404740,54474,Sainte-Geneviève,198,198,0
44,54,215404757,54475,Saint-Germain,160,154,6
44,54,215404765,54476,Saint-Jean-lès-Longuyon,424,414,10
44,54,215404773,54477,Saint-Julien-lès-Gorze,165,162,3
44,54,215404781,54478,Saint-Marcel,151,150,1
44,54,215404799,54479,Saint-Mard,100,99,1
44,54,215404807,54480,Saint-Martin,57,56,1
44,54,215404815,54481,Saint-Maurice-aux-Forges,101,98,3
44,54,215404823,54482,Saint-Max,10139,10046,93
44,54,215404831,54483,Saint-Nicolas-de-Port,7452,7383,69
44,54,215404849,54484,Sainte-Pôle,190,183,7
44,54,215404856,54485,Saint-Pancré,314,309,5
44,54,215404864,54486,Saint-Remimont,351,345,6
44,54,215404872,54487,Saint-Rémy-aux-Bois,63,63,0
44,54,215404880,54488,Saint-Sauveur,34,34,0
44,54,215404898,54489,Saint-Supplet,156,152,4
44,54,215404906,54490,Saizerais,1487,1464,23
44,54,215404914,54491,Sancy,339,335,4
44,54,215404922,54492,Sanzey,157,154,3
44,54,215404930,54493,Saulnes,2399,2362,37
44,54,215404948,54494,Saulxerotte,101,101,0
44,54,215404955,54495,Saulxures-lès-Nancy,4279,4220,59
44,54,215404963,54496,Saulxures-lès-Vannes,378,374,4
44,54,215404971,54497,Saxon-Sion,110,107,3
44,54,215404989,54498,Seichamps,5177,5111,66
44,54,215404997,54499,Seicheprey,114,110,4
44,54,215405002,54500,Selaincourt,185,182,3
44,54,215405010,54501,Seranville,101,101,0
44,54,215405028,54502,Serres,243,242,1
44,54,215405044,54504,Serrouville,672,657,15
44,54,215405051,54505,Sexey-aux-Forges,732,724,8
44,54,215405077,54507,Sionviller,104,102,2
44,54,215405085,54508,Sivry,244,239,5
44,54,215405093,54509,Sommerviller,1001,996,5
44,54,215405101,54510,Sornéville,311,305,6
44,54,215405119,54511,Sponville,115,111,4
44,54,215405127,54512,Tanconville,108,106,2
44,54,215405135,54513,Tantonville,649,646,3
44,54,215405143,54514,Tellancourt,637,622,15
44,54,215405150,54515,Thélod,250,250,0
44,54,215405168,54516,They-sous-Vaudemont,19,18,1
44,54,215405176,54517,Thézey-Saint-Martin,204,202,2
44,54,215405184,54518,Thiaucourt-Regniéville,1119,1113,6
44,54,215405192,54519,Thiaville-sur-Meurthe,602,594,8
44,54,215405200,54520,Thiébauménil,390,382,8
44,54,215405218,54521,Thil,1987,1968,19
44,54,215405226,54522,Thorey-Lyautey,137,135,2
44,54,215407982,54523,Thuilley-aux-Groseilles,424,423,1
44,54,215405242,54524,Thumeréville,92,90,2
44,54,215405259,54525,Tiercelet,663,654,9
44,54,215405267,54526,Tomblaine,9224,8941,283
44,54,215405275,54527,Tonnoy,689,664,25
44,54,215405283,54528,Toul,16107,15857,250
44,54,215405291,54529,Tramont-Émy,28,28,0
44,54,215405309,54530,Tramont-Lassus,92,88,4
44,54,215405317,54531,Tramont-Saint-André,59,59,0
44,54,215405325,54532,Tremblecourt,166,163,3
44,54,215405333,54533,Trieux,2651,2620,31
44,54,215405341,54534,Trondes,543,523,20
44,54,215405358,54535,Tronville,204,198,6
44,54,215405366,54536,Tucquegnieux,2446,2422,24
44,54,215405374,54537,Ugny,722,692,30
44,54,215405382,54538,Uruffe,374,371,3
44,54,215405390,54539,Vacqueville,243,230,13
44,54,215405408,54540,Val-et-Châtillon,574,569,5
44,54,215405416,54541,Valhey,167,165,2
44,54,215405424,54542,Valleroy,2351,2315,36
44,54,215405432,54543,Vallois,151,147,4
44,54,215405440,54544,Vandelainville,141,139,2
44,54,215405457,54545,Vandeléville,215,211,4
44,54,215405465,54546,Vandières,937,929,8
44,54,215405473,54547,Vandoeuvre-lès-Nancy,30039,29723,316
44,54,215405481,54548,Vannes-le-Châtel,533,523,10
44,54,215405499,54549,Varangéville,3641,3600,41
44,54,215405507,54550,Vathiménil,328,320,8
44,54,215405515,54551,Vaucourt,61,59,2
44,54,215405523,54552,Vaudémont,66,65,1
44,54,215405531,54553,Vaudeville,150,146,4
44,54,215408030,54554,Vaudigny,79,78,1
44,54,215405556,54555,Vaxainville,87,87,0
44,54,215405564,54556,Vého,111,108,3
44,54,200084457,54557,Bois-de-Haye,2415,2318,97
44,54,215405580,54558,Velaine-sous-Amance,285,280,5
44,54,215405598,54559,Velle-sur-Moselle,313,311,2
44,54,215405606,54560,Veney,52,52,0
44,54,215405614,54561,Vennezey,47,44,3
44,54,215405622,54562,Verdenal,149,147,2
44,54,215405630,54563,Vézelise,1379,1361,18
44,54,215405648,54564,Viéville-en-Haye,145,141,4
44,54,215405655,54565,Vigneulles,237,235,2
44,54,215405663,54566,Vilcey-sur-Trey,151,150,1
44,54,215405671,54567,Villacourt,367,356,11
44,54,215405689,54568,Ville-au-Montois,275,263,12
44,54,215405697,54569,Ville-au-Val,195,191,4
44,54,215405705,54570,Villecey-sur-Mad,345,340,5
44,54,215405713,54571,Ville-en-Vermois,599,592,7
44,54,215405721,54572,Ville-Houdlémont,695,690,5
44,54,215405739,54573,Villers-en-Haye,165,165,0
44,54,215405747,54574,Villers-la-Chèvre,568,549,19
44,54,215405754,54575,Villers-la-Montagne,1569,1538,31
44,54,215405762,54576,Villers-le-Rond,122,121,1
44,54,215405770,54577,Villers-lès-Moivrons,142,141,1
44,54,215405788,54578,Villers-lès-Nancy,14603,14305,298
44,54,215405796,54579,Villers-sous-Prény,340,333,7
44,54,215405804,54580,Villerupt,10206,10098,108
44,54,215405812,54581,Ville-sur-Yron,307,298,9
44,54,215405820,54582,Villette,186,185,1
44,54,215405838,54583,Villey-le-Sec,428,420,8
44,54,215405846,54584,Villey-Saint-Étienne,1043,1021,22
44,54,215405853,54585,Virecourt,501,494,7
44,54,215405861,54586,Viterne,752,741,11
44,54,215405879,54587,Vitrey,193,190,3
44,54,215405887,54588,Vitrimont,402,393,9
44,54,215405895,54589,Vittonville,132,127,5
44,54,215405903,54590,Viviers-sur-Chiers,679,660,19
44,54,215405911,54591,Voinémont,344,332,12
44,54,215405929,54592,Vroncourt,265,262,3
44,54,215405937,54593,Waville,440,431,9
44,54,215405945,54594,Xammes,167,166,1
44,54,215405952,54595,Xermaménil,570,564,6
44,54,215405960,54596,Xeuilley,976,969,7
44,54,215405978,54597,Xirocourt,446,443,3
44,54,215405986,54598,Xivry-Circourt,277,270,7
44,54,215405994,54599,Xonville,109,109,0
44,54,215406000,54600,Xousse,126,124,2
44,54,215408014,54601,Xures,104,101,3
44,54,215408048,54602,Han-devant-Pierrepont,148,148,0
44,55,215500018,55001,Abainville,294,285,9
44,55,215500026,55002,Abaucourt-Hautecourt,104,101,3
44,55,215500042,55004,Aincreville,81,81,0
44,55,215500059,55005,Amanty,37,36,1
44,55,215500075,55007,Ambly-sur-Meuse,244,242,2
44,55,215500083,55008,Amel-sur-l'Étang,149,144,5
44,55,215500091,55009,Ancemont,555,536,19
44,55,215500109,55010,Ancerville,2688,2617,71
44,55,215500117,55011,Andernay,259,256,3
44,55,215500125,55012,Apremont-la-Forêt,430,422,8
44,55,215500133,55013,Arrancy-sur-Crusnes,474,466,8
44,55,215500141,55014,Aubréville,367,360,7
44,55,215500158,55015,Aulnois-en-Perthois,500,489,11
44,55,215500174,55017,Autrécourt-sur-Aire,123,118,5
44,55,215500182,55018,Autréville-Saint-Lambert,42,40,2
44,55,215500216,55021,Avillers-Sainte-Croix,73,68,5
44,55,215500224,55022,Avioth,148,141,7
44,55,215500232,55023,Avocourt,121,120,1
44,55,215500240,55024,Azannes-et-Soumazannes,164,161,3
44,55,215500257,55025,Baâlon,278,276,2
44,55,215500265,55026,Badonvilliers-Gérauvilliers,134,129,5
44,55,215500273,55027,Bannoncourt,163,160,3
44,55,215500281,55028,Bantheville,114,110,4
44,55,215500299,55029,Bar-le-Duc,15135,14592,543
44,55,215500315,55031,Baudonvilliers,383,378,5
44,55,215500323,55032,Baudrémont,44,44,0
44,55,215500331,55033,Baulny,20,19,1
44,55,215500349,55034,Bazeilles-sur-Othain,114,113,1
44,55,215500356,55035,Bazincourt-sur-Saulx,151,145,6
44,55,215500364,55036,Beauclair,94,93,1
44,55,215500372,55037,Beaufort-en-Argonne,142,139,3
44,55,215500380,55038,Beaulieu-en-Argonne,40,38,2
44,55,215500398,55039,Beaumont-en-Verdunois,0,0,0
44,55,215500406,55040,Beausite,259,253,6
44,55,215500414,55041,Behonne,623,607,16
44,55,215500422,55042,Belleray,539,527,12
44,55,215500430,55043,Belleville-sur-Meuse,3073,3020,53
44,55,215500448,55044,Belrain,34,31,3
44,55,215500455,55045,Belrupt-en-Verdunois,560,551,9
44,55,215500463,55046,Beney-en-Woëvre,135,131,4
44,55,215500471,55047,Béthelainville,165,159,6
44,55,215500489,55048,Béthincourt,38,38,0
44,55,215500497,55049,Beurey-sur-Saulx,423,422,1
44,55,215500505,55050,Bezonvaux,0,0,0
44,55,215500513,55051,Biencourt-sur-Orge,121,121,0
44,55,215500539,55053,Billy-sous-Mangiennes,370,368,2
44,55,215500547,55054,Bislée,65,61,4
44,55,215500554,55055,Blanzée,14,13,1
44,55,215500570,55057,Boinville-en-Woëvre,79,77,2
44,55,215500588,55058,Boncourt-sur-Meuse,336,326,10
44,55,215500596,55059,Bonnet,197,190,7
44,55,200040913,55060,Bonzée,366,353,13
44,55,215500612,55061,Le Bouchon-sur-Saulx,243,237,6
44,55,215500620,55062,Bouconville-sur-Madt,110,109,1
44,55,215500638,55063,Bouligny,2488,2448,40
44,55,215500646,55064,Bouquemont,109,109,0
44,55,215500653,55065,Boureuilles,117,117,0
44,55,215500661,55066,Bovée-sur-Barboure,131,129,2
44,55,215500679,55067,Boviolles,100,99,1
44,55,215500687,55068,Brabant-en-Argonne,107,107,0
44,55,215500695,55069,Brabant-le-Roi,234,227,7
44,55,215500703,55070,Brabant-sur-Meuse,125,119,6
44,55,215500711,55071,Brandeville,184,181,3
44,55,215500729,55072,Braquis,108,107,1
44,55,215500737,55073,Bras-sur-Meuse,734,683,51
44,55,215500752,55075,Brauvilliers,179,175,4
44,55,215500760,55076,Bréhéville,178,174,4
44,55,215500778,55077,Breux,272,263,9
44,55,215500786,55078,Brieulles-sur-Meuse,304,296,8
44,55,215500794,55079,Brillon-en-Barrois,719,698,21
44,55,215500802,55080,Brixey-aux-Chanoines,83,79,4
44,55,215500810,55081,Brizeaux,59,59,0
44,55,215500828,55082,Brocourt-en-Argonne,46,46,0
44,55,215500836,55083,Brouennes,159,155,4
44,55,215500844,55084,Broussey-en-Blois,58,56,2
44,55,215500851,55085,Broussey-Raulecourt,291,287,4
44,55,215500877,55087,Bure,85,79,6
44,55,215500885,55088,Burey-en-Vaux,156,152,4
44,55,215500893,55089,Burey-la-Côte,89,88,1
44,55,215500935,55093,Buxières-sous-les-Côtes,289,282,7
44,55,215500943,55094,Buzy-Darmont,550,541,9
44,55,215500950,55095,Cesse,106,102,4
44,55,215500968,55096,Chaillon,111,110,1
44,55,215500976,55097,Chalaines,317,310,7
44,55,215500992,55099,Champneuville,124,123,1
44,55,215501008,55100,Champougny,82,75,7
44,55,215501016,55101,Chardogne,305,297,8
44,55,215501024,55102,Charny-sur-Meuse,547,527,20
44,55,215501032,55103,Charpentry,23,21,2
44,55,215501040,55104,Chassey-Beaupré,82,79,3
44,55,215501057,55105,Châtillon-sous-les-Côtes,181,177,4
44,55,215501065,55106,Chattancourt,182,177,5
44,55,215501073,55107,Chaumont-devant-Damvillers,47,47,0
44,55,215501081,55108,Chaumont-sur-Aire,126,122,4
44,55,215501099,55109,Chauvency-le-Château,238,231,7
44,55,215501107,55110,Chauvency-Saint-Hubert,230,224,6
44,55,215501115,55111,Chauvoncourt,457,437,20
44,55,215501131,55113,Cheppy,159,155,4
44,55,215501149,55114,Chonville-Malaumont,209,205,4
44,55,215501156,55115,Cierges-sous-Montfaucon,46,46,0
44,55,215501164,55116,Le Claon,55,53,2
44,55,215501172,55117,Clermont-en-Argonne,1484,1449,35
44,55,215508441,55118,Cléry-le-Grand,96,94,2
44,55,215501198,55119,Cléry-le-Petit,190,189,1
44,55,215501206,55120,Combles-en-Barrois,801,778,23
44,55,215501214,55121,Combres-sous-les-Côtes,119,116,3
44,55,215501222,55122,Commercy,5578,5352,226
44,55,215501230,55123,Les Hauts-de-Chée,725,711,14
44,55,215501248,55124,Consenvoye,312,308,4
44,55,215501255,55125,Contrisson,805,787,18
44,55,215501271,55127,Courcelles-en-Barrois,42,42,0
44,55,215501289,55128,Courcelles-sur-Aire,42,41,1
44,55,215501297,55129,Courouvre,38,37,1
44,55,215501321,55132,Cousances-les-Forges,1703,1675,28
44,55,215501339,55133,Couvertpuis,89,85,4
44,55,215501347,55134,Couvonges,156,152,4
44,55,215501370,55137,Cuisy,47,47,0
44,55,200043891,55138,Culey,130,127,3
44,55,215501396,55139,Cumières-le-Mort-Homme,0,0,0
44,55,215501404,55140,Cunel,18,18,0
44,55,215501412,55141,Dagonville,83,83,0
44,55,215501420,55142,Dainville-Bertheléville,129,123,6
44,55,215501438,55143,Damloup,133,125,8
44,55,215501446,55144,Dammarie-sur-Saulx,390,379,11
44,55,215501453,55145,Damvillers,693,618,75
44,55,215501461,55146,Dannevoux,207,197,10
44,55,215501487,55148,Delouze-Rosières,116,114,2
44,55,215501495,55149,Delut,120,120,0
44,55,200086486,55150,Demange-Baudignécourt,524,512,12
44,55,215501537,55153,Dieppe-sous-Douaumont,196,194,2
44,55,215501545,55154,Dieue-sur-Meuse,1488,1441,47
44,55,215501552,55155,Dombasle-en-Argonne,400,393,7
44,55,215501560,55156,Dombras,141,137,4
44,55,215501578,55157,Dommartin-la-Montagne,52,52,0
44,55,215501586,55158,Dommary-Baroncourt,731,723,8
44,55,215501594,55159,Dompcevrin,356,353,3
44,55,215501602,55160,Dompierre-aux-Bois,38,38,0
44,55,215501628,55162,Domremy-la-Canne,33,33,0
44,55,215501636,55163,Doncourt-aux-Templiers,57,54,3
44,55,215501651,55165,Doulcon,438,429,9
44,55,215501669,55166,Dugny-sur-Meuse,1339,1313,26
44,55,215501677,55167,Dun-sur-Meuse,656,637,19
44,55,215501685,55168,Duzey,45,45,0
44,55,215501693,55169,Écouviez,520,515,5
44,55,215501701,55170,Écurey-en-Verdunois,116,115,1
44,55,215501719,55171,Eix,263,259,4
44,55,215501727,55172,Les Éparges,62,61,1
44,55,215501735,55173,Épiez-sur-Meuse,42,39,3
44,55,215501743,55174,Épinonville,78,78,0
44,55,215501750,55175,Érize-la-Brûlée,188,184,4
44,55,215501776,55177,Érize-la-Petite,49,45,4
44,55,215501784,55178,Érize-Saint-Dizier,191,187,4
44,55,215501792,55179,Erneville-aux-Bois,147,145,2
44,55,215501800,55180,Esnes-en-Argonne,147,136,11
44,55,215501818,55181,Étain,3564,3492,72
44,55,215501826,55182,Éton,210,207,3
44,55,215501834,55183,Étraye,38,37,1
44,55,215501842,55184,Euville,1675,1644,31
44,55,215501859,55185,Èvres,94,89,5
44,55,215501867,55186,Fains-Véel,2143,2093,50
44,55,215501883,55188,Flassigny,45,44,1
44,55,215501891,55189,Fleury-devant-Douaumont,0,0,0
44,55,215501917,55191,Foameix-Ornel,230,225,5
44,55,215501925,55192,Fontaines-Saint-Clair,40,39,1
44,55,215501933,55193,Forges-sur-Meuse,126,124,2
44,55,215501941,55194,Foucaucourt-sur-Thabas,60,60,0
44,55,215501958,55195,Fouchères-aux-Bois,126,123,3
44,55,215501966,55196,Frémeréville-sous-les-Côtes,127,126,1
44,55,215501974,55197,Fresnes-au-Mont,170,166,4
44,55,215501982,55198,Fresnes-en-Woëvre,670,657,13
44,55,215501990,55199,Froidos,90,88,2
44,55,215502006,55200,Fromeréville-les-Vallons,211,207,4
44,55,215502014,55201,Fromezey,61,61,0
44,55,215502022,55202,Futeau,148,145,3
44,55,215502048,55204,Génicourt-sur-Meuse,297,292,5
44,55,215502063,55206,Gercourt-et-Drillancourt,113,107,6
44,55,215502071,55207,Géry,54,53,1
44,55,215502089,55208,Gesnes-en-Argonne,59,57,2
44,55,215502105,55210,Gimécourt,42,40,2
44,55,215502113,55211,Gincrey,64,64,0
44,55,215502121,55212,Girauvoisin,82,82,0
44,55,215502147,55214,Givrauval,294,278,16
44,55,215502154,55215,Gondrecourt-le-Château,1082,1065,17
44,55,215502162,55216,Gouraincourt,64,64,0
44,55,215502170,55217,Goussaincourt,119,115,4
44,55,215502188,55218,Gremilly,41,41,0
44,55,215502196,55219,Grimaucourt-en-Woëvre,103,101,2
44,55,215502204,55220,Grimaucourt-près-Sampigny,85,83,2
44,55,215502212,55221,Guerpont,248,243,5
44,55,215502220,55222,Gussainville,33,31,2
44,55,215502246,55224,Haironville,591,578,13
44,55,215502253,55225,Halles-sous-les-Côtes,145,139,6
44,55,215502261,55226,Han-lès-Juvigny,124,123,1
44,55,215502287,55228,Hannonville-sous-les-Côtes,552,542,10
44,55,215502295,55229,Han-sur-Meuse,272,269,3
44,55,215502329,55232,Harville,112,112,0
44,55,215502360,55236,Haudainville,959,935,24
44,55,215502378,55237,Haudiomont,233,232,1
44,55,215502394,55239,Haumont-près-Samogneux,0,0,0
44,55,215502410,55241,Heippes,81,77,4
44,55,215502428,55242,Hennemont,114,110,4
44,55,215502436,55243,Herbeuville,186,181,5
44,55,215502444,55244,Herméville-en-Woëvre,231,228,3
44,55,215502451,55245,Heudicourt-sous-les-Côtes,166,164,2
44,55,215502469,55246,Hévilliers,152,152,0
44,55,215502477,55247,Horville-en-Ornois,53,48,5
44,55,215502485,55248,Houdelaincourt,284,279,5
44,55,215502501,55250,Inor,189,181,8
44,55,215502519,55251,Ippécourt,108,105,3
44,55,215502527,55252,Iré-le-Sec,157,155,2
44,55,215502535,55253,Les Islettes,719,708,11
44,55,215502543,55254,Les Trois-Domaines,126,123,3
44,55,215502550,55255,Jametz,266,260,6
44,55,215502568,55256,Jonville-en-Woëvre,149,147,2
44,55,215502576,55257,Jouy-en-Argonne,42,42,0
44,55,215502584,55258,Geville,634,619,15
44,55,215502600,55260,Julvécourt,55,53,2
44,55,215502618,55261,Juvigny-en-Perthois,145,143,2
44,55,215502626,55262,Juvigny-sur-Loison,269,267,2
44,55,215502634,55263,Koeur-la-Grande,161,160,1
44,55,215502642,55264,Koeur-la-Petite,267,261,6
44,55,215502659,55265,Labeuville,144,139,5
44,55,215502667,55266,Lachalade,49,48,1
44,55,215502675,55267,Lachaussée,284,276,8
44,55,215502683,55268,Lacroix-sur-Meuse,707,691,16
44,55,215502691,55269,Lahaymeix,74,74,0
44,55,215502709,55270,Lahayville,30,30,0
44,55,215502717,55271,Laheycourt,370,365,5
44,55,215502725,55272,Laimont,449,431,18
44,55,215502741,55274,Lamorville,296,290,6
44,55,215502758,55275,Lamouilly,89,85,4
44,55,215502766,55276,Landrecourt-Lempire,219,217,2
44,55,215502782,55278,Laneuville-au-Rupt,197,194,3
44,55,215502790,55279,Laneuville-sur-Meuse,452,445,7
44,55,215502808,55280,Lanhères,59,58,1
44,55,215502816,55281,Latour-en-Woëvre,94,94,0
44,55,215502824,55282,Lavallée,99,96,3
44,55,215502840,55284,Lavincourt,73,73,0
44,55,215502857,55285,Lavoye,155,151,4
44,55,215502865,55286,Lemmes,238,237,1
44,55,215502881,55288,Lérouville,1427,1410,17
44,55,215502899,55289,Levoncourt,60,59,1
44,55,215502907,55290,Lignières-sur-Aire,57,55,2
44,55,215502915,55291,Ligny-en-Barrois,4038,3909,129
44,55,215502923,55292,Liny-devant-Dun,195,189,6
44,55,215502931,55293,Lion-devant-Dun,175,172,3
44,55,215502956,55295,Lisle-en-Barrois,32,31,1
44,55,215502964,55296,L'Isle-en-Rigault,482,475,7
44,55,215502972,55297,Lissey,114,113,1
44,55,200043883,55298,Loisey,303,294,9
44,55,215502998,55299,Loison,120,118,2
44,55,215503004,55300,Longeaux,227,221,6
44,55,215503012,55301,Longchamps-sur-Aire,127,119,8
44,55,215503020,55302,Longeville-en-Barrois,1145,1114,31
44,55,215503038,55303,Loupmont,76,72,4
44,55,215503046,55304,Louppy-le-Château,166,160,6
44,55,215503061,55306,Louppy-sur-Loison,114,113,1
44,55,215503079,55307,Louvemont-Côte-du-Poivre,0,0,0
44,55,215503103,55310,Luzy-Saint-Martin,116,112,4
44,55,215503111,55311,Maizeray,28,27,1
44,55,215503129,55312,Maizey,173,167,6
44,55,215503137,55313,Malancourt,70,68,2
44,55,215503152,55315,Mandres-en-Barrois,121,117,4
44,55,215503160,55316,Mangiennes,413,406,7
44,55,215503178,55317,Manheulles,151,144,7
44,55,215503202,55320,Marchéville-en-Woëvre,68,66,2
44,55,215503210,55321,Marre,170,168,2
44,55,215503228,55322,Marson-sur-Barboure,51,50,1
44,55,215503236,55323,Martincourt-sur-Meuse,70,69,1
44,55,215503244,55324,Marville,530,517,13
44,55,215503251,55325,Maucourt-sur-Orne,51,50,1
44,55,215503269,55326,Maulan,111,108,3
44,55,215503277,55327,Mauvages,250,248,2
44,55,215503285,55328,Maxey-sur-Vaise,290,285,5
44,55,215503293,55329,Mécrin,216,211,5
44,55,215503301,55330,Méligny-le-Grand,92,90,2
44,55,215503319,55331,Méligny-le-Petit,78,77,1
44,55,215503327,55332,Menaucourt,239,238,1
44,55,215503335,55333,Ménil-aux-Bois,44,43,1
44,55,215503343,55334,Ménil-la-Horgne,165,164,1
44,55,215503350,55335,Ménil-sur-Saulx,258,250,8
44,55,215503368,55336,Merles-sur-Loison,153,151,2
44,55,215503384,55338,Milly-sur-Bradon,152,148,4
44,55,215503392,55339,Mogeville,76,75,1
44,55,215503400,55340,Mognéville,379,371,8
44,55,215503418,55341,Moirey-Flabas-Crépion,126,122,4
44,55,215503434,55343,Montblainville,60,58,2
44,55,215503442,55344,Montbras,22,22,0
44,55,215503459,55345,Mont-devant-Sassey,103,101,2
44,55,215503467,55346,Montfaucon-d'Argonne,300,293,7
44,55,215503475,55347,Les Monthairons,342,339,3
44,55,215503483,55348,Montiers-sur-Saulx,371,368,3
44,55,215503491,55349,Montigny-devant-Sassey,118,118,0
44,55,215503509,55350,Montigny-lès-Vaucouleurs,76,76,0
44,55,215503517,55351,Montmédy,2124,2040,84
44,55,215503525,55352,Montplonne,160,143,17
44,55,215503533,55353,Montsec,80,79,1
44,55,215503558,55355,Montzéville,156,155,1
44,55,215503566,55356,Moranville,105,104,1
44,55,215503574,55357,Morgemoulin,111,108,3
44,55,215503582,55358,Chanteraine,192,188,4
44,55,215503590,55359,Morley,208,206,2
44,55,215503608,55360,Mouilly,110,109,1
44,55,215503616,55361,Moulainville,128,128,0
44,55,215503624,55362,Moulins-Saint-Hubert,184,181,3
44,55,215503632,55363,Moulotte,91,90,1
44,55,215503640,55364,Mouzay,688,660,28
44,55,215503657,55365,Murvaux,144,141,3
44,55,215503665,55366,Val-d'Ornain,1042,1008,34
44,55,215503673,55367,Muzeray,141,137,4
44,55,215503681,55368,Naives-en-Blois,155,148,7
44,55,215503699,55369,Naives-Rosières,821,805,16
44,55,215503707,55370,Naix-aux-Forges,229,227,2
44,55,215503731,55371,Nançois-le-Grand,79,76,3
44,55,215503723,55372,Nançois-sur-Ornain,376,367,9
44,55,215505876,55373,Nant-le-Grand,87,82,5
44,55,215503749,55374,Nant-le-Petit,76,75,1
44,55,215503756,55375,Nantillois,64,63,1
44,55,215503764,55376,Nantois,90,86,4
44,55,215503772,55377,Nepvant,94,93,1
44,55,215503780,55378,Nettancourt,243,241,2
44,55,215503798,55379,Le Neufour,68,66,2
44,55,215503806,55380,Neuville-en-Verdunois,53,52,1
44,55,215503814,55381,Neuville-lès-Vaucouleurs,165,165,0
44,55,215503822,55382,Neuville-sur-Ornain,374,366,8
44,55,215503830,55383,Neuvilly-en-Argonne,217,216,1
44,55,215503848,55384,Nicey-sur-Aire,130,126,4
44,55,215503855,55385,Nixéville-Blercourt,509,493,16
44,55,215508458,55386,Nonsard-Lamarche,224,221,3
44,55,215503871,55387,Nouillonpont,245,241,4
44,55,215503889,55388,Noyers-Auzécourt,280,276,4
44,55,215503897,55389,Nubécourt,253,247,6
44,55,215503913,55391,Olizy-sur-Chiers,204,198,6
44,55,215503947,55394,Ornes,7,7,0
44,55,215503954,55395,Osches,62,59,3
44,55,215503962,55396,Ourches-sur-Meuse,228,224,4
44,55,215503970,55397,Pagny-la-Blanche-Côte,238,234,4
44,55,215503988,55398,Pagny-sur-Meuse,1022,1006,16
44,55,215503996,55399,Pareid,119,115,4
44,55,215504002,55400,Parfondrupt,43,43,0
44,55,215504010,55401,Les Paroches,425,415,10
44,55,215504036,55403,Peuvillers,64,63,1
44,55,215504044,55404,Pierrefitte-sur-Aire,325,319,6
44,55,215504051,55405,Pillon,256,252,4
44,55,215504069,55406,Pintheville,114,110,4
44,55,215504077,55407,Pont-sur-Meuse,135,129,6
44,55,215504085,55408,Pouilly-sur-Meuse,179,171,8
44,55,215504093,55409,Pretz-en-Argonne,66,64,2
44,55,215504101,55410,Quincy-Landzécourt,138,133,5
44,55,215504119,55411,Rambluzin-et-Benoite-Vaux,100,99,1
44,55,215504127,55412,Rambucourt,190,185,5
44,55,215504143,55414,Rancourt-sur-Ornain,181,180,1
44,55,215504150,55415,Ranzières,88,87,1
44,55,215504168,55416,Rarécourt,233,225,8
44,55,215504192,55419,Récicourt,159,157,2
44,55,215504200,55420,Récourt-le-Creux,77,77,0
44,55,215504218,55421,Reffroy,80,75,5
44,55,215504226,55422,Regnéville-sur-Meuse,52,51,1
44,55,215504234,55423,Rembercourt-Sommaisne,326,318,8
44,55,215504242,55424,Remennecourt,48,47,1
44,55,215504259,55425,Remoiville,133,133,0
44,55,215504267,55426,Resson,397,384,13
44,55,215504275,55427,Revigny-sur-Ornain,2838,2794,44
44,55,215504283,55428,Réville-aux-Bois,127,126,1
44,55,215504291,55429,Riaville,49,49,0
44,55,215504309,55430,Ribeaucourt,68,67,1
44,55,215504317,55431,Richecourt,57,57,0
44,55,215504333,55433,Rigny-la-Salle,367,362,5
44,55,215504341,55434,Rigny-Saint-Martin,51,49,2
44,55,215504358,55435,Robert-Espagne,794,771,23
44,55,215504366,55436,Les Roises,28,28,0
44,55,215504374,55437,Romagne-sous-les-Côtes,125,122,3
44,55,215504382,55438,Romagne-sous-Montfaucon,190,186,4
44,55,215504390,55439,Ronvaux,102,95,7
44,55,215504424,55442,Raival,250,245,5
44,55,215504432,55443,Rouvres-en-Woëvre,597,591,6
44,55,215504440,55444,Rouvrois-sur-Meuse,212,210,2
44,55,215504457,55445,Rouvrois-sur-Othain,198,190,8
44,55,215504465,55446,Rumont,90,86,4
44,55,215504473,55447,Rupt-aux-Nonains,377,370,7
44,55,215504481,55448,Rupt-devant-Saint-Mihiel,45,44,1
44,55,215504499,55449,Rupt-en-Woëvre,288,284,4
44,55,215504507,55450,Rupt-sur-Othain,47,45,2
44,55,215504523,55452,Saint-Amand-sur-Ornain,53,53,0
44,55,215504531,55453,Saint-André-en-Barrois,66,64,2
44,55,215504549,55454,Saint-Aubin-sur-Aire,178,169,9
44,55,215504564,55456,Saint-Germain-sur-Meuse,231,225,6
44,55,200040848,55457,Saint-Hilaire-en-Woëvre,191,185,6
44,55,215504580,55458,Saint-Jean-lès-Buzy,380,380,0
44,55,215504598,55459,Saint-Joire,239,237,2
44,55,215504606,55460,Saint-Julien-sous-les-Côtes,142,140,2
44,55,215504614,55461,Saint-Laurent-sur-Othain,470,455,15
44,55,215504622,55462,Saint-Maurice-sous-les-Côtes,346,335,11
44,55,215504630,55463,Saint-Mihiel,4070,4000,70
44,55,215504648,55464,Saint-Pierrevillers,155,153,2
44,55,215504655,55465,Saint-Remy-la-Calonne,102,102,0
44,55,215504663,55466,Salmagne,294,290,4
44,55,215504671,55467,Sampigny,709,696,13
44,55,215504689,55468,Samogneux,99,99,0
44,55,215504697,55469,Sassey-sur-Meuse,91,91,0
44,55,215504705,55470,Saudrupt,195,193,2
44,55,215504713,55471,Saulmory-Villefranche,82,81,1
44,55,215504721,55472,Saulvaux,121,116,5
44,55,215504739,55473,Saulx-lès-Champlon,123,111,12
44,55,215504747,55474,Sauvigny,230,226,4
44,55,215504754,55475,Sauvoy,65,64,1
44,55,215504762,55476,Savonnières-devant-Bar,482,469,13
44,55,215504770,55477,Savonnières-en-Perthois,417,402,15
44,55,215504796,55479,Seigneulles,163,160,3
44,55,215504812,55481,Senon,329,324,5
44,55,215504820,55482,Senoncourt-les-Maujouy,105,103,2
44,55,215504846,55484,Septsarges,47,47,0
44,55,215504853,55485,Sepvigny,71,70,1
44,55,215508417,55487,Seuzey,90,88,2
44,55,215504887,55488,Silmont,151,146,5
44,55,215504895,55489,Sivry-la-Perche,281,276,5
44,55,215504903,55490,Sivry-sur-Meuse,338,333,5
44,55,215504929,55492,Sommedieue,999,988,11
44,55,215504937,55493,Sommeilles,189,183,6
44,55,215504945,55494,Sommelonne,439,419,20
44,55,215504952,55495,Sorbey,243,242,1
44,55,215504960,55496,Sorcy-Saint-Martin,1074,1047,27
44,55,215504978,55497,Les Souhesmes-Rampont,322,319,3
44,55,215504986,55498,Souilly,457,452,5
44,55,215505009,55500,Spincourt,837,825,12
44,55,215505017,55501,Stainville,392,382,10
44,55,215505025,55502,Stenay,2623,2492,131
44,55,215505033,55503,Taillancourt,126,124,2
44,55,215505041,55504,Tannois,410,405,5
44,55,215505058,55505,Thierville-sur-Meuse,3263,3167,96
44,55,215505066,55506,Thillombois,31,31,0
44,55,215505074,55507,Thillot,216,214,2
44,55,215505082,55508,Thonne-la-Long,364,351,13
44,55,215505090,55509,Thonne-le-Thil,281,276,5
44,55,215505108,55510,Thonne-les-Près,132,129,3
44,55,215505116,55511,Thonnelle,121,118,3
44,55,215505124,55512,Tilly-sur-Meuse,283,279,4
44,55,215505140,55514,Trémont-sur-Saulx,615,605,10
44,55,215505157,55515,Trésauvaux,69,68,1
44,55,215505165,55516,Tréveray,559,552,7
44,55,215505173,55517,Seuil-d'Argonne,516,510,6
44,55,215505181,55518,Cousances-lès-Triconville,147,145,2
44,55,215505199,55519,Tronville-en-Barrois,1360,1343,17
44,55,215505207,55520,Troussey,488,477,11
44,55,215505215,55521,Troyon,236,235,1
44,55,215505223,55522,Ugny-sur-Meuse,113,110,3
44,55,215505231,55523,Vacherauville,192,188,4
44,55,215505256,55525,Vadelaincourt,76,75,1
44,55,215505264,55526,Vadonville,267,263,4
44,55,215505272,55527,Varennes-en-Argonne,646,635,11
44,55,215505280,55528,Varnéville,50,50,0
44,55,215505306,55530,Valbois,93,92,1
44,55,215505314,55531,Vassincourt,304,283,21
44,55,215505322,55532,Vaubecourt,318,313,5
44,55,215505330,55533,Vaucouleurs,1953,1929,24
44,55,215505348,55534,Vaudeville-le-Haut,53,53,0
44,55,215505355,55535,Vaudoncourt,90,90,0
44,55,215505363,55536,Vauquois,21,19,2
44,55,200086445,55537,Douaumont-Vaux,79,79,0
44,55,215508425,55540,Vaux-lès-Palameix,62,59,3
44,55,215505413,55541,Vavincourt,536,527,9
44,55,215505439,55543,Velaines,943,925,18
44,55,215505447,55544,Velosnes,149,148,1
44,55,215505454,55545,Verdun,17846,16877,969
44,55,215505462,55546,Verneuil-Grand,215,207,8
44,55,215505470,55547,Verneuil-Petit,118,114,4
44,55,215505496,55549,Véry,90,89,1
44,55,215505512,55551,Vigneulles-lès-Hattonchâtel,1658,1566,92
44,55,215505520,55552,Vigneul-sous-Montmédy,85,81,4
44,55,215505538,55553,Vignot,1319,1299,20
44,55,215505546,55554,Villécloye,282,268,14
44,55,215505553,55555,Ville-devant-Belrain,33,32,1
44,55,215505561,55556,Ville-devant-Chaumont,50,49,1
44,55,215505579,55557,Ville-en-Woëvre,124,124,0
44,55,215505595,55559,Villeroy-sur-Méholle,54,52,2
44,55,215505603,55560,Villers-aux-Vents,134,130,4
44,55,215505611,55561,Villers-devant-Dun,52,51,1
44,55,215505629,55562,Villers-le-Sec,126,126,0
44,55,215505637,55563,Villers-lès-Mangiennes,79,77,2
44,55,215505652,55565,Villers-sous-Pareid,80,77,3
44,55,215505660,55566,Villers-sur-Meuse,304,298,6
44,55,215505678,55567,Ville-sur-Cousances,144,141,3
44,55,215505686,55568,Ville-sur-Saulx,282,277,5
44,55,215505694,55569,Villotte-devant-Louppy,170,165,5
44,55,215505702,55570,Villotte-sur-Aire,219,212,7
44,55,215505710,55571,Vilosnes-Haraumont,240,235,5
44,55,215505728,55572,Vittarville,90,89,1
44,55,215505736,55573,Void-Vacon,1650,1621,29
44,55,215505744,55574,Vouthon-Bas,45,43,2
44,55,215505751,55575,Vouthon-Haut,89,89,0
44,55,215505777,55577,Waly,59,57,2
44,55,215505785,55578,Warcq,193,186,7
44,55,215505793,55579,Watronville,101,101,0
44,55,215505801,55580,Wavrille,53,50,3
44,55,215505819,55581,Willeroncourt,107,105,2
44,55,215505827,55582,Wiseppe,90,89,1
44,55,215505835,55583,Woël,208,205,3
44,55,215505843,55584,Woimbey,128,126,2
44,55,215505868,55586,Xivray-et-Marvoisin,114,111,3
53,56,215600016,56001,Allaire,4008,3882,126
53,56,215600024,56002,Ambon,2095,2042,53
53,56,215600032,56003,Arradon,5699,5549,150
53,56,215600040,56004,Arzal,1731,1699,32
53,56,215600057,56005,Arzon,2305,2264,41
53,56,215600065,56006,Augan,1553,1522,31
53,56,215600073,56007,Auray,14571,14155,416
53,56,215600081,56008,Baden,4545,4418,127
53,56,215600099,56009,Bangor,1038,1018,20
53,56,215600107,56010,Baud,6427,6242,185
53,56,215600115,56011,Béganne,1416,1390,26
53,56,215600123,56012,Beignon,1998,1955,43
53,56,215600131,56013,Belz,3845,3784,61
53,56,215600149,56014,Berné,1679,1545,134
53,56,215600156,56015,Berric,2126,2095,31
53,56,215600172,56017,Bignan,2821,2758,63
53,56,215600180,56018,Billiers,1063,1037,26
53,56,215600198,56019,Billio,342,332,10
53,56,215600206,56020,Bohal,865,852,13
53,56,215600214,56021,Brandérion,1492,1466,26
53,56,215600222,56022,Brandivy,1377,1341,36
53,56,215600230,56023,Brech,7078,6792,286
53,56,215600248,56024,Bréhan,2324,2291,33
53,56,215600255,56025,Brignac,198,194,4
53,56,215600263,56026,Bubry,2346,2289,57
53,56,215600271,56027,Buléon,549,542,7
53,56,215600289,56028,Caden,1616,1580,36
53,56,215600297,56029,Calan,1272,1247,25
53,56,215600305,56030,Camoël,1104,1089,15
53,56,215600313,56031,Camors,3144,3083,61
53,56,215600321,56032,Campénéac,1951,1898,53
53,56,200067569,56033,Carentoir,3120,3062,58
53,56,215600347,56034,Carnac,4337,4231,106
53,56,215600354,56035,Caro,1172,1143,29
53,56,215600362,56036,Caudan,7298,7091,207
53,56,215600396,56039,La Chapelle-Neuve,1006,984,22
53,56,215600404,56040,Cléguer,3371,3310,61
53,56,215600412,56041,Cléguérec,2923,2835,88
53,56,215600420,56042,Colpo,2262,2216,46
53,56,215600438,56043,Concoret,767,750,17
53,56,215600446,56044,Cournon,827,798,29
53,56,215600453,56045,Le Cours,684,674,10
53,56,215600461,56046,Crach,3501,3421,80
53,56,215600479,56047,Crédin,1546,1501,45
53,56,215600487,56048,Le Croisty,735,721,14
53,56,215600503,56050,La Croix-Helléan,908,876,32
53,56,215600511,56051,Cruguel,665,656,9
53,56,215600529,56052,Damgan,1937,1908,29
53,56,215600537,56053,Elven,6514,6387,127
53,56,215600545,56054,Erdeven,4053,3958,95
53,56,215600552,56055,Étel,2233,2053,180
53,56,215600560,56056,Évriguet,209,205,4
53,56,215600578,56057,Le Faouët,2856,2800,56
53,56,215600586,56058,Férel,3433,3367,66
53,56,215600602,56060,Les Fougerêts,982,948,34
53,56,200064269,56061,La Gacilly,4079,3974,105
53,56,215600628,56062,Gâvres,698,679,19
53,56,215600636,56063,Gestel,2698,2609,89
53,56,215600651,56065,Gourhel,774,751,23
53,56,215600669,56066,Gourin,3935,3783,152
53,56,215600677,56067,Grand-Champ,5754,5612,142
53,56,215600685,56068,La Grée-Saint-Laurent,318,315,3
53,56,215600693,56069,Groix,2303,2256,47
53,56,215600701,56070,Guégon,2313,2261,52
53,56,215600719,56071,Guéhenno,808,796,12
53,56,215600727,56072,Gueltas,521,511,10
53,56,215600735,56073,Guémené-sur-Scorff,1074,1059,15
53,56,215600743,56074,Guénin,1886,1848,38
53,56,215600750,56075,Guer,6378,6079,299
53,56,215600768,56076,Guern,1349,1314,35
53,56,215600776,56077,Le Guerno,1017,992,25
53,56,215600784,56078,Guidel,12037,11743,294
53,56,215600792,56079,Guillac,1398,1364,34
53,56,215600800,56080,Guilliers,1444,1301,143
53,56,215600818,56081,Guiscriff,2138,2081,57
53,56,215600826,56082,Helléan,390,383,7
53,56,215600834,56083,Hennebont,16300,15873,427
53,56,215600842,56084,Le Hézo,872,856,16
53,56,215600859,56085,Hoedic,99,97,2
53,56,215600867,56086,Île-d'Houat,222,216,6
53,56,215600875,56087,Île-aux-Moines,645,627,18
53,56,215600883,56088,Île-d'Arz,263,257,6
53,56,215600891,56089,Inguiniel,2247,2193,54
53,56,215600909,56090,Inzinzac-Lochrist,6669,6535,134
53,56,215600917,56091,Josselin,2613,2511,102
53,56,215600925,56092,Kerfourn,844,829,15
53,56,215600933,56093,Kergrist,742,719,23
53,56,215600941,56094,Kervignac,7074,6858,216
53,56,215600966,56096,Landaul,2479,2429,50
53,56,215600974,56097,Landévant,4084,4013,71
53,56,215600982,56098,Lanester,23421,22940,481
53,56,215600990,56099,Langoëlan,393,388,5
53,56,215601006,56100,Langonnet,1760,1708,52
53,56,215601014,56101,Languidic,8204,8047,157
53,56,200087153,56102,Forges de Lanouée,2199,2148,51
53,56,215601030,56103,Lantillac,300,296,4
53,56,215601048,56104,Lanvaudan,814,804,10
53,56,215601055,56105,Lanvénégen,1160,1138,22
53,56,215601063,56106,Larmor-Baden,889,869,20
53,56,215601071,56107,Larmor-Plage,8522,8277,245
53,56,215601089,56108,Larré,1098,1081,17
53,56,215601097,56109,Lauzach,1204,1177,27
53,56,215601105,56110,Lignol,864,844,20
53,56,215601113,56111,Limerzel,1334,1311,23
53,56,215601121,56112,Lizio,755,740,15
53,56,215601139,56113,Locmalo,924,903,21
53,56,215601147,56114,Locmaria,992,962,30
53,56,215601154,56115,Locmaria-Grand-Champ,1782,1742,40
53,56,215601162,56116,Locmariaquer,1588,1545,43
53,56,215601170,56117,Locminé,4815,4578,237
53,56,215601188,56118,Locmiquélic,4167,4056,111
53,56,215601196,56119,Locoal-Mendon,3566,3486,80
53,56,215601204,56120,Locqueltas,1961,1919,42
53,56,215601212,56121,Lorient,58881,57412,1469
53,56,215601220,56122,Loyat,1709,1667,42
53,56,215601238,56123,Malansac,2242,2198,44
53,56,215601246,56124,Malestroit,2564,2483,81
53,56,215601253,56125,Malguénac,1904,1840,64
53,56,215601261,56126,Marzan,2498,2468,30
53,56,215601279,56127,Mauron,3247,3176,71
53,56,215601287,56128,Melrand,1544,1520,24
53,56,215601295,56129,Ménéac,1545,1512,33
53,56,215601303,56130,Merlevenez,3291,3215,76
53,56,215601311,56131,Meslan,1467,1438,29
53,56,215601329,56132,Meucon,2323,2269,54
53,56,215601337,56133,Missiriac,1201,1167,34
53,56,215601345,56134,Mohon,993,982,11
53,56,215601352,56135,Molac,1653,1622,31
53,56,215601360,56136,Monteneuf,770,755,15
53,56,215601378,56137,Monterblanc,3389,3311,78
53,56,215601394,56139,Montertelot,372,362,10
53,56,215601402,56140,Moréac,3798,3703,95
53,56,215601410,56141,Moustoir-Ac,1765,1728,37
53,56,215601436,56143,Muzillac,5181,5054,127
53,56,200059244,56144,Évellys,3525,3446,79
53,56,215601451,56145,Néant-sur-Yvel,1146,1119,27
53,56,215601469,56146,Neulliac,1454,1419,35
53,56,215601477,56147,Nivillac,4844,4746,98
53,56,215601485,56148,Nostang,1640,1607,33
53,56,215601493,56149,Noyal-Muzillac,2571,2520,51
53,56,215601519,56151,Noyal-Pontivy,3714,3596,118
53,56,215601527,56152,Le Palais,2589,2536,53
53,56,215601535,56153,Péaule,2770,2718,52
53,56,215601543,56154,Peillac,1889,1840,49
53,56,215601550,56155,Pénestin,2051,2023,28
53,56,215601568,56156,Persquen,357,351,6
53,56,215601576,56157,Plaudren,2011,1957,54
53,56,215601584,56158,Plescop,6367,6182,185
53,56,215601592,56159,Pleucadeuc,1862,1819,43
53,56,215601600,56160,Pleugriffet,1310,1292,18
53,56,215601618,56161,Ploemel,3122,3032,90
53,56,215601626,56162,Ploemeur,19185,18537,648
53,56,215601634,56163,Ploërdut,1252,1228,24
53,56,215601642,56164,Ploeren,6893,6669,224
53,56,200086791,56165,Ploërmel,10348,9785,563
53,56,215601667,56166,Plouay,5930,5789,141
53,56,215601675,56167,Plougoumelen,2684,2599,85
53,56,215601683,56168,Plouharnel,2292,2240,52
53,56,215601691,56169,Plouhinec,5487,5365,122
53,56,215601709,56170,Plouray,1075,1046,29
53,56,215601717,56171,Pluherlin,1547,1520,27
53,56,215601725,56172,Plumelec,2753,2686,67
53,56,200085041,56173,Pluméliau-Bieuzy,4430,4341,89
53,56,215601741,56174,Plumelin,2823,2753,70
53,56,215601758,56175,Plumergat,4286,4190,96
53,56,215601766,56176,Pluneret,6166,6023,143
53,56,215601774,56177,Pluvigner,7798,7657,141
53,56,215601782,56178,Pontivy,16030,15092,938
53,56,215601790,56179,Pont-Scorff,3985,3897,88
53,56,215601808,56180,Porcaro,755,738,17
53,56,215601816,56181,Port-Louis,2774,2672,102
53,56,215601824,56182,Priziac,1145,965,180
53,56,215601840,56184,Questembert,8219,7937,282
53,56,215601857,56185,Quéven,9051,8816,235
53,56,215601865,56186,Quiberon,4756,4659,97
53,56,215601881,56188,Quistinic,1442,1421,21
53,56,215601899,56189,Radenac,1086,1067,19
53,56,215601907,56190,Réguiny,2017,1963,54
53,56,215601915,56191,Réminiac,436,425,11
53,56,215601931,56193,Riantec,5946,5806,140
53,56,215601949,56194,Rieux,2936,2862,74
53,56,215601956,56195,La Roche-Bernard,707,694,13
53,56,215601964,56196,Rochefort-en-Terre,650,637,13
53,56,200059830,56197,Val d'Oust,2860,2782,78
53,56,215601980,56198,Rohan,1642,1605,37
53,56,215601998,56199,Roudouallec,716,702,14
53,56,215602004,56200,Ruffiac,1412,1378,34
53,56,215602012,56201,Le Saint,597,590,7
53,56,215602020,56202,Saint-Abraham,543,529,14
53,56,215602038,56203,Saint-Aignan,643,629,14
53,56,215602046,56204,Saint-Allouestre,638,630,8
53,56,215602053,56205,Saint-Armel,895,877,18
53,56,215602061,56206,Saint-Avé,12195,11912,283
53,56,215602079,56207,Saint-Barthélemy,1171,1153,18
53,56,215602087,56208,Saint-Brieuc-de-Mauron,310,302,8
53,56,215602095,56209,Sainte-Brigitte,187,180,7
53,56,215602103,56210,Saint-Caradec-Trégomel,485,479,6
53,56,215602111,56211,Saint-Congard,815,798,17
53,56,215602129,56212,Saint-Dolay,2620,2570,50
53,56,200096469,56213,Saint-Gérand-Croixanvec,1348,1316,32
53,56,215602145,56214,Saint-Gildas-de-Rhuys,1574,1552,22
53,56,215602152,56215,Saint-Gonnery,1124,1100,24
53,56,215602160,56216,Saint-Gorgon,403,399,4
53,56,215602186,56218,Saint-Gravé,721,710,11
53,56,215602194,56219,Saint-Guyomard,1430,1407,23
53,56,215602202,56220,Sainte-Hélène,1303,1272,31
53,56,215602210,56221,Saint-Jacut-les-Pins,1825,1742,83
53,56,215602228,56222,Saint-Jean-Brévelay,3001,2865,136
53,56,215602236,56223,Saint-Jean-la-Poterie,1512,1454,58
53,56,215602244,56224,Saint-Laurent-sur-Oust,399,389,10
53,56,215602251,56225,Saint-Léry,216,208,8
53,56,215602269,56226,Saint-Malo-de-Beignon,566,543,23
53,56,215602277,56227,Saint-Malo-des-Trois-Fontaines,611,596,15
53,56,215602285,56228,Saint-Marcel,1161,1113,48
53,56,215602293,56229,Saint-Martin-sur-Oust,1316,1299,17
53,56,215602301,56230,Saint-Nicolas-du-Tertre,474,463,11
53,56,215602319,56231,Saint-Nolff,4019,3892,127
53,56,215602327,56232,Saint-Perreux,1108,1066,42
53,56,215602335,56233,Saint-Philibert,1568,1524,44
53,56,215602343,56234,Saint-Pierre-Quiberon,2193,2145,48
53,56,215602368,56236,Saint-Servant,820,802,18
53,56,215602376,56237,Saint-Thuriau,1945,1869,76
53,56,215602384,56238,Saint-Tugdual,381,369,12
53,56,215602392,56239,Saint-Vincent-sur-Oust,1626,1584,42
53,56,215602400,56240,Sarzeau,9045,8866,179
53,56,215602418,56241,Sauzon,1032,1012,20
53,56,215602426,56242,Séglien,663,645,18
53,56,215602434,56243,Séné,9189,8930,259
53,56,215602442,56244,Sérent,3223,3172,51
53,56,215602459,56245,Silfiac,491,478,13
53,56,215602467,56246,Le Sourn,2167,2124,43
53,56,215602475,56247,Sulniac,3889,3797,92
53,56,215602483,56248,Surzur,5000,4899,101
53,56,215602491,56249,Taupont,2323,2259,64
53,56,215602509,56250,Théhillac,613,608,5
53,56,200055952,56251,Theix-Noyalo,8625,8386,239
53,56,215602525,56252,Le Tour-du-Parc,1219,1211,8
53,56,215602533,56253,Tréal,665,640,25
53,56,215602541,56254,Trédion,1345,1323,22
53,56,215602558,56255,Treffléan,2507,2450,57
53,56,215602566,56256,Tréhorenteuc,113,113,0
53,56,215602574,56257,La Trinité-Porhoët,683,670,13
53,56,215602582,56258,La Trinité-sur-Mer,1731,1698,33
53,56,215602590,56259,La Trinité-Surzur,1760,1738,22
53,56,215602608,56260,Vannes,56018,54017,2001
53,56,215602616,56261,La Vraie-Croix,1504,1473,31
53,56,215602624,56262,Le Bono,2609,2567,42
53,56,215602632,56263,Sainte-Anne-d'Auray,2938,2802,136
53,56,215602640,56264,Kernascléden,404,395,9
44,57,215700014,57001,Aboncourt,327,324,3
44,57,215700022,57002,Aboncourt-sur-Seille,67,66,1
44,57,215700030,57003,Abreschviller,1437,1409,28
44,57,215700048,57004,Achain,80,79,1
44,57,215700063,57006,Achen,1011,983,28
44,57,215700071,57007,Adaincourt,132,128,4
44,57,215700089,57008,Adelange,210,203,7
44,57,215700097,57009,Ajoncourt,105,104,1
44,57,215700105,57010,Alaincourt-la-Côte,160,158,2
44,57,215700113,57011,Albestroff,637,618,19
44,57,215700121,57012,Algrange,6157,6104,53
44,57,215700139,57013,Alsting,2558,2508,50
44,57,215700147,57014,Altrippe,379,369,10
44,57,215700154,57015,Altviller,573,561,12
44,57,215700162,57016,Alzing,400,392,8
44,57,215700170,57017,Amanvillers,2110,2087,23
44,57,215700188,57018,Amelécourt,134,126,8
44,57,215700196,57019,Amnéville,10739,10668,71
44,57,215700204,57020,Ancerville,306,303,3
44,57,200058253,57021,Ancy-Dornot,1538,1509,29
44,57,215700220,57022,Angevillers,1292,1264,28
44,57,215700246,57024,Antilly,188,188,0
44,57,215700253,57025,Anzeling,518,511,7
44,57,215700261,57026,Apach,1090,1071,19
44,57,215700279,57027,Arraincourt,126,123,3
44,57,215700287,57028,Argancy,1376,1337,39
44,57,215700295,57029,Arriance,219,216,3
44,57,215700303,57030,Arry,565,562,3
44,57,215700311,57031,Ars-Laquenexy,947,930,17
44,57,215700329,57032,Ars-sur-Moselle,4743,4695,48
44,57,215700337,57033,Arzviller,554,538,16
44,57,215700345,57034,Aspach,36,35,1
44,57,215700352,57035,Assenoncourt,118,115,3
44,57,215700360,57036,Attilloncourt,103,103,0
44,57,215700378,57037,Aube,272,267,5
44,57,215700386,57038,Audun-le-Tiche,7172,7108,64
44,57,215700394,57039,Augny,2193,2158,35
44,57,215700402,57040,Aulnois-sur-Seille,291,289,2
44,57,215700410,57041,Aumetz,2399,2368,31
44,57,215700428,57042,Avricourt,594,583,11
44,57,215700436,57043,Ay-sur-Moselle,1536,1517,19
44,57,215700444,57044,Azoudange,130,125,5
44,57,215700451,57045,Bacourt,110,110,0
44,57,215700469,57046,Baerenthal,769,756,13
44,57,215700477,57047,Bambiderstroff,1058,1045,13
44,57,215700485,57048,Bannay,74,72,2
44,57,215700493,57049,Le Ban-Saint-Martin,4672,4604,68
44,57,215700501,57050,Barchain,113,111,2
44,57,215700519,57051,Baronville,374,370,4
44,57,215700527,57052,Barst,582,573,9
44,57,215700535,57053,Bassing,112,107,5
44,57,215700543,57054,Baudrecourt,185,184,1
44,57,215700550,57055,Bazoncourt,541,537,4
44,57,215700568,57056,Bébing,195,190,5
44,57,215700576,57057,Béchy,610,604,6
44,57,215700584,57058,Behren-lès-Forbach,6635,6571,64
44,57,215700592,57059,Bellange,55,53,2
44,57,215700600,57060,Bénestroff,529,523,6
44,57,215700618,57061,Béning-lès-Saint-Avold,1173,1145,28
44,57,215700626,57062,Berg-sur-Moselle,447,433,14
44,57,215700634,57063,Bérig-Vintrange,224,216,8
44,57,215700642,57064,Berling,264,260,4
44,57,215700659,57065,Bermering,219,214,5
44,57,215700667,57066,Berthelming,516,512,4
44,57,215700675,57067,Bertrange,2868,2808,60
44,57,215700691,57069,Berviller-en-Moselle,465,458,7
44,57,215700709,57070,Bettange,249,247,2
44,57,215700717,57071,Bettborn,385,380,5
44,57,215700725,57072,Bettelainville,631,623,8
44,57,215700733,57073,Betting,879,863,16
44,57,215700741,57074,Bettviller,837,820,17
44,57,215700758,57075,Beux,297,294,3
44,57,215700766,57076,Beyren-lès-Sierck,528,512,16
44,57,215700774,57077,Bezange-la-Petite,100,97,3
44,57,215700790,57079,Bibiche,457,448,9
44,57,215700808,57080,Bickenholtz,83,83,0
44,57,215700816,57081,Bidestroff,133,132,1
44,57,215700824,57082,Biding,341,334,7
44,57,215700832,57083,Bining,1217,1195,22
44,57,215700840,57084,Bioncourt,303,301,2
44,57,215700857,57085,Bionville-sur-Nied,388,386,2
44,57,215700865,57086,Belles-Forêts,237,232,5
44,57,215700873,57087,Bisten-en-Lorraine,255,251,4
44,57,215700881,57088,Bistroff,317,310,7
44,57,215700899,57089,Bitche,5056,4955,101
44,57,215700907,57090,Blanche-Église,112,110,2
44,57,215700915,57091,Bliesbruck,1029,1007,22
44,57,215700923,57092,Blies-Ébersing,624,616,8
44,57,215700931,57093,Blies-Guersviller,662,650,12
44,57,215700956,57095,Boucheporn,586,576,10
44,57,215700964,57096,Boulange,2516,2469,47
44,57,215700972,57097,Boulay-Moselle,5635,5565,70
44,57,215700980,57098,Bourgaltroff,249,236,13
44,57,215700998,57099,Bourdonnay,241,236,5
44,57,215701004,57100,Bourscheid,181,175,6
44,57,215701012,57101,Bousbach,1251,1228,23
44,57,215701020,57102,Bousse,3258,3209,49
44,57,215701038,57103,Bousseviller,124,122,2
44,57,215701046,57104,Boust,1183,1156,27
44,57,215701053,57105,Boustroff,152,151,1
44,57,215701061,57106,Bouzonville,4001,3926,75
44,57,215701079,57107,Bréhain,106,106,0
44,57,215701087,57108,Breidenbach,318,313,5
44,57,215701095,57109,Breistroff-la-Grande,804,792,12
44,57,215701103,57110,Brettnach,427,425,2
44,57,215701111,57111,Bronvaux,521,518,3
44,57,215701129,57112,Brouck,83,83,0
44,57,215701137,57113,Brouderdorff,990,971,19
44,57,215701145,57114,Brouviller,452,436,16
44,57,215701152,57115,Brulange,102,98,4
44,57,215701160,57116,Buchy,94,93,1
44,57,215701178,57117,Buding,596,581,15
44,57,215701186,57118,Budling,171,165,6
44,57,215701194,57119,Buhl-Lorraine,1232,1199,33
44,57,215701202,57120,Burlioncourt,121,118,3
44,57,215701210,57121,Burtoncourt,225,220,5
44,57,215701228,57122,Cappel,689,677,12
44,57,215701236,57123,Carling,3456,3414,42
44,57,215701244,57124,Cattenom,2653,2619,34
44,57,215701251,57125,Chailly-lès-Ennery,432,425,7
44,57,215701269,57126,Chambrey,331,322,9
44,57,215701277,57127,Chanville,149,148,1
44,57,215701285,57128,Charleville-sous-Bois,317,309,8
44,57,215701293,57129,Charly-Oradour,757,734,23
44,57,215701301,57130,Château-Bréhain,75,74,1
44,57,215701319,57131,Château-Rouge,307,296,11
44,57,215701327,57132,Château-Salins,2542,2304,238
44,57,215701335,57133,Château-Voué,93,93,0
44,57,215701343,57134,Châtel-Saint-Germain,2105,1913,192
44,57,215701368,57136,Chémery-les-Deux,590,573,17
44,57,215701376,57137,Cheminot,821,807,14
44,57,215701384,57138,Chenois,85,82,3
44,57,215701392,57139,Chérisey,290,284,6
44,57,215701400,57140,Chesny,581,571,10
44,57,215701418,57141,Chicourt,89,89,0
44,57,215701426,57142,Chieulles,432,424,8
44,57,215701434,57143,Clouange,3401,3369,32
44,57,215701442,57144,Cocheren,3396,3355,41
44,57,215701459,57145,Coincy,330,325,5
44,57,215701467,57146,Coin-lès-Cuvry,823,804,19
44,57,215701475,57147,Coin-sur-Seille,351,337,14
44,57,200062339,57148,Colligny-Maizery,579,568,11
44,57,215701491,57149,Colmen,206,202,4
44,57,215701509,57150,Condé-Northen,701,692,9
44,57,215701517,57151,Conthil,149,147,2
44,57,215701525,57152,Contz-les-Bains,522,514,8
44,57,215701533,57153,Corny-sur-Moselle,2206,2168,38
44,57,215701541,57154,Coume,639,620,19
44,57,215701558,57155,Courcelles-Chaussy,3286,2961,325
44,57,215701566,57156,Courcelles-sur-Nied,1181,1169,12
44,57,215701582,57158,Craincourt,245,240,5
44,57,215701590,57159,Créhange,3909,3854,55
44,57,215701608,57160,Creutzwald,12975,12772,203
44,57,215701616,57161,Cutting,106,105,1
44,57,215701624,57162,Cuvry,918,903,15
44,57,215701632,57163,Dabo,2430,2384,46
44,57,215701657,57165,Dalem,704,695,9
44,57,215701665,57166,Dalhain,106,104,2
44,57,215701673,57167,Dalstein,382,376,6
44,57,215701681,57168,Danne-et-Quatre-Vents,692,676,16
44,57,215701699,57169,Dannelbourg,512,496,16
44,57,215701715,57171,Delme,1164,1151,13
44,57,215701723,57172,Denting,285,284,1
44,57,215701731,57173,Desseling,104,101,3
44,57,215701749,57174,Destry,102,101,1
44,57,215701756,57175,Diane-Capelle,231,224,7
44,57,215701764,57176,Diebling,1714,1677,37
44,57,215701772,57177,Dieuze,3004,2795,209
44,57,215701780,57178,Diffembach-lès-Hellimer,355,351,4
44,57,215701798,57179,Distroff,1863,1830,33
44,57,215701806,57180,Dolving,351,342,9
44,57,215701814,57181,Domnom-lès-Dieuze,86,84,2
44,57,215701822,57182,Donjeux,96,95,1
44,57,215701830,57183,Donnelay,191,189,2
44,57,215701863,57186,Ébersviller,967,956,11
44,57,215701871,57187,Éblange,370,363,7
44,57,215701889,57188,Éguelshardt,528,424,104
44,57,215701897,57189,Eincheville,227,225,2
44,57,215701905,57190,Elvange,420,418,2
44,57,215701913,57191,Elzange,710,694,16
44,57,215701921,57192,Enchenberg,1250,1218,32
44,57,215701939,57193,Ennery,2256,2230,26
44,57,215701947,57194,Entrange,1263,1229,34
44,57,215701954,57195,Epping,577,562,15
44,57,215701962,57196,Erching,435,423,12
44,57,215701970,57197,Ernestviller,518,510,8
44,57,215701988,57198,Erstroff,195,192,3
44,57,215701996,57199,Escherange,705,690,15
44,57,215702002,57200,Les Étangs,407,397,10
44,57,215702010,57201,Etting,732,720,12
44,57,215702028,57202,Etzling,1172,1155,17
44,57,215702036,57203,Évrange,226,222,4
44,57,215702044,57204,Failly,546,536,10
44,57,215702051,57205,Falck,2553,2520,33
44,57,215702069,57206,Fameck,14997,14829,168
44,57,215702077,57207,Farébersviller,5453,5406,47
44,57,215702085,57208,Farschviller,1374,1340,34
44,57,215702093,57209,Faulquemont,5241,5157,84
44,57,215702101,57210,Fénétrange,683,664,19
44,57,215702119,57211,Fèves,1215,1204,11
44,57,215702127,57212,Féy,740,731,9
44,57,215702135,57213,Filstroff,785,772,13
44,57,215702143,57214,Fixem,415,408,7
44,57,215702150,57215,Flastroff,343,340,3
44,57,215702168,57216,Fleisheim,147,142,5
44,57,215702176,57217,Flétrange,910,892,18
44,57,215702184,57218,Fleury,1309,1287,22
44,57,215702192,57219,Flévy,566,560,6
44,57,215702200,57220,Flocourt,119,117,2
44,57,215702218,57221,Florange,12040,11939,101
44,57,215702226,57222,Folkling,1393,1354,39
44,57,215702242,57224,Folschviller,4019,3949,70
44,57,215702259,57225,Fonteny,142,140,2
44,57,215702267,57226,Fontoy,3173,3132,41
44,57,215702275,57227,Forbach,21797,21509,288
44,57,215702283,57228,Fossieux,196,191,5
44,57,215702291,57229,Foulcrey,155,153,2
44,57,215702309,57230,Fouligny,196,194,2
44,57,215702317,57231,Foville,100,100,0
44,57,215702325,57232,Francaltroff,790,778,12
44,57,215702333,57233,Fraquelfing,87,86,1
44,57,215702341,57234,Frauenberg,607,599,8
44,57,215702358,57235,Freistroff,1051,1031,20
44,57,215702366,57236,Frémery,88,88,0
44,57,215702374,57237,Frémestroff,311,304,7
44,57,215702382,57238,Fresnes-en-Saulnois,199,193,6
44,57,215702390,57239,Freybouse,438,432,6
44,57,215702408,57240,Freyming-Merlebach,12952,12840,112
44,57,215702416,57241,Fribourg,173,165,8
44,57,215702424,57242,Gandrange,3068,3035,33
44,57,215702440,57244,Garrebourg,504,492,12
44,57,215702457,57245,Gavisse,579,570,9
44,57,215702465,57246,Gelucourt,221,217,4
44,57,215702473,57247,Gerbécourt,80,77,3
44,57,215702481,57248,Givrycourt,88,86,2
44,57,215702499,57249,Glatigny,266,259,7
44,57,215702507,57250,Goetzenbruck,1505,1465,40
44,57,215702515,57251,Goin,346,344,2
44,57,215702523,57252,Gomelange,484,474,10
44,57,215702531,57253,Gondrexange,508,502,6
44,57,215702549,57254,Gorze,1164,1155,9
44,57,215702556,57255,Gosselming,591,568,23
44,57,215702564,57256,Gravelotte,825,821,4
44,57,215702572,57257,Grémecey,105,104,1
44,57,215702580,57258,Gréning,116,115,1
44,57,215702598,57259,Grindorff-Bizing,326,316,10
44,57,215702606,57260,Grosbliederstroff,3371,3319,52
44,57,215702614,57261,Gros-Réderching,1354,1324,30
44,57,215702622,57262,Grostenquin,665,658,7
44,57,215702630,57263,Grundviller,673,654,19
44,57,215702648,57264,Guebenhouse,410,404,6
44,57,215702655,57265,Guébestroff,62,59,3
44,57,215702663,57266,Guéblange-lès-Dieuze,149,146,3
44,57,215702671,57267,Le Val-de-Guéblange,844,832,12
44,57,215702689,57268,Guébling,124,123,1
44,57,215702697,57269,Guénange,7661,7594,67
44,57,215702705,57270,Val-de-Bride,568,562,6
44,57,215702713,57271,Guenviller,695,678,17
44,57,215702721,57272,Guermange,92,88,4
44,57,215702739,57273,Guerstling,394,385,9
44,57,215702747,57274,Guerting,878,863,15
44,57,215702754,57275,Guessling-Hémering,930,918,12
44,57,215702762,57276,Guinglange,339,335,4
44,57,215702770,57277,Guinkirchen,152,147,5
44,57,215702788,57278,Guinzeling,65,65,0
44,57,215702804,57280,Guntzviller,382,362,20
44,57,215702812,57281,Haboudange,240,235,5
44,57,215702820,57282,Hagen,358,354,4
44,57,215702838,57283,Hagondange,9437,9332,105
44,57,215702846,57284,Hallering,118,113,5
44,57,215702861,57286,Halstroff,313,305,8
44,57,215702879,57287,Basse-Ham,2265,2221,44
44,57,215702887,57288,Ham-sous-Varsberg,2902,2862,40
44,57,215702895,57289,Hambach,2930,2864,66
44,57,215702903,57290,Hampont,178,176,2
44,57,215702911,57291,Hangviller,267,262,5
44,57,215702929,57292,Hannocourt,19,19,0
44,57,215702937,57293,Han-sur-Nied,263,257,6
44,57,215702945,57294,Hanviller,202,195,7
44,57,215702952,57295,Haraucourt-sur-Seille,106,105,1
44,57,215702960,57296,Hargarten-aux-Mines,1115,1095,20
44,57,215702978,57297,Harprich,190,184,6
44,57,215702986,57298,Harreberg,384,377,7
44,57,215702994,57299,Hartzviller,943,926,17
44,57,215703000,57300,Haselbourg,324,319,5
44,57,215703018,57301,Haspelschiedt,315,303,12
44,57,215703026,57302,Hattigny,190,189,1
44,57,215703034,57303,Hauconcourt,605,596,9
44,57,215703042,57304,Haut-Clocher,364,355,9
44,57,215703059,57305,Havange,457,451,6
44,57,215703067,57306,Hayange,16186,15994,192
44,57,215703075,57307,Hayes,256,251,5
44,57,215703083,57308,Hazembourg,154,149,5
44,57,215703091,57309,Heining-lès-Bouzonville,490,481,9
44,57,215703109,57310,Hellering-lès-Fénétrange,197,192,5
44,57,215703117,57311,Hellimer,528,518,10
44,57,215703125,57312,Helstroff,500,492,8
44,57,215703133,57313,Hémilly,145,142,3
44,57,215703141,57314,Héming,501,496,5
44,57,215703158,57315,Henridorff,730,709,21
44,57,215703166,57316,Henriville,766,750,16
44,57,215703174,57317,Hérange,108,107,1
44,57,215703182,57318,Hermelange,221,216,5
44,57,215703190,57319,Herny,531,526,5
44,57,215703208,57320,Hertzing,185,182,3
44,57,215703216,57321,Hesse,580,559,21
44,57,215703224,57322,Hestroff,480,474,6
44,57,215703232,57323,Hettange-Grande,7921,7753,168
44,57,215703240,57324,Hilbesheim,638,615,23
44,57,215703257,57325,Hilsprich,841,825,16
44,57,215703265,57326,Hinckange,340,336,4
44,57,215703281,57328,Holacourt,91,90,1
44,57,215703299,57329,Holling,441,430,11
44,57,215703307,57330,Holving,1300,1280,20
44,57,215703315,57331,Hombourg-Budange,564,553,11
44,57,215703323,57332,Hombourg-Haut,6330,6275,55
44,57,215703331,57333,Hommarting,851,827,24
44,57,215703349,57334,Hommert,323,319,4
44,57,215703356,57335,Honskirch,222,218,4
44,57,215703364,57336,L'Hôpital,5262,5205,57
44,57,215703372,57337,Hoste,601,584,17
44,57,215703380,57338,Hottviller,517,512,5
44,57,215703398,57339,Hultehouse,371,366,5
44,57,215703406,57340,Hundling,1375,1355,20
44,57,215703414,57341,Hunting,723,707,16
44,57,215703422,57342,Ibigny,94,94,0
44,57,215703430,57343,Illange,1844,1814,30
44,57,215703448,57344,Imling,745,737,8
44,57,215703455,57345,Inglange,444,412,32
44,57,215703463,57346,Insming,602,593,9
44,57,215703471,57347,Insviller,178,173,5
44,57,215703489,57348,Ippling,814,797,17
44,57,215703497,57349,Jallaucourt,151,148,3
44,57,215703505,57350,Jouy-aux-Arches,1444,1424,20
44,57,215703513,57351,Jury,1335,1317,18
44,57,215703521,57352,Jussy,462,446,16
44,57,215703539,57353,Juvelize,73,72,1
44,57,215703547,57354,Juville,126,121,5
44,57,215703554,57355,Kalhausen,818,799,19
44,57,215703562,57356,Kanfen,1248,1210,38
44,57,215703570,57357,Kappelkinger,409,407,2
44,57,215703588,57358,Kédange-sur-Canner,1104,1080,24
44,57,215703596,57359,Kemplich,176,172,4
44,57,215703604,57360,Kerbach,1229,1207,22
44,57,215703612,57361,Kerling-lès-Sierck,628,610,18
44,57,215703620,57362,Kerprich-aux-Bois,187,182,5
44,57,215703646,57364,Kirsch-lès-Sierck,321,314,7
44,57,215703653,57365,Kirschnaumen,482,471,11
44,57,215703661,57366,Kirviller,141,139,2
44,57,215703679,57367,Klang,222,218,4
44,57,215703687,57368,Knutange,3245,3197,48
44,57,215703703,57370,Koenigsmacker,2318,2278,40
44,57,215703711,57371,Haute-Kontz,593,586,7
44,57,215703729,57372,Kuntzig,1386,1360,26
44,57,215703737,57373,Lachambre,945,926,19
44,57,215703745,57374,Lafrimbolle,204,198,6
44,57,215703752,57375,Lagarde,190,185,5
44,57,215703760,57376,Lambach,499,492,7
44,57,215703778,57377,Landange,251,247,4
44,57,215703794,57379,Landroff,274,272,2
44,57,215703802,57380,Laneuveville-lès-Lorquin,108,106,2
44,57,215703810,57381,Laneuveville-en-Saulnois,292,286,6
44,57,215703828,57382,Langatte,589,581,8
44,57,215703836,57383,Languimberg,166,160,6
44,57,215703844,57384,Laning,641,623,18
44,57,215703851,57385,Laquenexy,1281,1258,23
44,57,215703869,57386,Laudrefang,353,346,7
44,57,215703877,57387,Laumesfeld,294,293,1
44,57,215703885,57388,Launstroff,265,258,7
44,57,215703893,57389,Lelling,477,465,12
44,57,215703901,57390,Lemberg,1458,1420,38
44,57,215703919,57391,Lemoncourt,65,63,2
44,57,215703927,57392,Lemud,543,539,4
44,57,215703935,57393,Lengelsheim,199,196,3
44,57,215703943,57394,Léning,358,346,12
44,57,215703950,57395,Lesse,208,204,4
44,57,215703968,57396,Lessy,763,736,27
44,57,215703976,57397,Ley,102,102,0
44,57,215703984,57398,Leyviller,516,506,10
44,57,215703992,57399,Lezey,98,91,7
44,57,215704016,57401,Lidrezing,85,84,1
44,57,215704024,57402,Liederschiedt,120,119,1
44,57,215704032,57403,Liéhon,129,129,0
44,57,215704040,57404,Lindre-Basse,216,210,6
44,57,215704057,57405,Lindre-Haute,54,54,0
44,57,215704065,57406,Liocourt,144,141,3
44,57,215704073,57407,Lixheim,595,589,6
44,57,215704081,57408,Lixing-lès-Rouhling,865,847,18
44,57,215704099,57409,Lixing-lès-Saint-Avold,685,670,15
44,57,215704107,57410,Lhor,143,140,3
44,57,215704115,57411,Lommerange,351,350,1
44,57,215704123,57412,Longeville-lès-Metz,3990,3926,64
44,57,215704131,57413,Longeville-lès-Saint-Avold,3709,3627,82
44,57,215704149,57414,Lorquin,1169,1144,25
44,57,215704156,57415,Lorry-lès-Metz,1812,1737,75
44,57,215704164,57416,Lorry-Mardigny,672,664,8
44,57,215704172,57417,Lostroff,72,69,3
44,57,215704180,57418,Loudrefing,326,323,3
44,57,215704198,57419,Loupershouse,922,902,20
44,57,215704214,57421,Loutzviller,157,154,3
44,57,215704222,57422,Louvigny,894,883,11
44,57,215704230,57423,Lubécourt,73,72,1
44,57,215704248,57424,Lucy,237,235,2
44,57,215704255,57425,Luppy,579,575,4
44,57,215704263,57426,Luttange,909,900,9
44,57,215704271,57427,Lutzelbourg,575,565,10
44,57,215704289,57428,Macheren,2828,2778,50
44,57,215704305,57430,Mainvillers,332,327,5
44,57,215704313,57431,Maizeroy,412,409,3
44,57,215704339,57433,Maizières-lès-Metz,11892,11776,116
44,57,215704347,57434,Maizières-lès-Vic,491,482,9
44,57,215704362,57436,Malaucourt-sur-Seille,135,129,6
44,57,215704370,57437,Malling,660,647,13
44,57,215704388,57438,Malroy,355,350,5
44,57,200084853,57439,Manderen-Ritzing,615,602,13
44,57,215704404,57440,Manhoué,144,141,3
44,57,215704412,57441,Manom,3008,2947,61
44,57,215704420,57442,Many,240,238,2
44,57,215704438,57443,Marange-Silvange,6502,6446,56
44,57,215704446,57444,Marange-Zondrange,363,358,5
44,57,215704453,57445,Marieulles,711,700,11
44,57,215704461,57446,Marimont-lès-Bénestroff,45,45,0
44,57,215704479,57447,Marly,10187,9961,226
44,57,215704487,57448,Marsal,251,245,6
44,57,215704495,57449,Marsilly,597,594,3
44,57,215704511,57451,Marthille,172,168,4
44,57,215704529,57452,La Maxe,1049,1034,15
44,57,215704537,57453,Maxstadt,308,297,11
44,57,215704545,57454,Mécleuves,1212,1187,25
44,57,215704552,57455,Mégange,146,143,3
44,57,215704560,57456,Meisenthal,686,662,24
44,57,215704578,57457,Menskirch,139,137,2
44,57,215704594,57459,Merschweiller,291,289,2
44,57,215704602,57460,Merten,1488,1471,17
44,57,215704610,57461,Métairies-Saint-Quirin,284,276,8
44,57,215704628,57462,Metting,438,431,7
44,57,215704636,57463,Metz,122036,120211,1825
44,57,215704644,57464,Metzeresche,1006,978,28
44,57,215704651,57465,Metzervisse,2319,2268,51
44,57,215704669,57466,Metzing,674,665,9
44,57,215704677,57467,Mey,310,308,2
44,57,215704685,57468,Mittelbronn,690,673,17
44,57,215704693,57469,Mittersheim,599,595,4
44,57,215704701,57470,Molring,4,4,0
44,57,215704719,57471,Momerstroff,300,297,3
44,57,215704727,57472,Moncheux,147,147,0
44,57,215704735,57473,Moncourt,67,65,2
44,57,215704743,57474,Mondelange,5758,5701,57
44,57,215704750,57475,Mondorff,542,527,15
44,57,215704768,57476,Monneren,417,407,10
44,57,215704776,57477,Montbronn,1641,1597,44
44,57,215704784,57478,Montdidier,86,86,0
44,57,215704792,57479,Montenach,491,479,12
44,57,215704800,57480,Montigny-lès-Metz,22135,21788,347
44,57,215704818,57481,Montois-la-Montagne,2747,2730,17
44,57,200073609,57482,Ogy-Montoy-Flanville,1806,1777,29
44,57,215704834,57483,Morhange,3475,3390,85
44,57,215704842,57484,Morsbach,2703,2675,28
44,57,215704859,57485,Morville-lès-Vic,126,124,2
44,57,215704867,57486,Morville-sur-Nied,117,116,1
44,57,215704875,57487,Moulins-lès-Metz,5079,5021,58
44,57,215704883,57488,Moussey,569,561,8
44,57,215704891,57489,Mouterhouse,288,288,0
44,57,215704909,57490,Moyenvic,345,341,4
44,57,215704917,57491,Moyeuvre-Grande,7412,7349,63
44,57,215704925,57492,Moyeuvre-Petite,457,448,9
44,57,215704933,57493,Mulcey,215,211,4
44,57,215704941,57494,Munster,236,236,0
44,57,215704958,57495,Narbéfontaine,116,115,1
44,57,215704966,57496,Nébing,340,334,6
44,57,215704974,57497,Nelling,271,262,9
44,57,215704982,57498,Neufchef,2646,2593,53
44,57,215704990,57499,Neufgrange,1387,1357,30
44,57,215705005,57500,Neufmoulins,43,43,0
44,57,215705013,57501,Neufvillage,40,40,0
44,57,215705021,57502,Neunkirchen-lès-Bouzonville,343,331,12
44,57,215705047,57504,Niderhoff,283,278,5
44,57,215705054,57505,Niderviller,1214,1192,22
44,57,215705062,57506,Niederstinzel,252,247,5
44,57,215705070,57507,Niedervisse,273,271,2
44,57,215705088,57508,Nilvange,4483,4430,53
44,57,215705096,57509,Nitting,498,487,11
44,57,215705104,57510,Noisseville,1119,1108,11
44,57,215705112,57511,Norroy-le-Veneur,1040,1019,21
44,57,215705120,57512,Nouilly,723,712,11
44,57,215705138,57513,Nousseviller-lès-Bitche,155,154,1
44,57,215705146,57514,Nousseviller-Saint-Nabor,1211,1186,25
44,57,215705153,57515,Novéant-sur-Moselle,1861,1836,25
44,57,215705161,57516,Oberdorff,349,339,10
44,57,215705179,57517,Obergailbach,283,279,4
44,57,215705187,57518,Oberstinzel,337,327,10
44,57,215705195,57519,Obervisse,163,160,3
44,57,215705203,57520,Obreck,33,32,1
44,57,215705211,57521,oeting,2765,2711,54
44,57,215705245,57524,Ommeray,130,129,1
44,57,215705252,57525,Oriocourt,56,55,1
44,57,215705260,57526,Ormersviller,379,378,1
44,57,215705278,57527,Orny,361,357,4
44,57,215705286,57528,Oron,106,105,1
44,57,215705294,57529,Ottange,3193,3127,66
44,57,215705302,57530,Ottonville,444,438,6
44,57,215705310,57531,Oudrenne,754,742,12
44,57,215705328,57532,Pagny-lès-Goin,233,230,3
44,57,215705336,57533,Pange,894,876,18
44,57,215705344,57534,Peltre,1953,1830,123
44,57,215705351,57535,Petit-Réderching,1459,1426,33
44,57,215705369,57536,Petit-Tenquin,222,219,3
44,57,215705377,57537,Petite-Rosselle,6324,6257,67
44,57,215705385,57538,Pettoncourt,299,296,3
44,57,215705393,57539,Pévange,48,45,3
44,57,215705401,57540,Phalsbourg,4939,4700,239
44,57,215705419,57541,Philippsbourg,613,600,13
44,57,215705427,57542,Piblange,983,973,10
44,57,215705435,57543,Pierrevillers,1517,1495,22
44,57,215705443,57544,Plaine-de-Walsch,627,610,17
44,57,215705450,57545,Plappeville,2088,2032,56
44,57,215705468,57546,Plesnois,834,803,31
44,57,215705476,57547,Pommérieux,719,709,10
44,57,215705484,57548,Pontoy,588,581,7
44,57,215705492,57549,Pontpierre,757,743,14
44,57,215705500,57550,Porcelette,2538,2473,65
44,57,215705518,57551,Postroff,215,208,7
44,57,215705526,57552,Pouilly,737,727,10
44,57,215705534,57553,Pournoy-la-Chétive,637,624,13
44,57,215705542,57554,Pournoy-la-Grasse,731,710,21
44,57,215705559,57555,Prévocourt,112,112,0
44,57,215705567,57556,Puttelange-aux-Lacs,3127,3081,46
44,57,215705575,57557,Puttelange-lès-Thionville,1040,1016,24
44,57,215705583,57558,Puttigny,77,77,0
44,57,215705591,57559,Puzieux,170,170,0
44,57,215705609,57560,Racrange,634,621,13
44,57,215705617,57561,Rahling,742,722,20
44,57,215708629,57562,Ranguevaux,883,865,18
44,57,215705633,57563,Raville,252,250,2
44,57,215705641,57564,Réchicourt-le-Château,578,564,14
44,57,215705658,57565,Rédange,1015,996,19
44,57,215705666,57566,Réding,2413,2349,64
44,57,215705674,57567,Rémelfang,147,146,1
44,57,215705682,57568,Rémelfing,1390,1367,23
44,57,215705690,57569,Rémeling,326,320,6
44,57,215705708,57570,Rémering,421,416,5
44,57,215705716,57571,Rémering-lès-Puttelange,1072,1040,32
44,57,215705724,57572,Rémilly,2109,2009,100
44,57,215705732,57573,Réning,136,134,2
44,57,215705740,57574,Basse-Rentgen,535,522,13
44,57,215705757,57575,Retonfey,1374,1344,30
44,57,215705765,57576,Rettel,850,796,54
44,57,215705773,57577,Reyersviller,377,371,6
44,57,200085231,57578,Rezonville-Vionville,501,494,7
44,57,215705799,57579,Rhodes,129,128,1
44,57,215705807,57580,Riche,189,187,2
44,57,215705815,57581,Richeling,358,351,7
44,57,215705823,57582,Richemont,2134,2090,44
44,57,215705831,57583,Richeval,135,129,6
44,57,215705849,57584,Rimling,673,656,17
44,57,215705864,57586,Rochonvillers,188,186,2
44,57,215705872,57587,Rodalbe,251,248,3
44,57,215705880,57588,Rodemack,1325,1292,33
44,57,215705898,57589,Rohrbach-lès-Bitche,2355,2305,50
44,57,215705906,57590,Rolbing,265,259,6
44,57,215705914,57591,Rombas,9955,9864,91
44,57,215705922,57592,Romelfing,351,344,7
44,57,215705930,57593,Roncourt,1040,1029,11
44,57,215705948,57594,Roppeviller,101,98,3
44,57,215705955,57595,Rorbach-lès-Dieuze,49,49,0
44,57,215705963,57596,Rosbruck,751,740,11
44,57,215705971,57597,Rosselange,2592,2567,25
44,57,215705989,57598,Rouhling,2048,1995,53
44,57,215705997,57599,Roupeldange,369,361,8
44,57,215706003,57600,Roussy-le-Village,1468,1443,25
44,57,215706011,57601,Rozérieulles,1363,1322,41
44,57,215706029,57602,Rurange-lès-Thionville,2452,2399,53
44,57,215706037,57603,Russange,1290,1268,22
44,57,215706045,57604,Rustroff,635,630,5
44,57,215706052,57605,Sailly-Achâtel,305,303,2
44,57,215706060,57606,Saint-Avold,15494,15171,323
44,57,215706078,57607,Sainte-Barbe,779,769,10
44,57,215706094,57609,Saint-Epvre,175,173,2
44,57,215706102,57610,Saint-François-Lacroix,317,311,6
44,57,215706110,57611,Saint-Georges,203,197,6
44,57,215706128,57612,Saint-Hubert,242,237,5
44,57,215706136,57613,Saint-Jean-de-Bassel,349,344,5
44,57,215706144,57614,Saint-Jean-Kourtzerode,707,703,4
44,57,215706151,57615,Saint-Jean-Rohrbach,988,969,19
44,57,215706169,57616,Saint-Julien-lès-Metz,3531,3467,64
44,57,215706177,57617,Saint-Jure,289,283,6
44,57,215706185,57618,Saint-Louis,660,642,18
44,57,215706193,57619,Saint-Louis-lès-Bitche,476,467,9
44,57,215706201,57620,Sainte-Marie-aux-Chênes,4522,4463,59
44,57,215706219,57621,Saint-Médard,110,109,1
44,57,215706227,57622,Saint-Privat-la-Montagne,1920,1897,23
44,57,215706235,57623,Saint-Quirin,754,705,49
44,57,215706243,57624,Sainte-Ruffine,601,570,31
44,57,215706250,57625,Salonnes,176,174,2
44,57,215706268,57626,Sanry-lès-Vigy,535,523,12
44,57,215706276,57627,Sanry-sur-Nied,360,357,3
44,57,215706284,57628,Sarralbe,4540,4450,90
44,57,215706292,57629,Sarraltroff,786,780,6
44,57,215706300,57630,Sarrebourg,12582,12278,304
44,57,215706318,57631,Sarreguemines,21017,20555,462
44,57,215706334,57633,Sarreinsming,1293,1261,32
44,57,215706342,57634,Saulny,1551,1511,40
44,57,215706359,57635,Schalbach,375,368,7
44,57,215706367,57636,Schmittviller,330,322,8
44,57,215706375,57637,Schneckenbusch,314,307,7
44,57,215706383,57638,Schoeneck,2514,2473,41
44,57,215706391,57639,Schorbach,545,536,9
44,57,215706409,57640,Schwerdorff,488,474,14
44,57,215706417,57641,Schweyen,315,309,6
44,57,215706425,57642,Scy-Chazelles,2717,2665,52
44,57,215706433,57643,Secourt,207,201,6
44,57,215706441,57644,Seingbouse,1785,1741,44
44,57,215706458,57645,Semécourt,1030,1021,9
44,57,215706474,57647,Serémange-Erzange,4220,4164,56
44,57,215706482,57648,Servigny-lès-Raville,506,501,5
44,57,215706490,57649,Servigny-lès-Sainte-Barbe,482,478,4
44,57,215706508,57650,Sierck-les-Bains,1789,1776,13
44,57,215706516,57651,Siersthal,645,639,6
44,57,215706524,57652,Sillegny,590,584,6
44,57,215706532,57653,Silly-en-Saulnois,34,33,1
44,57,215706540,57654,Silly-sur-Nied,714,703,11
44,57,215706557,57655,Solgne,1177,1124,53
44,57,215706565,57656,Sorbey,391,385,6
44,57,215706573,57657,Sotzeling,21,21,0
44,57,215706581,57658,Soucht,1058,1038,20
44,57,215706599,57659,Spicheren,3283,3227,56
44,57,215706607,57660,Stiring-Wendel,11174,11043,131
44,57,215706615,57661,Sturzelbronn,173,172,1
44,57,215706623,57662,Suisse,99,98,1
44,57,215706631,57663,Talange,8009,7832,177
44,57,215706649,57664,Tarquimpol,63,61,2
44,57,215706656,57665,Tenteling,1070,1051,19
44,57,215706664,57666,Terville,7421,7328,93
44,57,215706672,57667,Téterchen,783,775,8
44,57,215706680,57668,Teting-sur-Nied,1298,1264,34
44,57,215706698,57669,Théding,2503,2459,44
44,57,215706706,57670,Thicourt,133,132,1
44,57,215706714,57671,Thimonville,154,154,0
44,57,215706722,57672,Thionville,42117,41383,734
44,57,215706730,57673,Thonville,50,49,1
44,57,215706748,57674,Tincry,178,174,4
44,57,215706755,57675,Torcheville,119,118,1
44,57,215706763,57676,Tragny,91,90,1
44,57,215706771,57677,Trémery,1045,1024,21
44,57,215706789,57678,Tressange,2331,2301,30
44,57,215706797,57679,Tritteling-Redlach,536,526,10
44,57,215706805,57680,Troisfontaines,1284,1255,29
44,57,215706813,57681,Tromborn,339,334,5
44,57,215706821,57682,Turquestein-Blancrupt,11,11,0
44,57,215706839,57683,Uckange,6988,6951,37
44,57,215706847,57684,Vahl-Ebersing,519,509,10
44,57,215706854,57685,Vahl-lès-Bénestroff,153,150,3
44,57,215706862,57686,Vahl-lès-Faulquemont,248,247,1
44,57,215706870,57687,Vallerange,216,212,4
44,57,215706896,57689,Valmestroff,334,329,5
44,57,215706904,57690,Valmont,3044,2976,68
44,57,215706912,57691,Valmunster,89,85,4
44,57,215706920,57692,Vannecourt,73,73,0
44,57,215706938,57693,Vantoux,827,808,19
44,57,215706946,57694,Vany,463,452,11
44,57,215706953,57695,Varize-Vaudoncourt,515,506,9
44,57,215706961,57696,Varsberg,992,968,24
44,57,215706979,57697,Vasperviller,323,314,9
44,57,215706987,57698,Vatimont,320,314,6
44,57,215707001,57700,Vaudreching,507,499,8
44,57,215707019,57701,Vaux,842,816,26
44,57,215707027,57702,Vaxy,169,169,0
44,57,215707035,57703,Veckersviller,251,234,17
44,57,215707043,57704,Veckring,662,647,15
44,57,215707050,57705,Velving,214,209,5
44,57,215707068,57706,Vergaville,558,545,13
44,57,215707076,57707,Vernéville,676,670,6
44,57,215707084,57708,Verny,2025,1981,44
44,57,215707092,57709,Vescheim,317,310,7
44,57,215707118,57711,Vibersviller,408,400,8
44,57,215707126,57712,Vic-sur-Seille,1376,1332,44
44,57,215707134,57713,Vieux-Lixheim,254,248,6
44,57,215707142,57714,Haute-Vigneulles,451,442,9
44,57,215707159,57715,Vigny,394,383,11
44,57,215707167,57716,Vigy,1691,1673,18
44,57,215707175,57717,Viller,185,181,4
44,57,215707183,57718,Villers-Stoncourt,217,216,1
44,57,215707191,57719,Villers-sur-Nied,85,82,3
44,57,215707209,57720,Villing,513,501,12
44,57,215707217,57721,Vilsberg,357,346,11
44,57,215707233,57723,Virming,299,293,6
44,57,215707241,57724,Vitry-sur-Orne,3051,3019,32
44,57,215707258,57725,Vittersbourg,350,343,7
44,57,215707266,57726,Vittoncourt,389,385,4
44,57,215707274,57727,Viviers,125,124,1
44,57,215707282,57728,Voimhaut,257,254,3
44,57,215707308,57730,Volmerange-lès-Boulay,579,565,14
44,57,215707316,57731,Volmerange-les-Mines,2349,2308,41
44,57,215707324,57732,Volmunster,788,768,20
44,57,215707332,57733,Volstroff,2077,2048,29
44,57,215707340,57734,Voyer,467,458,9
44,57,215707365,57736,Vry,630,619,11
44,57,215707373,57737,Vulmont,34,32,2
44,57,215707381,57738,Waldhouse,396,387,9
44,57,215707399,57739,Waldweistroff,515,510,5
44,57,215707407,57740,Waldwisse,823,812,11
44,57,215707415,57741,Walschbronn,420,408,12
44,57,215707423,57742,Walscheid,1538,1496,42
44,57,215707431,57743,Waltembourg,248,241,7
44,57,215707456,57745,Wiesviller,942,920,22
44,57,215707464,57746,Willerwald,1570,1538,32
44,57,215707472,57747,Wintersbourg,269,266,3
44,57,215707480,57748,Wittring,771,752,19
44,57,215707498,57749,Voelfling-lès-Bouzonville,162,156,6
44,57,215707506,57750,Woelfling-lès-Sarreguemines,736,710,26
44,57,215707514,57751,Woippy,14649,14526,123
44,57,215707522,57752,Woustviller,2941,2891,50
44,57,215707530,57753,Wuisse,60,59,1
44,57,215707548,57754,Xanrey,110,109,1
44,57,215707555,57755,Xocourt,99,99,0
44,57,215707563,57756,Xouaxange,318,314,4
44,57,215707571,57757,Yutz,17580,17304,276
44,57,215707597,57759,Zarbeling,67,66,1
44,57,215707605,57760,Zetting,874,854,20
44,57,215707613,57761,Zilling,277,273,4
44,57,215707621,57762,Zimming,710,704,6
44,57,215707639,57763,Zommange,49,47,2
44,57,215707647,57764,Zoufftgen,1270,1253,17
44,57,215707654,57765,Diesen,1073,1057,16
44,57,215708637,57767,Stuckange,1370,1336,34
27,58,215800012,58001,Achun,159,159,0
27,58,215800020,58002,Alligny-Cosne,932,919,13
27,58,215800038,58003,Alligny-en-Morvan,608,601,7
27,58,215800046,58004,Alluy,382,374,8
27,58,215800053,58005,Amazy,226,222,4
27,58,215800061,58006,Anlezy,245,242,3
27,58,215800079,58007,Annay,349,344,5
27,58,215800087,58008,Anthien,172,168,4
27,58,215800095,58009,Arbourse,127,126,1
27,58,215800103,58010,Arleuf,662,651,11
27,58,215800111,58011,Armes,288,283,5
27,58,215800129,58012,Arquian,584,571,13
27,58,215800137,58013,Arthel,97,95,2
27,58,215800145,58014,Arzembouy,66,65,1
27,58,215800152,58015,Asnan,122,119,3
27,58,215800160,58016,Asnois,143,139,4
27,58,215800178,58017,Aunay-en-Bazois,232,225,7
27,58,215800186,58018,Authiou,45,45,0
27,58,215800194,58019,Avrée,86,84,2
27,58,215800202,58020,Avril-sur-Loire,250,246,4
27,58,215800210,58021,Azy-le-Vif,208,203,5
27,58,215800236,58023,Bazoches,176,173,3
27,58,215800244,58024,Bazolles,291,280,11
27,58,215800251,58025,Béard,170,163,7
27,58,200055051,58026,Beaulieu,150,141,9
27,58,215800277,58027,Beaumont-la-Ferrière,123,120,3
27,58,215800285,58028,Beaumont-Sardolles,121,118,3
27,58,215800293,58029,Beuvron,83,83,0
27,58,215800301,58030,Biches,294,282,12
27,58,215800319,58031,Billy-Chevannes,300,297,3
27,58,215800327,58032,Billy-sur-Oisy,364,357,7
27,58,215800335,58033,Bitry,310,301,9
27,58,215800343,58034,Blismes,191,185,6
27,58,215800350,58035,Bona,299,297,2
27,58,215800368,58036,Bouhy,471,462,9
27,58,215800376,58037,Brassy,627,591,36
27,58,215800384,58038,Breugnon,161,156,5
27,58,215800392,58039,Brèves,234,231,3
27,58,215800400,58040,Brinay,147,144,3
27,58,215800418,58041,Brinon-sur-Beuvron,172,167,5
27,58,215800426,58042,Bulcy,142,140,2
27,58,215800434,58043,Bussy-la-Pesle,53,53,0
27,58,215800442,58044,La Celle-sur-Loire,815,804,11
27,58,215800459,58045,La Celle-sur-Nièvre,159,158,1
27,58,215800467,58046,Cercy-la-Tour,1721,1697,24
27,58,215800475,58047,Cervon,654,639,15
27,58,215800483,58048,Cessy-les-Bois,119,114,5
27,58,215800491,58049,Chalaux,85,83,2
27,58,215800509,58050,Challement,47,45,2
27,58,215800517,58051,Challuy,1655,1522,133
27,58,215800525,58052,Champallement,49,48,1
27,58,215800533,58053,Champlemy,333,325,8
27,58,215800541,58054,Champlin,41,40,1
27,58,215800558,58055,Champvert,766,752,14
27,58,215800566,58056,Champvoux,298,291,7
27,58,215800574,58057,Chantenay-Saint-Imbert,1127,1108,19
27,58,215800582,58058,La Chapelle-Saint-André,303,298,5
27,58,215800590,58059,La Charité-sur-Loire,4726,4673,53
27,58,215800608,58060,Charrin,624,614,10
27,58,215800616,58061,Chasnay,126,125,1
27,58,215800624,58062,Château-Chinon (Ville),2317,1934,383
27,58,215800632,58063,Château-Chinon (Campagne),557,549,8
27,58,215800640,58064,Châteauneuf-Val-de-Bargis,506,491,15
27,58,215800657,58065,Châtillon-en-Bazois,928,912,16
27,58,215800665,58066,Châtin,82,82,0
27,58,215800673,58067,Chaulgnes,1531,1508,23
27,58,215800681,58068,Chaumard,206,205,1
27,58,215800699,58069,Chaumot,167,163,4
27,58,215800707,58070,Chazeuil,58,58,0
27,58,215800715,58071,Chevannes-Changy,144,137,7
27,58,215800723,58072,Chevenon,633,623,10
27,58,215800731,58073,Chevroches,130,126,4
27,58,215800749,58074,Chiddes,355,344,11
27,58,215800756,58075,Chitry-les-Mines,222,218,4
27,58,215800764,58076,Chougny,81,81,0
27,58,215800772,58077,Ciez,380,373,7
27,58,215800780,58078,Cizely,53,53,0
27,58,215800798,58079,Clamecy,3779,3594,185
27,58,215800806,58080,La Collancelle,168,167,1
27,58,215800814,58081,Colméry,275,271,4
27,58,215800822,58082,Corancy,288,284,4
27,58,215800830,58083,Corbigny,1493,1397,96
27,58,215800848,58084,Corvol-d'Embernard,99,95,4
27,58,215800855,58085,Corvol-l'Orgueilleux,742,730,12
27,58,215800863,58086,Cosne-Cours-sur-Loire,9658,9415,243
27,58,215800871,58087,Cossaye,701,689,12
27,58,215800889,58088,Coulanges-lès-Nevers,3779,3708,71
27,58,215800897,58089,Couloutre,199,192,7
27,58,215800905,58090,Courcelles,220,219,1
27,58,215800921,58092,Crux-la-Ville,407,397,10
27,58,215800939,58093,Cuncy-lès-Varzy,128,126,2
27,58,215800947,58094,Dampierre-sous-Bouhy,448,444,4
27,58,215800954,58095,Decize,5375,5193,182
27,58,215800962,58096,Devay,506,496,10
27,58,215800970,58097,Diennes-Aubigny,92,91,1
27,58,215800988,58098,Dirol,115,110,5
27,58,215800996,58099,Dommartin,164,161,3
27,58,215801010,58101,Dompierre-sur-Nièvre,192,190,2
27,58,215801028,58102,Donzy,1596,1571,25
27,58,215801036,58103,Dornecy,477,469,8
27,58,215801044,58104,Dornes,1497,1473,24
27,58,215801051,58105,Druy-Parigny,311,307,4
27,58,215801069,58106,Dun-les-Places,359,356,3
27,58,215801077,58107,Dun-sur-Grandry,146,144,2
27,58,215801085,58108,Empury,87,86,1
27,58,215801093,58109,Entrains-sur-Nohain,751,739,12
27,58,215801101,58110,Epiry,241,239,2
27,58,215801119,58111,Fâchin,104,104,0
27,58,215801127,58112,La Fermeté,636,629,7
27,58,215801135,58113,Fertrève,97,96,1
27,58,215801143,58114,Fléty,95,91,4
27,58,215801150,58115,Fleury-sur-Loire,230,224,6
27,58,215801168,58116,Flez-Cuzy,134,130,4
27,58,215801176,58117,Fourchambault,4120,4069,51
27,58,215801184,58118,Fours,648,641,7
27,58,215801192,58119,Frasnay-Reugny,81,79,2
27,58,215801200,58120,Gâcogne,219,219,0
27,58,215801218,58121,Garchizy,3795,3750,45
27,58,215801226,58122,Garchy,436,425,11
27,58,215801234,58123,Germenay,132,121,11
27,58,215801242,58124,Germigny-sur-Loire,774,767,7
27,58,215801259,58125,Gien-sur-Cure,94,92,2
27,58,215801267,58126,Gimouille,450,438,12
27,58,215801275,58127,Giry,191,188,3
27,58,215801283,58128,Glux-en-Glenne,91,90,1
27,58,215801291,58129,Gouloux,175,170,5
27,58,215801309,58130,Grenois,97,94,3
27,58,215801317,58131,Guérigny,2568,2525,43
27,58,215801325,58132,Guipy,237,227,10
27,58,215801333,58133,Héry,74,72,2
27,58,215801341,58134,Imphy,3233,3195,38
27,58,215801358,58135,Isenay,101,101,0
27,58,215801366,58136,Jailly,70,68,2
27,58,215801374,58137,Lamenay-sur-Loire,71,71,0
27,58,215801382,58138,Langeron,365,352,13
27,58,215801390,58139,Lanty,113,113,0
27,58,215801408,58140,Larochemillay,233,229,4
27,58,215801416,58141,Lavault-de-Frétoy,72,72,0
27,58,215801424,58142,Limanton,240,239,1
27,58,215801432,58143,Limon,146,141,5
27,58,215801440,58144,Livry,696,681,15
27,58,215801457,58145,Lormes,1297,1267,30
27,58,215801465,58146,Lucenay-lès-Aix,1000,981,19
27,58,215801473,58147,Lurcy-le-Bourg,281,276,5
27,58,215801481,58148,Luthenay-Uxeloup,623,613,10
27,58,215801499,58149,Luzy,2033,1994,39
27,58,215801507,58150,Lys,108,108,0
27,58,215801515,58151,La Machine,3283,3231,52
27,58,215801523,58152,Magny-Cours,1431,1404,27
27,58,215801531,58153,Magny-Lormes,72,70,2
27,58,215801549,58154,La Maison-Dieu,116,115,1
27,58,215801556,58155,La Marche,575,558,17
27,58,215801564,58156,Marcy,144,142,2
27,58,215801572,58157,Marigny-l'Église,295,279,16
27,58,215801580,58158,Mars-sur-Allier,309,304,5
27,58,215801598,58159,Marigny-sur-Yonne,196,192,4
27,58,215801606,58160,Marzy,3861,3701,160
27,58,215801614,58161,Maux,146,145,1
27,58,215801622,58162,Menestreau,106,103,3
27,58,215801630,58163,Menou,190,187,3
27,58,215801648,58164,Mesves-sur-Loire,690,661,29
27,58,215801655,58165,Metz-le-Comte,173,166,7
27,58,215801663,58166,Mhère,233,230,3
27,58,215801689,58168,Millay,446,440,6
27,58,215801697,58169,Moissy-Moulinot,16,14,2
27,58,215801705,58170,Monceaux-le-Comte,127,124,3
27,58,215801713,58171,Montapas,290,288,2
27,58,215801721,58172,Montambert,123,121,2
27,58,215801739,58173,Montaron,157,156,1
27,58,215801747,58174,Montenoison,122,120,2
27,58,215801754,58175,Mont-et-Marré,156,155,1
27,58,215801762,58176,Montigny-aux-Amognes,659,637,22
27,58,215801770,58177,Montigny-en-Morvan,277,276,1
27,58,215801788,58178,Montigny-sur-Canne,156,154,2
27,58,215801796,58179,Montreuillon,269,258,11
27,58,215801804,58180,Montsauche-les-Settons,518,515,3
27,58,215801812,58181,Moraches,142,140,2
27,58,215801820,58182,Moulins-Engilbert,1429,1415,14
27,58,215801838,58183,Mouron-sur-Yonne,95,94,1
27,58,215801846,58184,Moussy,105,104,1
27,58,215801853,58185,Moux-en-Morvan,532,528,4
27,58,215801861,58186,Murlin,58,57,1
27,58,215801879,58187,Myennes,531,524,7
27,58,215801887,58188,Nannay,116,113,3
27,58,215801895,58189,Narcy,479,476,3
27,58,215801903,58190,Neuffontaines,107,105,2
27,58,215801911,58191,Neuilly,114,111,3
27,58,215801929,58192,Neuville-lès-Decize,227,218,9
27,58,215801937,58193,Neuvy-sur-Loire,1422,1393,29
27,58,215801945,58194,Nevers,33285,32284,1001
27,58,215801952,58195,La Nocle-Maulaix,277,276,1
27,58,215801960,58196,Nolay,347,344,3
27,58,215801978,58197,Nuars,166,163,3
27,58,215801986,58198,Oisy,304,299,5
27,58,215801994,58199,Onlay,161,157,4
27,58,215802000,58200,Ouagne,148,147,1
27,58,215802018,58201,Oudan,144,141,3
27,58,215802026,58202,Ougny,25,25,0
27,58,215802034,58203,Oulon,63,62,1
27,58,200063287,58204,Vaux d'Amognes,545,538,7
27,58,215802059,58205,Ouroux-en-Morvan,608,600,8
27,58,215802067,58206,Parigny-la-Rose,34,34,0
27,58,215802075,58207,Parigny-les-Vaux,1005,973,32
27,58,215802083,58208,Pazy,306,293,13
27,58,215802091,58209,Perroy,152,147,5
27,58,215802109,58210,Planchez,308,304,4
27,58,215802117,58211,Poil,155,152,3
27,58,215802125,58212,Poiseux,333,329,4
27,58,215802133,58213,Pougny,478,469,9
27,58,215802141,58214,Pougues-les-Eaux,2410,2361,49
27,58,215802158,58215,Pouilly-sur-Loire,1631,1607,24
27,58,215802166,58216,Pouques-Lormes,161,157,4
27,58,215802174,58217,Pousseaux,200,196,4
27,58,215802182,58218,Prémery,1848,1823,25
27,58,215802190,58219,Préporché,211,207,4
27,58,215802208,58220,Raveau,657,645,12
27,58,215802216,58221,Rémilly,152,150,2
27,58,215802224,58222,Rix,158,157,1
27,58,215802232,58223,Rouy,645,637,8
27,58,215802240,58224,Ruages,89,88,1
27,58,215802257,58225,Saincaize-Meauce,376,369,7
27,58,215802265,58226,Saint-Agnan,131,129,2
27,58,215802273,58227,Saint-Amand-en-Puisaye,1244,1223,21
27,58,215802281,58228,Saint-Andelain,596,592,4
27,58,215802299,58229,Saint-André-en-Morvan,315,311,4
27,58,215802307,58230,Saint-Aubin-des-Chaumes,70,70,0
27,58,215802315,58231,Saint-Aubin-les-Forges,395,387,8
27,58,215802323,58232,Saint-Benin-d'Azy,1282,1262,20
27,58,215802331,58233,Saint-Benin-des-Bois,176,175,1
27,58,215802349,58234,Saint-Bonnot,144,143,1
27,58,215802356,58235,Saint-Brisson,257,257,0
27,58,215802364,58236,Sainte-Colombe-des-Bois,138,136,2
27,58,215802372,58237,Saint-Didier,31,29,2
27,58,215802380,58238,Saint-Éloi,2272,2223,49
27,58,215802398,58239,Saint-Firmin,157,155,2
27,58,215802406,58240,Saint-Franchy,80,78,2
27,58,215802414,58241,Saint-Germain-Chassenay,319,314,5
27,58,215802422,58242,Saint-Germain-des-Bois,124,124,0
27,58,215802430,58243,Saint-Gratien-Savigny,118,115,3
27,58,215802448,58244,Saint-Hilaire-en-Morvan,221,215,6
27,58,215802455,58245,Saint-Hilaire-Fontaine,169,165,4
27,58,215802463,58246,Saint-Honoré-les-Bains,711,698,13
27,58,215802471,58247,Saint-Jean-aux-Amognes,491,484,7
27,58,215802489,58248,Saint-Laurent-l'Abbaye,219,214,5
27,58,215802497,58249,Saint-Léger-de-Fougeret,352,350,2
27,58,215802505,58250,Saint-Léger-des-Vignes,1838,1799,39
27,58,215802513,58251,Saint-Loup-des-Bois,477,470,7
27,58,215802521,58252,Saint-Malo-en-Donziois,128,126,2
27,58,215802539,58253,Sainte-Marie,88,81,7
27,58,215802547,58254,Saint-Martin-d'Heuille,576,564,12
27,58,215802554,58255,Saint-Martin-du-Puy,288,283,5
27,58,215802562,58256,Saint-Martin-sur-Nohain,392,378,14
27,58,215802570,58257,Saint-Maurice,66,65,1
27,58,215802588,58258,Saint-Ouen-sur-Loire,540,531,9
27,58,215802596,58259,Saint-Parize-en-Viry,142,142,0
27,58,215802604,58260,Saint-Parize-le-Châtel,1269,1242,27
27,58,215802612,58261,Saint-Père,1075,1055,20
27,58,215802620,58262,Saint-Péreuse,215,209,6
27,58,215802638,58263,Saint-Pierre-du-Mont,169,167,2
27,58,215802646,58264,Saint-Pierre-le-Moûtier,1868,1840,28
27,58,215802653,58265,Saint-Quentin-sur-Nohain,94,91,3
27,58,215802661,58266,Saint-Révérien,170,170,0
27,58,215802679,58267,Saint-Saulge,800,719,81
27,58,215802687,58268,Saint-Seine,196,191,5
27,58,215802695,58269,Saint-Sulpice,430,420,10
27,58,215802703,58270,Saint-Vérain,363,356,7
27,58,215802711,58271,Saizy,189,186,3
27,58,215802729,58272,Sardy-lès-Épiry,113,110,3
27,58,215802737,58273,Sauvigny-les-Bois,1460,1427,33
27,58,215802745,58274,Savigny-Poil-Fol,116,113,3
27,58,215802752,58275,Saxi-Bourdon,293,288,5
27,58,215802760,58276,Sémelay,224,222,2
27,58,215802778,58277,Sermages,196,191,5
27,58,215802786,58278,Sermoise-sur-Loire,1549,1480,69
27,58,215802794,58279,Sichamps,179,173,6
27,58,215802802,58280,Sougy-sur-Loire,608,592,16
27,58,215802810,58281,Suilly-la-Tour,602,589,13
27,58,215802828,58282,Surgy,346,335,11
27,58,215802836,58283,Taconnay,75,73,2
27,58,215802844,58284,Talon,39,37,2
27,58,215802851,58285,Tamnay-en-Bazois,164,159,5
27,58,215802869,58286,Tannay,582,570,12
27,58,215802877,58287,Tazilly,190,188,2
27,58,215802885,58288,Teigny,109,107,2
27,58,215802893,58289,Ternant,183,182,1
27,58,215802901,58290,Thaix,45,44,1
27,58,215802919,58291,Thianges,180,180,0
27,58,215802927,58292,Tintury,165,165,0
27,58,215802935,58293,Toury-Lurcy,413,409,4
27,58,215802943,58294,Toury-sur-Jour,120,120,0
27,58,215802950,58295,Tracy-sur-Loire,1001,985,16
27,58,215802968,58296,Tresnay,136,135,1
27,58,215802976,58297,Trois-Vèvres,245,244,1
27,58,215802984,58298,Tronsanges,409,400,9
27,58,215802992,58299,Trucy-l'Orgueilleux,223,220,3
27,58,215803008,58300,Urzy,1778,1747,31
27,58,215803016,58301,Vandenesse,304,299,5
27,58,215803024,58302,Varennes-lès-Narcy,926,921,5
27,58,215803032,58303,Varennes-Vauzelles,9362,9195,167
27,58,215803040,58304,Varzy,1251,1053,198
27,58,215803057,58305,Vauclaix,137,136,1
27,58,215803065,58306,Verneuil,293,289,4
27,58,215803073,58307,Vielmanay,181,177,4
27,58,215803081,58308,Vignol,62,62,0
27,58,215803099,58309,Villapourçon,418,409,9
27,58,215803107,58310,Villiers-le-Sec,49,48,1
27,58,215803115,58311,Ville-Langy,244,238,6
27,58,215803123,58312,Villiers-sur-Yonne,278,269,9
27,58,215803131,58313,Vitry-Laché,89,87,2
32,59,215900010,59001,Abancourt,481,468,13
32,59,215900028,59002,Abscon,4274,4241,33
32,59,215900036,59003,Aibes,377,371,6
32,59,215900044,59004,Aix-en-Pévèle,1381,1368,13
32,59,215900051,59005,Allennes-les-Marais,3593,3532,61
32,59,215900069,59006,Amfroipret,221,213,8
32,59,215900077,59007,Anhiers,900,892,8
32,59,215900085,59008,Aniche,10025,9944,81
32,59,215900093,59009,Villeneuve-d'Ascq,61902,61258,644
32,59,215900101,59010,Anneux,259,257,2
32,59,215900119,59011,Annoeullin,10787,10679,108
32,59,215900127,59012,Anor,3301,3254,47
32,59,215900135,59013,Anstaing,1584,1559,25
32,59,215900143,59014,Anzin,13270,13195,75
32,59,215900150,59015,Arleux,3186,3160,26
32,59,215900168,59016,Armbouts-Cappel,2203,2159,44
32,59,215900176,59017,Armentières,25588,25225,363
32,59,215900184,59018,Arnèke,1582,1566,16
32,59,215900192,59019,Artres,1067,1055,12
32,59,215900218,59021,Assevent,1828,1810,18
32,59,215900226,59022,Attiches,2264,2234,30
32,59,215900234,59023,Aubencheul-au-Bac,551,544,7
32,59,215900242,59024,Auberchicourt,4661,4634,27
32,59,215900259,59025,Aubers,1726,1698,28
32,59,215900267,59026,Aubigny-au-Bac,1177,1161,16
32,59,215900275,59027,Aubry-du-Hainaut,1736,1720,16
32,59,215900283,59028,Auby,7236,7205,31
32,59,215900291,59029,Auchy-lez-Orchies,1513,1493,20
32,59,215900317,59031,Audignies,378,374,4
32,59,215900325,59032,Aulnoy-lez-Valenciennes,7237,7167,70
32,59,215900333,59033,Aulnoye-Aymeries,9042,8804,238
32,59,215900341,59034,Avelin,2659,2616,43
32,59,215900358,59035,Avesnelles,2355,2309,46
32,59,215900366,59036,Avesnes-sur-Helpe,4295,4158,137
32,59,215900374,59037,Avesnes-les-Aubert,3662,3628,34
32,59,215900382,59038,Avesnes-le-Sec,1463,1445,18
32,59,215900390,59039,Awoingt,830,812,18
32,59,215900416,59041,Bachant,2292,2276,16
32,59,215900424,59042,Bachy,1867,1836,31
32,59,215900432,59043,Bailleul,15250,15026,224
32,59,215900440,59044,Baisieux,5044,4993,51
32,59,215900457,59045,Baives,170,166,4
32,59,215900465,59046,Bambecque,824,822,2
32,59,215900473,59047,Banteux,353,350,3
32,59,215900481,59048,Bantigny,524,515,9
32,59,215900499,59049,Bantouzelle,447,440,7
32,59,215900507,59050,Bas-Lieu,350,342,8
32,59,215900515,59051,La Bassée,6603,6565,38
32,59,215900523,59052,Bauvin,5088,5044,44
32,59,215900531,59053,Bavay,3308,3248,60
32,59,215900549,59054,Bavinchove,1049,1041,8
32,59,215900556,59055,Bazuel,536,526,10
32,59,215900564,59056,Beaucamps-Ligny,867,844,23
32,59,215900572,59057,Beaudignies,568,564,4
32,59,215900580,59058,Beaufort,1027,1013,14
32,59,215900598,59059,Beaumont-en-Cambrésis,454,447,7
32,59,215900606,59060,Beaurain,237,232,5
32,59,215900614,59061,Beaurepaire-sur-Sambre,270,268,2
32,59,215900622,59062,Beaurieux,170,163,7
32,59,215900630,59063,Beauvois-en-Cambrésis,1988,1970,18
32,59,215900648,59064,Bellaing,1275,1263,12
32,59,215900655,59065,Bellignies,827,809,18
32,59,215900663,59066,Bérelles,166,161,5
32,59,215900671,59067,Bergues,3623,3580,43
32,59,215900689,59068,Berlaimont,3210,3174,36
32,59,215900697,59069,Bermerain,751,739,12
32,59,215900705,59070,Bermeries,379,376,3
32,59,215900713,59071,Bersée,2318,2271,47
32,59,215900721,59072,Bersillies,262,256,6
32,59,215900739,59073,Berthen,586,577,9
32,59,215900747,59074,Bertry,2180,2158,22
32,59,215900754,59075,Béthencourt,741,736,5
32,59,215900762,59076,Bettignies,314,309,5
32,59,215900770,59077,Bettrechies,265,259,6
32,59,215900788,59078,Beugnies,625,619,6
32,59,215900796,59079,Beuvrages,6833,6800,33
32,59,215900804,59080,Beuvry-la-Forêt,2856,2817,39
32,59,215900812,59081,Bévillers,571,560,11
32,59,215900820,59082,Bierne,1830,1799,31
32,59,215900838,59083,Bissezeele,261,250,11
32,59,215900846,59084,Blaringhem,2085,2055,30
32,59,215900853,59085,Blécourt,308,302,6
32,59,215900861,59086,Boeschepe,2175,2144,31
32,59,215900879,59087,Boëseghem,758,745,13
32,59,215900887,59088,Bois-Grenier,1826,1802,24
32,59,215900895,59089,Bollezeele,1454,1424,30
32,59,215900903,59090,Bondues,9944,9759,185
32,59,215900911,59091,Borre,590,575,15
32,59,215900929,59092,Bouchain,3979,3937,42
32,59,215900937,59093,Boulogne-sur-Helpe,331,325,6
32,59,215900945,59094,Bourbourg,7135,7087,48
32,59,215900960,59096,Bourghelles,1710,1670,40
32,59,215900978,59097,Boursies,413,408,5
32,59,215900986,59098,Bousbecque,4845,4791,54
32,59,215900994,59099,Bousies,1782,1766,16
32,59,215901000,59100,Bousignies,358,354,4
32,59,215901018,59101,Bousignies-sur-Roc,390,379,11
32,59,215901026,59102,Boussières-en-Cambrésis,444,440,4
32,59,215901034,59103,Boussières-sur-Sambre,526,518,8
32,59,215901042,59104,Boussois,3201,3176,25
32,59,215901059,59105,Bouvignies,1556,1532,24
32,59,215901067,59106,Bouvines,760,746,14
32,59,215901075,59107,Bray-Dunes,4521,4476,45
32,59,215901083,59108,Briastre,739,732,7
32,59,215901091,59109,Brillon,779,770,9
32,59,215901109,59110,Brouckerque,1459,1434,25
32,59,215901117,59111,Broxeele,401,397,4
32,59,215901125,59112,Bruay-sur-l'Escaut,11373,11325,48
32,59,215901133,59113,Bruille-lez-Marchiennes,1360,1354,6
32,59,215901141,59114,Bruille-Saint-Amand,1689,1671,18
32,59,215901158,59115,Brunémont,717,710,7
32,59,215901166,59116,Bry,431,419,12
32,59,215901174,59117,Bugnicourt,1068,1058,10
32,59,215901182,59118,Busigny,2464,2440,24
32,59,215901190,59119,Buysscheure,605,599,6
32,59,215901208,59120,Caëstre,2067,2034,33
32,59,215901216,59121,Cagnoncles,628,621,7
32,59,215901224,59122,Cambrai,32128,31559,569
32,59,215901232,59123,Camphin-en-Carembault,1726,1702,24
32,59,215901240,59124,Camphin-en-Pévèle,2565,2497,68
32,59,215901257,59125,Cantaing-sur-Escaut,414,405,9
32,59,215901265,59126,Cantin,1733,1719,14
32,59,215901273,59127,Capelle,148,143,5
32,59,215901281,59128,Capinghem,2537,2506,31
32,59,215901299,59129,Cappelle-en-Pévèle,2310,2265,45
32,59,215901307,59130,Cappelle-Brouck,1173,1154,19
32,59,215901315,59131,Cappelle-la-Grande,8030,7953,77
32,59,215901323,59132,Carnières,1022,1009,13
32,59,215901331,59133,Carnin,1068,1054,14
32,59,215901349,59134,Cartignies,1267,1257,10
32,59,215901356,59135,Cassel,2349,2249,100
32,59,215901364,59136,Le Cateau-Cambrésis,7153,7016,137
32,59,215901372,59137,Catillon-sur-Sambre,796,788,8
32,59,215901380,59138,Cattenières,696,682,14
32,59,215901398,59139,Caudry,14170,14028,142
32,59,215901406,59140,Caullery,466,457,9
32,59,215901414,59141,Cauroir,581,566,15
32,59,215901422,59142,Cerfontaine,714,709,5
32,59,215901430,59143,La Chapelle-d'Armentières,8724,8656,68
32,59,215901448,59144,Château-l'Abbaye,869,859,10
32,59,215901455,59145,Chemy,782,770,12
32,59,215901463,59146,Chéreng,3019,2978,41
32,59,215901471,59147,Choisies,50,48,2
32,59,215901489,59148,Clairfayts,364,363,1
32,59,215901497,59149,Clary,1102,1086,16
32,59,215901505,59150,Cobrieux,542,535,7
32,59,215901513,59151,Colleret,1617,1595,22
32,59,215901521,59152,Comines,12847,12749,98
32,59,215901539,59153,Condé-sur-l'Escaut,9498,9445,53
32,59,215901554,59155,Coudekerque-Branche,20987,20708,279
32,59,215901562,59156,Courchelettes,2947,2912,35
32,59,215901570,59157,Cousolre,2192,2172,20
32,59,215901588,59158,Coutiches,3197,3151,46
32,59,215901596,59159,Craywick,748,741,7
32,59,215901604,59160,Crespin,4511,4481,30
32,59,215901612,59161,Crèvecoeur-sur-l'Escaut,773,741,32
32,59,215901620,59162,Crochte,686,665,21
32,59,215901638,59163,Croix,20837,20574,263
32,59,215901646,59164,Croix-Caluyau,252,244,8
32,59,215901653,59165,Cuincy,6509,6444,65
32,59,215901661,59166,Curgies,1384,1348,36
32,59,215901679,59167,Cuvillers,208,207,1
32,59,215901687,59168,Cysoing,4866,4798,68
32,59,215901695,59169,Damousies,211,207,4
32,59,215901703,59170,Dechy,5385,5352,33
32,59,215901711,59171,Dehéries,39,38,1
32,59,215901729,59172,Denain,20532,20415,117
32,59,215901737,59173,Deûlémont,1868,1843,25
32,59,215901745,59174,Dimechaux,328,326,2
32,59,215901752,59175,Dimont,319,310,9
32,59,215901760,59176,Doignies,326,323,3
32,59,215901778,59177,Dompierre-sur-Helpe,872,858,14
32,59,215901786,59178,Douai,40697,39842,855
32,59,215901794,59179,Douchy-les-Mines,10179,10144,35
32,59,215901802,59180,Le Doulieu,1481,1462,19
32,59,215901810,59181,Dourlers,548,542,6
32,59,215901828,59182,Drincham,278,274,4
32,59,200027159,59183,Dunkerque,87805,86545,1260
32,59,215901844,59184,Ebblinghem,670,660,10
32,59,215901851,59185,Écaillon,1949,1936,13
32,59,215901869,59186,Eccles,86,84,2
32,59,215901877,59187,Éclaibes,270,265,5
32,59,215901885,59188,Écuélin,144,140,4
32,59,215901893,59189,Eecke,1249,1222,27
32,59,215901901,59190,Élesmes,1012,998,14
32,59,215901919,59191,Élincourt,634,630,4
32,59,215901927,59192,Émerchicourt,873,826,47
32,59,215901935,59193,Emmerin,3101,3077,24
32,59,215901943,59194,Englefontaine,1293,1271,22
32,59,215901950,59195,Englos,624,615,9
32,59,215901968,59196,Ennetières-en-Weppes,1319,1299,20
32,59,215901976,59197,Ennevelin,2323,2295,28
32,59,215901984,59198,Eppe-Sauvage,243,243,0
32,59,215901992,59199,Erchin,701,690,11
32,59,215902008,59200,Eringhem,501,492,9
32,59,215902016,59201,Erquinghem-le-Sec,606,595,11
32,59,215902024,59202,Erquinghem-Lys,5402,5364,38
32,59,215902032,59203,Erre,1589,1580,9
32,59,215902040,59204,Escarmain,490,482,8
32,59,215902057,59205,Escaudain,9489,9445,44
32,59,215902065,59206,Escaudoeuvres,3214,3186,28
32,59,215902073,59207,Escautpont,4200,4172,28
32,59,215902081,59208,Escobecques,315,304,11
32,59,215902099,59209,Esnes,681,673,8
32,59,215902107,59210,Esquelbecq,2176,2125,51
32,59,215902115,59211,Esquerchin,934,914,20
32,59,215902123,59212,Estaires,6624,6501,123
32,59,215902131,59213,Estourmel,472,457,15
32,59,215902149,59214,Estrées,1135,1111,24
32,59,215902156,59215,Estreux,993,960,33
32,59,215902164,59216,Eswars,357,349,8
32,59,215902172,59217,Eth,354,347,7
32,59,215902180,59218,Étroeungt,1307,1291,16
32,59,215902198,59219,Estrun,726,718,8
32,59,215902206,59220,Faches-Thumesnil,18280,18160,120
32,59,215902214,59221,Famars,2562,2494,68
32,59,215902222,59222,Faumont,2281,2235,46
32,59,215902230,59223,Le Favril,505,501,4
32,59,215902248,59224,Féchain,1688,1675,13
32,59,215902255,59225,Feignies,6831,6763,68
32,59,215902263,59226,Felleries,1473,1458,15
32,59,215902271,59227,Fenain,5564,5516,48
32,59,215902289,59228,Férin,1474,1452,22
32,59,215902297,59229,Féron,565,546,19
32,59,215902305,59230,Ferrière-la-Grande,5292,5239,53
32,59,215902313,59231,Ferrière-la-Petite,1094,1081,13
32,59,215902321,59232,La Flamengrie,440,436,4
32,59,215902339,59233,Flaumont-Waudrechies,359,356,3
32,59,215902347,59234,Flers-en-Escrebieux,5792,5751,41
32,59,215902362,59236,Flesquières,267,263,4
32,59,215902370,59237,Flêtre,1015,992,23
32,59,215902388,59238,Flines-lès-Mortagne,1655,1630,25
32,59,215902396,59239,Flines-lez-Raches,5703,5612,91
32,59,215902404,59240,Floursies,130,127,3
32,59,215902412,59241,Floyon,529,515,14
32,59,215902420,59242,Fontaine-au-Bois,686,680,6
32,59,215902438,59243,Fontaine-au-Pire,1229,1217,12
32,59,215902446,59244,Fontaine-Notre-Dame,1797,1767,30
32,59,215902461,59246,Forest-en-Cambrésis,578,575,3
32,59,215902479,59247,Forest-sur-Marque,1520,1503,17
32,59,215902495,59249,Fourmies,11574,11403,171
32,59,215902503,59250,Fournes-en-Weppes,2327,2220,107
32,59,215902511,59251,Frasnoy,380,376,4
32,59,215902529,59252,Frelinghien,2504,2482,22
32,59,215902537,59253,Fresnes-sur-Escaut,7491,7453,38
32,59,215902545,59254,Fressain,892,880,12
32,59,215902552,59255,Fressies,577,572,5
32,59,215902560,59256,Fretin,3278,3245,33
32,59,215902578,59257,Fromelles,1079,1065,14
32,59,215902586,59258,Genech,3463,2839,624
32,59,215902594,59259,Ghissignies,522,502,20
32,59,200057222,59260,Ghyvelde,4170,4111,59
32,59,215902610,59261,Glageon,1780,1751,29
32,59,215902628,59262,Godewaersvelde,2098,2070,28
32,59,215902636,59263,Goeulzin,1071,1045,26
32,59,215902644,59264,Gognies-Chaussée,739,728,11
32,59,215902651,59265,Gommegnies,2331,2295,36
32,59,215902669,59266,Gondecourt,4039,4000,39
32,59,215902677,59267,Gonnelieu,302,295,7
32,59,215902685,59268,La Gorgue,5692,5640,52
32,59,215902693,59269,Gouzeaucourt,1488,1463,25
32,59,215902701,59270,Grand-Fayt,484,477,7
32,59,215902719,59271,Grande-Synthe,20840,20635,205
32,59,215902727,59272,Grand-Fort-Philippe,5103,5054,49
32,59,215902735,59273,Gravelines,11175,11001,174
32,59,215902743,59274,La Groise,485,481,4
32,59,215902750,59275,Gruson,1281,1246,35
32,59,215902768,59276,Guesnain,4695,4667,28
32,59,215902776,59277,Gussignies,342,339,3
32,59,215902784,59278,Hallennes-lez-Haubourdin,4733,4697,36
32,59,215902792,59279,Halluin,20934,20812,122
32,59,215902800,59280,Hamel,789,780,9
32,59,215902818,59281,Hantay,1281,1269,12
32,59,215902826,59282,Hardifort,410,401,9
32,59,215902834,59283,Hargnies,632,622,10
32,59,215902842,59284,Hasnon,3931,3894,37
32,59,215902859,59285,Haspres,2670,2650,20
32,59,215902867,59286,Haubourdin,14661,14556,105
32,59,215902875,59287,Haucourt-en-Cambrésis,194,190,4
32,59,215902883,59288,Haulchin,2354,2328,26
32,59,215902891,59289,Haussy,1546,1514,32
32,59,215902909,59290,Haut-Lieu,389,388,1
32,59,215902917,59291,Hautmont,14413,14318,95
32,59,215902925,59292,Haveluy,3288,3276,12
32,59,215902933,59293,Haverskerque,1426,1408,18
32,59,215902941,59294,Haynecourt,316,309,7
32,59,215902958,59295,Hazebrouck,21869,21464,405
32,59,215902966,59296,Hecq,360,350,10
32,59,215902974,59297,Hélesmes,1956,1937,19
32,59,215902990,59299,Hem,18610,18462,148
32,59,215903006,59300,Hem-Lenglet,558,549,9
32,59,215903014,59301,Hergnies,4492,4465,27
32,59,215903022,59302,Hérin,4153,4125,28
32,59,215903030,59303,Herlies,2387,2358,29
32,59,215903048,59304,Herrin,428,421,7
32,59,215903055,59305,Herzeele,1677,1642,35
32,59,215903063,59306,Hestrud,298,295,3
32,59,215903071,59307,Holque,889,887,2
32,59,215903089,59308,Hondeghem,945,922,23
32,59,215903097,59309,Hondschoote,4123,4041,82
32,59,215903105,59310,Hon-Hergies,879,869,10
32,59,215903113,59311,Honnechy,573,567,6
32,59,215903121,59312,Honnecourt-sur-Escaut,759,743,16
32,59,215903139,59313,Hordain,1446,1431,15
32,59,215903147,59314,Hornaing,3583,3548,35
32,59,215903154,59315,Houdain-lez-Bavay,904,892,12
32,59,215903162,59316,Houplin-Ancoisne,3344,3299,45
32,59,215903170,59317,Houplines,7966,7870,96
32,59,215903188,59318,Houtkerque,995,986,9
32,59,215903196,59319,Hoymille,3387,3185,202
32,59,215903204,59320,Illies,1652,1640,12
32,59,215903212,59321,Inchy,648,643,5
32,59,215903220,59322,Iwuy,3389,3358,31
32,59,215903238,59323,Jenlain,1177,1150,27
32,59,215903246,59324,Jeumont,10544,10447,97
32,59,215903253,59325,Jolimetz,870,856,14
32,59,215903261,59326,Killem,1196,1175,21
32,59,215903279,59327,Lallaing,6346,6311,35
32,59,215903287,59328,Lambersart,27868,27425,443
32,59,215903295,59329,Lambres-lez-Douai,5038,4953,85
32,59,215903303,59330,Landas,2452,2414,38
32,59,215903311,59331,Landrecies,3545,3456,89
32,59,215903329,59332,Lannoy,1818,1810,8
32,59,215903337,59333,Larouillies,258,249,9
32,59,215903345,59334,Lauwin-Planque,1626,1604,22
32,59,215903352,59335,Lecelles,2953,2896,57
32,59,215903360,59336,Lécluse,1381,1366,15
32,59,215903378,59337,Lederzeele,707,687,20
32,59,215903386,59338,Ledringhem,660,640,20
32,59,215903394,59339,Leers,9628,9548,80
32,59,215903402,59340,Leffrinckoucke,4250,4150,100
32,59,215903410,59341,Lesdain,446,439,7
32,59,215903428,59342,Lez-Fontaine,227,223,4
32,59,215903436,59343,Lesquin,9199,9113,86
32,59,215903444,59344,Leval,2510,2500,10
32,59,215903451,59345,Lewarde,2442,2418,24
32,59,215903469,59346,Lezennes,3058,3038,20
32,59,215903477,59347,Liessies,550,534,16
32,59,215903485,59348,Lieu-Saint-Amand,1480,1465,15
32,59,215903493,59349,Ligny-en-Cambrésis,1958,1928,30
32,59,215903501,59350,Lille,238104,236234,1870
32,59,215903519,59351,Limont-Fontaine,551,544,7
32,59,215903527,59352,Linselles,8307,8211,96
32,59,215903535,59353,Locquignol,308,302,6
32,59,215903543,59354,Loffre,732,719,13
32,59,215903568,59356,Lompret,2242,2195,47
32,59,215903576,59357,La Longueville,2103,2070,33
32,59,215903584,59358,Looberghe,1218,1195,23
32,59,215903592,59359,Loon-Plage,6157,6083,74
32,59,215903600,59360,Loos,23153,22896,257
32,59,215903618,59361,Lourches,3895,3872,23
32,59,215903634,59363,Louvignies-Quesnoy,939,922,17
32,59,215903642,59364,Louvil,902,890,12
32,59,215903659,59365,Louvroil,6429,6389,40
32,59,215903667,59366,Lynde,794,779,15
32,59,215903675,59367,Lys-lez-Lannoy,13942,13797,145
32,59,215903683,59368,La Madeleine,22387,22214,173
32,59,215903691,59369,Maing,4092,4039,53
32,59,215903709,59370,Mairieux,711,700,11
32,59,215903717,59371,Le Maisnil,649,634,15
32,59,215903725,59372,Malincourt,486,481,5
32,59,215903741,59374,Marbaix,474,470,4
32,59,215903758,59375,Marchiennes,4612,4549,63
32,59,215903774,59377,Marcoing,1922,1897,25
32,59,215903782,59378,Marcq-en-Baroeul,39319,38604,715
32,59,215903790,59379,Marcq-en-Ostrevent,758,755,3
32,59,215903816,59381,Maresches,828,808,20
32,59,215903824,59382,Maretz,1444,1430,14
32,59,215903832,59383,Marly,12135,12014,121
32,59,215903840,59384,Maroilles,1454,1432,22
32,59,215903857,59385,Marpent,2695,2674,21
32,59,215903865,59386,Marquette-lez-Lille,11175,11105,70
32,59,215903873,59387,Marquette-en-Ostrevant,1931,1919,12
32,59,215903881,59388,Marquillies,2011,1987,24
32,59,215903899,59389,Masnières,2787,2757,30
32,59,215903907,59390,Masny,4122,4080,42
32,59,215903915,59391,Mastaing,892,887,5
32,59,215903923,59392,Maubeuge,29913,29625,288
32,59,215903931,59393,Maulde,1020,1007,13
32,59,215903949,59394,Maurois,406,404,2
32,59,215903956,59395,Mazinghien,302,297,5
32,59,215903964,59396,Mecquignies,724,713,11
32,59,215903972,59397,Merckeghem,615,603,12
32,59,215903980,59398,Mérignies,3424,3289,135
32,59,215903998,59399,Merris,1039,1009,30
32,59,215904004,59400,Merville,9780,9692,88
32,59,215904012,59401,Méteren,2311,2281,30
32,59,215904020,59402,Millam,876,854,22
32,59,215904038,59403,Millonfosse,722,715,7
32,59,215904053,59405,Moeuvres,488,485,3
32,59,215904061,59406,Monceau-Saint-Waast,441,435,6
32,59,215904079,59407,Monchaux-sur-Écaillon,557,548,9
32,59,215904087,59408,Moncheaux,1743,1723,20
32,59,215904095,59409,Monchecourt,2527,2508,19
32,59,215904103,59410,Mons-en-Baroeul,21697,21564,133
32,59,215904111,59411,Mons-en-Pévèle,2142,2105,37
32,59,215904129,59412,Montay,277,273,4
32,59,215904137,59413,Montigny-en-Cambrésis,562,555,7
32,59,215904145,59414,Montigny-en-Ostrevent,4809,4774,35
32,59,215904152,59415,Montrécourt,225,224,1
32,59,215904160,59416,Morbecque,2559,2518,41
32,59,215904186,59418,Mortagne-du-Nord,1591,1584,7
32,59,215904194,59419,Mouchin,1432,1416,16
32,59,215904202,59420,Moustier-en-Fagne,60,58,2
32,59,215904210,59421,Mouvaux,13210,13020,190
32,59,215904228,59422,Naves,639,627,12
32,59,215904236,59423,Neuf-Berquin,1385,1365,20
32,59,215904244,59424,Neuf-Mesnil,1321,1316,5
32,59,215904251,59425,Neuville-en-Avesnois,311,303,8
32,59,215904269,59426,Neuville-en-Ferrain,10194,10126,68
32,59,215904277,59427,La Neuville,644,633,11
32,59,215904285,59428,Neuville-Saint-Rémy,3963,3923,40
32,59,215904293,59429,Neuville-sur-Escaut,2702,2688,14
32,59,215904301,59430,Neuvilly,1095,1084,11
32,59,215904319,59431,Nieppe,7612,7528,84
32,59,215904327,59432,Niergnies,520,513,7
32,59,215904335,59433,Nieurlet,917,905,12
32,59,215904343,59434,Nivelle,1378,1361,17
32,59,215904350,59435,Nomain,2605,2569,36
32,59,215904368,59436,Noordpeene,797,787,10
32,59,215904376,59437,Noyelles-lès-Seclin,867,852,15
32,59,215904384,59438,Noyelles-sur-Escaut,826,813,13
32,59,215904392,59439,Noyelles-sur-Sambre,280,273,7
32,59,215904400,59440,Noyelles-sur-Selle,696,685,11
32,59,215904418,59441,Obies,658,652,6
32,59,215904426,59442,Obrechies,276,270,6
32,59,215904434,59443,Ochtezeele,393,388,5
32,59,215904442,59444,Odomez,928,918,10
32,59,215904459,59445,Ohain,1211,1193,18
32,59,215904467,59446,Oisy,687,679,8
32,59,215904475,59447,Onnaing,8807,8742,65
32,59,215904483,59448,Oost-Cappel,479,474,5
32,59,215904491,59449,Orchies,8672,8529,143
32,59,215904509,59450,Ors,647,638,9
32,59,215904517,59451,Orsinval,565,555,10
32,59,215904525,59452,Ostricourt,5675,5644,31
32,59,215904533,59453,Oudezeele,686,672,14
32,59,215904541,59454,Oxelaëre,527,522,5
32,59,215904558,59455,Paillencourt,1015,1007,8
32,59,215904566,59456,Pecquencourt,6489,6225,264
32,59,215904574,59457,Pérenchies,8629,8584,45
32,59,215904582,59458,Péronne-en-Mélantois,992,972,20
32,59,215904590,59459,Petite-Forêt,5119,5080,39
32,59,215904616,59461,Petit-Fayt,308,302,6
32,59,215904624,59462,Phalempin,4885,4834,51
32,59,215904632,59463,Pitgam,988,976,12
32,59,215904640,59464,Poix-du-Nord,2240,2224,16
32,59,215904657,59465,Pommereuil,781,778,3
32,59,215904665,59466,Pont-à-Marcq,3014,2924,90
32,59,215904673,59467,Pont-sur-Sambre,2461,2434,27
32,59,215904681,59468,Potelle,445,442,3
32,59,215904699,59469,Pradelles,419,415,4
32,59,215904707,59470,Prémesques,2124,2092,32
32,59,215904715,59471,Préseau,2072,2048,24
32,59,215904723,59472,Preux-au-Bois,841,833,8
32,59,215904731,59473,Preux-au-Sart,313,306,7
32,59,215904749,59474,Prisches,1063,1042,21
32,59,215904756,59475,Prouvy,2209,2190,19
32,59,215904764,59476,Proville,3165,3090,75
32,59,215904772,59477,Provin,4532,4488,44
32,59,215904780,59478,Quaëdypre,1149,1123,26
32,59,215904798,59479,Quarouble,3135,3108,27
32,59,215904806,59480,Quérénaing,880,859,21
32,59,215904814,59481,Le Quesnoy,4983,4863,120
32,59,215904822,59482,Quesnoy-sur-Deûle,7045,6985,60
32,59,215904830,59483,Quiévelon,139,137,2
32,59,215904848,59484,Quiévrechain,6387,6354,33
32,59,215904855,59485,Quiévy,1820,1801,19
32,59,215904863,59486,Râches,2724,2682,42
32,59,215904871,59487,Radinghem-en-Weppes,1418,1398,20
32,59,215904889,59488,Raillencourt-Sainte-Olle,2195,2155,40
32,59,215904897,59489,Raimbeaucourt,4064,4010,54
32,59,215904905,59490,Rainsars,184,183,1
32,59,215904913,59491,Raismes,12253,12201,52
32,59,215904921,59492,Ramillies,612,605,7
32,59,215904939,59493,Ramousies,228,227,1
32,59,215904947,59494,Raucourt-au-Bois,157,156,1
32,59,215904954,59495,Recquignies,2485,2460,25
32,59,215904962,59496,Rejet-de-Beaulieu,238,237,1
32,59,215904970,59497,Renescure,2169,2140,29
32,59,215904988,59498,Reumont,355,347,8
32,59,215904996,59499,Rexpoëde,2033,2000,33
32,59,215905001,59500,Ribécourt-la-Tour,380,375,5
32,59,215905019,59501,Rieulay,1283,1258,25
32,59,215905027,59502,Rieux-en-Cambrésis,1449,1439,10
32,59,215905035,59503,Robersart,204,201,3
32,59,215905043,59504,Roeulx,3816,3798,18
32,59,215905050,59505,Rombies-et-Marchipont,762,755,7
32,59,215905068,59506,Romeries,477,470,7
32,59,215905076,59507,Ronchin,19061,18933,128
32,59,215905084,59508,Roncq,13675,13560,115
32,59,215905092,59509,Roost-Warendin,6032,5985,47
32,59,215905118,59511,Rosult,1975,1948,27
32,59,215905126,59512,Roubaix,98480,98066,414
32,59,215905134,59513,Roucourt,460,455,5
32,59,215905142,59514,Rousies,4142,4089,53
32,59,215905159,59515,Rouvignies,666,660,6
32,59,215905167,59516,Rubrouck,946,924,22
32,59,215905175,59517,Les Rues-des-Vignes,770,756,14
32,59,215905183,59518,Ruesnes,466,459,7
32,59,215905191,59519,Rumegies,1772,1739,33
32,59,215905209,59520,Rumilly-en-Cambrésis,1456,1431,25
32,59,215905217,59521,Sailly-lez-Cambrai,437,429,8
32,59,215905225,59522,Sailly-lez-Lannoy,1981,1943,38
32,59,215905233,59523,Sainghin-en-Mélantois,2868,2840,28
32,59,215905241,59524,Sainghin-en-Weppes,5647,5597,50
32,59,215905258,59525,Sains-du-Nord,2812,2787,25
32,59,215905266,59526,Saint-Amand-les-Eaux,16177,15997,180
32,59,215905274,59527,Saint-André-lez-Lille,13104,13004,100
32,59,215905282,59528,Saint-Aubert,1580,1563,17
32,59,215905290,59529,Saint-Aubin,357,349,8
32,59,215905308,59530,Saint-Aybert,334,333,1
32,59,215905316,59531,Saint-Benin,346,340,6
32,59,215905324,59532,Saint-Georges-sur-l'Aa,305,302,3
32,59,215905332,59533,Saint-Hilaire-lez-Cambrai,1575,1559,16
32,59,215905340,59534,Saint-Hilaire-sur-Helpe,863,832,31
32,59,215905357,59535,Saint-Jans-Cappel,1722,1675,47
32,59,215905365,59536,Sainte-Marie-Cappel,905,880,25
32,59,215905373,59537,Saint-Martin-sur-Écaillon,511,502,9
32,59,215905381,59538,Saint-Momelin,431,420,11
32,59,215905399,59539,Saint-Pierre-Brouck,999,984,15
32,59,215905415,59541,Saint-Python,1021,1013,8
32,59,215905423,59542,Saint-Remy-Chaussée,506,498,8
32,59,215905431,59543,Saint-Remy-du-Nord,1094,1083,11
32,59,215905449,59544,Saint-Saulve,11416,11268,148
32,59,215905456,59545,Saint-Souplet,1226,1203,23
32,59,215905464,59546,Saint-Sylvestre-Cappel,1179,1150,29
32,59,215905472,59547,Saint-Vaast-en-Cambrésis,860,852,8
32,59,215905480,59548,Saint-Waast,652,644,8
32,59,215905498,59549,Salesches,333,330,3
32,59,215905506,59550,Salomé,3006,2985,21
32,59,215905514,59551,Saméon,1761,1738,23
32,59,215905522,59552,Sancourt,201,195,6
32,59,215905530,59553,Santes,5714,5663,51
32,59,215905548,59554,Sars-et-Rosières,633,618,15
32,59,215905555,59555,Sars-Poteries,1450,1432,18
32,59,215905563,59556,Sassegnies,264,261,3
32,59,215905571,59557,Saultain,2594,2577,17
32,59,215905589,59558,Saulzoir,1703,1684,19
32,59,215905597,59559,Sebourg,2022,1989,33
32,59,215905605,59560,Seclin,12598,12505,93
32,59,215905621,59562,Sémeries,545,538,7
32,59,215905639,59563,Semousies,237,234,3
32,59,215905647,59564,La Sentinelle,3167,3151,16
32,59,215905654,59565,Sepmeries,660,649,11
32,59,215905662,59566,Sequedin,4850,4812,38
32,59,215905670,59567,Séranvillers-Forenville,422,416,6
32,59,215905688,59568,Sercus,492,484,8
32,59,215905696,59569,Sin-le-Noble,15539,15442,97
32,59,215905704,59570,Socx,925,906,19
32,59,215905712,59571,Solesmes,4374,4266,108
32,59,215905720,59572,Solre-le-Château,1798,1777,21
32,59,215905738,59573,Solrinnes,144,141,3
32,59,215905746,59574,Somain,11952,11869,83
32,59,215905753,59575,Sommaing,403,399,4
32,59,215905761,59576,Spycker,1815,1779,36
32,59,215905779,59577,Staple,675,671,4
32,59,215905787,59578,Steenbecque,1691,1662,29
32,59,215905795,59579,Steene,1398,1373,25
32,59,215905803,59580,Steenvoorde,4408,4341,67
32,59,215905811,59581,Steenwerck,3661,3606,55
32,59,215905829,59582,Strazeele,970,947,23
32,59,215905837,59583,Taisnières-en-Thiérache,477,473,4
32,59,215905845,59584,Taisnières-sur-Hon,969,957,12
32,59,215905852,59585,Templemars,3563,3528,35
32,59,215905860,59586,Templeuve-en-Pévèle,6559,6469,90
32,59,215905878,59587,Terdeghem,531,517,14
32,59,200057123,59588,Téteghem-Coudekerque-Village,8474,8258,216
32,59,215905894,59589,Thiant,3024,3000,24
32,59,215905902,59590,Thiennes,931,918,13
32,59,215905910,59591,Thivencelle,830,827,3
32,59,215905928,59592,Thumeries,4001,3957,44
32,59,215905936,59593,Thun-l'Évêque,767,756,11
32,59,215905944,59594,Thun-Saint-Amand,1129,1116,13
32,59,215905951,59595,Thun-Saint-Martin,549,541,8
32,59,215905969,59596,Tilloy-lez-Marchiennes,539,519,20
32,59,215905977,59597,Tilloy-lez-Cambrai,705,682,23
32,59,215905985,59598,Toufflers,3945,3914,31
32,59,215905993,59599,Tourcoing,99826,99165,661
32,59,215906009,59600,Tourmignies,955,940,15
32,59,215906017,59601,Trélon,2811,2744,67
32,59,215906025,59602,Tressin,1439,1401,38
32,59,215906033,59603,Trith-Saint-Léger,6265,6186,79
32,59,215906041,59604,Troisvilles,822,815,7
32,59,215906058,59605,Uxem,1497,1470,27
32,59,215906066,59606,Valenciennes,43188,42738,450
32,59,215906074,59607,Vendegies-au-Bois,488,483,5
32,59,215906082,59608,Vendegies-sur-Écaillon,1130,1108,22
32,59,215906090,59609,Vendeville,1569,1548,21
32,59,215906108,59610,Verchain-Maugré,1096,1087,9
32,59,215906116,59611,Verlinghem,2665,2607,58
32,59,215906124,59612,Vertain,517,508,9
32,59,215906132,59613,Vicq,1479,1465,14
32,59,215906140,59614,Viesly,1412,1394,18
32,59,215906157,59615,Vieux-Berquin,2678,2634,44
32,59,215906165,59616,Vieux-Condé,10465,10409,56
32,59,215906173,59617,Vieux-Mesnil,644,637,7
32,59,215906181,59618,Vieux-Reng,905,899,6
32,59,215906199,59619,Villereau,1069,1054,15
32,59,215906207,59620,Villers-au-Tertre,673,664,9
32,59,215906223,59622,Villers-en-Cauchies,1191,1174,17
32,59,215906231,59623,Villers-Guislain,689,686,3
32,59,215906249,59624,Villers-Outréaux,2171,2146,25
32,59,215906256,59625,Villers-Plouich,398,393,5
32,59,215906264,59626,Villers-Pol,1316,1295,21
32,59,215906272,59627,Villers-Sire-Nicole,1016,1005,11
32,59,215906280,59628,Volckerinckhove,567,562,5
32,59,215906298,59629,Vred,1343,1320,23
32,59,215906306,59630,Wahagnies,2664,2615,49
32,59,215906314,59631,Walincourt-Selvigny,2157,2132,25
32,59,215906322,59632,Wallers,5652,5617,35
32,59,215906330,59633,Wallers-en-Fagne,289,282,7
32,59,215906348,59634,Wallon-Cappel,797,777,20
32,59,215906355,59635,Wambaix,372,366,6
32,59,215906363,59636,Wambrechies,10821,10716,105
32,59,215906371,59637,Wandignies-Hamage,1341,1327,14
32,59,215906389,59638,Wannehain,1343,1330,13
32,59,215906397,59639,Wargnies-le-Grand,1125,1102,23
32,59,215906405,59640,Wargnies-le-Petit,785,774,11
32,59,215906413,59641,Warhem,2045,2009,36
32,59,215906421,59642,Warlaing,606,590,16
32,59,215906439,59643,Warneton,240,235,5
32,59,215906454,59645,Wasnes-au-Bac,597,593,4
32,59,215906462,59646,Wasquehal,21190,20980,210
32,59,215906470,59647,Watten,2608,2587,21
32,59,215906488,59648,Wattignies,15572,15372,200
32,59,215906496,59649,Wattignies-la-Victoire,244,239,5
32,59,215906504,59650,Wattrelos,41197,41015,182
32,59,215906512,59651,Wavrechain-sous-Denain,1635,1624,11
32,59,215906520,59652,Wavrechain-sous-Faulx,419,419,0
32,59,215906538,59653,Wavrin,7793,7736,57
32,59,215906546,59654,Waziers,7444,7381,63
32,59,215906553,59655,Wemaers-Cappel,250,246,4
32,59,215906561,59656,Wervicq-Sud,5373,5322,51
32,59,215906579,59657,West-Cappel,639,632,7
32,59,215906587,59658,Wicres,540,533,7
32,59,215906595,59659,Wignehies,2863,2830,33
32,59,215906603,59660,Willems,3053,3023,30
32,59,215906611,59661,Willies,135,133,2
32,59,215906629,59662,Winnezeele,1341,1319,22
32,59,215906637,59663,Wormhout,5794,5709,85
32,59,215906645,59664,Wulverdinghe,329,322,7
32,59,215906652,59665,Wylder,305,299,6
32,59,215906660,59666,Zegerscappel,1565,1540,25
32,59,215906678,59667,Zermezeele,237,231,6
32,59,215906686,59668,Zuydcoote,1653,1593,60
32,59,215906694,59669,Zuytpeene,529,512,17
32,59,215906702,59670,Don,1374,1362,12
32,60,216000018,60001,Abancourt,619,606,13
32,60,216000059,60002,Abbecourt,847,822,25
32,60,216000091,60003,Abbeville-Saint-Lucien,521,508,13
32,60,216000026,60004,Achy,414,407,7
32,60,216000034,60005,Acy-en-Multien,902,889,13
32,60,216000042,60006,Les Ageux,1163,1143,20
32,60,216000075,60007,Agnetz,3153,3054,99
32,60,216000067,60008,Airion,533,370,163
32,60,216000083,60009,Allonne,1692,1659,33
32,60,216000109,60010,Amblainville,1770,1752,18
32,60,216000117,60011,Amy,412,410,2
32,60,216000125,60012,Andeville,3372,3332,40
32,60,216000133,60013,Angicourt,1402,1374,28
32,60,216000141,60014,Angivillers,171,166,5
32,60,216000158,60015,Angy,1161,1147,14
32,60,216000166,60016,Ansacq,281,273,8
32,60,216000174,60017,Ansauvillers,1205,1185,20
32,60,216000190,60019,Antheuil-Portes,429,417,12
32,60,216000208,60020,Antilly,264,261,3
32,60,216000216,60021,Appilly,535,529,6
32,60,216000224,60022,Apremont,656,642,14
32,60,216000232,60023,Armancourt,556,539,17
32,60,216000240,60024,Arsy,793,784,9
32,60,216000257,60025,Attichy,1905,1864,41
32,60,216000265,60026,Auchy-la-Montagne,587,577,10
32,60,216000273,60027,Auger-Saint-Vincent,546,532,14
32,60,216000281,60028,Aumont-en-Halatte,516,494,22
32,60,200073518,60029,Auneuil,2895,2856,39
32,60,216000604,60030,Auteuil,565,556,9
32,60,216000307,60031,Autheuil-en-Valois,272,265,7
32,60,216000315,60032,Autrêches,731,717,14
32,60,216000323,60033,Avilly-Saint-Léonard,924,885,39
32,60,216000331,60034,Avrechy,1186,1169,17
32,60,216000349,60035,Avricourt,249,245,4
32,60,216000356,60036,Avrigny,396,390,6
32,60,216000364,60037,Baboeuf,518,510,8
32,60,216000380,60039,Bacouël,490,484,6
32,60,216000398,60040,Bailleul-le-Soc,653,642,11
32,60,216000406,60041,Bailleul-sur-Thérain,2381,2321,60
32,60,216000414,60042,Bailleval,1532,1486,46
32,60,216000422,60043,Bailly,628,615,13
32,60,216000430,60044,Balagny-sur-Thérain,1697,1671,26
32,60,216000448,60045,Barbery,573,563,10
32,60,216000455,60046,Bargny,348,342,6
32,60,216000463,60047,Baron,779,763,16
32,60,216000471,60048,Baugy,283,278,5
32,60,216000489,60049,Bazancourt,109,106,3
32,60,216000497,60050,Bazicourt,359,351,8
32,60,216000505,60051,Beaudéduit,178,177,1
32,60,216000513,60052,Beaugies-sous-Bois,101,98,3
32,60,216000521,60053,Beaulieu-les-Fontaines,641,591,50
32,60,200083483,60054,Les Hauts-Talican,892,873,19
32,60,216000547,60055,Beaurains-lès-Noyon,345,340,5
32,60,216000554,60056,Beaurepaire,66,65,1
32,60,216000562,60057,Beauvais,58306,56889,1417
32,60,216000570,60058,Beauvoir,216,212,4
32,60,216000588,60059,Béhéricourt,205,202,3
32,60,216000596,60060,Belle-Église,667,656,11
32,60,216000612,60061,Belloy,84,79,5
32,60,216000620,60062,Berlancourt,320,316,4
32,60,216000638,60063,Berneuil-en-Bray,817,798,19
32,60,216000646,60064,Berneuil-sur-Aisne,1006,989,17
32,60,216000653,60065,Berthecourt,1649,1616,33
32,60,216000661,60066,Béthancourt-en-Valois,212,202,10
32,60,216000679,60067,Béthisy-Saint-Martin,1018,999,19
32,60,216000687,60068,Béthisy-Saint-Pierre,3195,3154,41
32,60,216000695,60069,Betz,1171,1131,40
32,60,216000703,60070,Bienville,462,452,10
32,60,216000711,60071,Biermont,177,172,5
32,60,216000729,60072,Bitry,329,317,12
32,60,216000737,60073,Blacourt,574,568,6
32,60,216000745,60074,Blaincourt-lès-Précy,1220,1191,29
32,60,216000752,60075,Blancfossé,142,142,0
32,60,216000760,60076,Blargies,525,516,9
32,60,216000778,60077,Blicourt,363,354,9
32,60,216000786,60078,Blincourt,118,116,2
32,60,216000794,60079,Boissy-Fresnoy,993,981,12
32,60,216000810,60081,Bonlier,486,477,9
32,60,216000828,60082,Bonneuil-les-Eaux,798,782,16
32,60,216000836,60083,Bonneuil-en-Valois,1005,982,23
32,60,216000844,60084,Bonnières,190,189,1
32,60,216000851,60085,Bonvillers,197,196,1
32,60,216000869,60086,Boran-sur-Oise,2174,2129,45
32,60,216000877,60087,Borest,357,340,17
32,60,200053734,60088,Bornel,4844,4774,70
32,60,216000893,60089,Boubiers,406,401,5
32,60,216000901,60090,Bouconvillers,392,386,6
32,60,216000919,60091,Bouillancy,426,420,6
32,60,216000927,60092,Boullarre,219,214,5
32,60,216000935,60093,Boulogne-la-Grasse,471,462,9
32,60,216000943,60094,Boursonne,317,314,3
32,60,216000950,60095,Boury-en-Vexin,350,343,7
32,60,216000976,60097,Boutencourt,214,209,5
32,60,216000984,60098,Bouvresse,163,159,4
32,60,216000992,60099,Braisnes-sur-Aronde,177,174,3
32,60,216001008,60100,Brasseuse,119,113,6
32,60,216001016,60101,Brégy,675,661,14
32,60,216001024,60102,Brenouille,2047,2008,39
32,60,216001032,60103,Bresles,4047,3993,54
32,60,216001040,60104,Breteuil,4302,4192,110
32,60,216001057,60105,Brétigny,435,427,8
32,60,216001065,60106,Breuil-le-Sec,2707,2668,39
32,60,216001073,60107,Breuil-le-Vert,3278,3133,145
32,60,216001081,60108,Briot,301,293,8
32,60,216001099,60109,Brombos,258,254,4
32,60,216001107,60110,Broquiers,252,252,0
32,60,216001115,60111,Broyes,150,148,2
32,60,216001123,60112,Brunvillers-la-Motte,352,351,1
32,60,216001131,60113,Bucamps,205,203,2
32,60,216001149,60114,Buicourt,149,148,1
32,60,216001156,60115,Bulles,894,878,16
32,60,216001164,60116,Bury,2992,2951,41
32,60,216001172,60117,Bussy,323,310,13
32,60,216001180,60118,Caisnes,516,507,9
32,60,216001198,60119,Cambronne-lès-Ribécourt,1951,1920,31
32,60,216001206,60120,Cambronne-lès-Clermont,1228,1203,25
32,60,216001214,60121,Campagne,164,160,4
32,60,216006940,60122,Campeaux,500,490,10
32,60,216001222,60123,Campremy,481,481,0
32,60,216001230,60124,Candor,324,317,7
32,60,216001248,60125,Canly,773,754,19
32,60,216001255,60126,Cannectancourt,525,513,12
32,60,216001263,60127,Canny-sur-Matz,406,403,3
32,60,216001271,60128,Canny-sur-Thérain,225,225,0
32,60,216001289,60129,Carlepont,1505,1475,30
32,60,216001297,60130,Catenoy,1058,1035,23
32,60,216001305,60131,Catheux,106,104,2
32,60,216001313,60132,Catigny,188,185,3
32,60,216001321,60133,Catillon-Fumechon,542,538,4
32,60,216001339,60134,Cauffry,2660,2634,26
32,60,216001347,60135,Cauvigny,1666,1629,37
32,60,216001354,60136,Cempuis,514,502,12
32,60,216001362,60137,Cernoy,296,293,3
32,60,216001370,60138,Chamant,1053,1025,28
32,60,216001388,60139,Chambly,10266,10127,139
32,60,216001396,60140,Chambors,317,310,7
32,60,216001404,60141,Chantilly,10821,10604,217
32,60,216001412,60142,La Chapelle-en-Serval,3231,3141,90
32,60,216001420,60143,Chaumont-en-Vexin,3391,3348,43
32,60,216001438,60144,Chavençon,176,172,4
32,60,216001446,60145,Chelles,485,473,12
32,60,216001453,60146,Chepoix,467,463,4
32,60,216001461,60147,Chevincourt,823,790,33
32,60,216001479,60148,Chèvreville,422,412,10
32,60,216001487,60149,Chevrières,2085,2018,67
32,60,216001495,60150,Chiry-Ourscamp,1203,1177,26
32,60,216001503,60151,Choisy-au-Bac,3412,3307,105
32,60,216001511,60152,Choisy-la-Victoire,248,247,1
32,60,216001529,60153,Choqueuse-les-Bénards,102,102,0
32,60,216001537,60154,Cinqueux,1661,1604,57
32,60,216001545,60155,Cires-lès-Mello,4050,3995,55
32,60,216001552,60156,Clairoix,2292,2245,47
32,60,216001560,60157,Clermont,10481,10268,213
32,60,216001578,60158,Coivrel,247,245,2
32,60,216001586,60159,Compiègne,41470,40453,1017
32,60,216001594,60160,Conchy-les-Pots,741,728,13
32,60,216001602,60161,Conteville,72,72,0
32,60,216001610,60162,Corbeil-Cerf,320,312,8
32,60,216001628,60163,Cormeilles,409,403,6
32,60,216001636,60164,Le Coudray-Saint-Germer,869,859,10
32,60,216001644,60165,Le Coudray-sur-Thelle,542,528,14
32,60,216001651,60166,Coudun,1095,1063,32
32,60,216001669,60167,Couloisy,606,592,14
32,60,216001677,60168,Courcelles-Epayelles,216,214,2
32,60,216001685,60169,Courcelles-lès-Gisors,832,810,22
32,60,216001693,60170,Courteuil,603,568,35
32,60,216001701,60171,Courtieux,182,179,3
32,60,216001719,60172,Coye-la-Forêt,4118,3972,146
32,60,216001727,60173,Cramoisy,822,810,12
32,60,216001735,60174,Crapeaumesnil,215,211,4
32,60,216001743,60175,Creil,36193,35970,223
32,60,216001750,60176,Crépy-en-Valois,14645,14365,280
32,60,216001768,60177,Cressonsacq,450,442,8
32,60,216001776,60178,Crèvecoeur-le-Grand,3598,3472,126
32,60,216001784,60179,Crèvecoeur-le-Petit,152,151,1
32,60,216001792,60180,Crillon,512,497,15
32,60,216001800,60181,Crisolles,926,908,18
32,60,216001818,60182,Le Crocq,180,176,4
32,60,216001826,60183,Croissy-sur-Celle,257,248,9
32,60,216001834,60184,Croutoy,217,207,10
32,60,216001842,60185,Crouy-en-Thelle,1126,1117,9
32,60,216001859,60186,Cuignières,254,251,3
32,60,216001867,60187,Cuigy-en-Bray,990,975,15
32,60,216001875,60188,Cuise-la-Motte,2326,2220,106
32,60,216001883,60189,Cuts,988,967,21
32,60,216001891,60190,Cuvergnon,306,300,6
32,60,216001909,60191,Cuvilly,629,623,6
32,60,216001917,60192,Cuy,225,219,6
32,60,216001925,60193,Daméraucourt,206,204,2
32,60,216001933,60194,Dargies,248,246,2
32,60,216001941,60195,Delincourt,524,514,10
32,60,200062644,60196,La Drenne,1063,1047,16
32,60,216001966,60197,Dieudonné,931,924,7
32,60,216001974,60198,Dives,401,392,9
32,60,216001982,60199,Doméliers,264,256,8
32,60,216001990,60200,Domfront,320,318,2
32,60,216002006,60201,Dompierre,245,242,3
32,60,216002014,60203,Duvy,436,429,7
32,60,216002022,60204,Écuvilly,308,303,5
32,60,216002030,60205,Élencourt,51,50,1
32,60,216002048,60206,Élincourt-Sainte-Marguerite,897,877,20
32,60,216002055,60207,Éméville,292,286,6
32,60,216002063,60208,Énencourt-Léage,127,121,6
32,60,200083459,60209,La Corne-en-Vexin,554,544,10
32,60,216002089,60210,Épineuse,271,267,4
32,60,216002097,60211,Éragny-sur-Epte,602,598,4
32,60,216002105,60212,Ercuis,1632,1606,26
32,60,216002113,60213,Ermenonville,967,946,21
32,60,216002121,60214,Ernemont-Boutavent,211,203,8
32,60,216002139,60215,Erquery,608,595,13
32,60,216002147,60216,Erquinvillers,187,185,2
32,60,216002154,60217,Escames,221,217,4
32,60,216002162,60218,Esches,1637,1626,11
32,60,216002170,60219,Escles-Saint-Pierre,169,168,1
32,60,216002188,60220,Espaubourg,519,503,16
32,60,216002196,60221,Esquennoy,722,719,3
32,60,216002204,60222,Essuiles,569,552,17
32,60,216002212,60223,Estrées-Saint-Denis,3810,3726,84
32,60,216002220,60224,Étavigny,165,160,5
32,60,216002238,60225,Étouy,863,821,42
32,60,216002246,60226,Ève,427,421,6
32,60,216002253,60227,Évricourt,236,233,3
32,60,216002261,60228,Fay-les-Étangs,474,465,9
32,60,216002279,60229,Le Fayel,234,230,4
32,60,216002287,60230,Le Fay-Saint-Quentin,538,524,14
32,60,216002295,60231,Feigneux,436,422,14
32,60,216002303,60232,Ferrières,472,468,4
32,60,216002311,60233,Feuquières,1381,1360,21
32,60,216002329,60234,Fitz-James,2606,2578,28
32,60,216002337,60235,Flavacourt,683,663,20
32,60,216002345,60236,Flavy-le-Meldeux,223,220,3
32,60,216002352,60237,Fléchy,89,88,1
32,60,216002360,60238,Fleurines,1924,1844,80
32,60,216002378,60239,Fleury,587,575,12
32,60,216002386,60240,Fontaine-Bonneleau,237,234,3
32,60,216002394,60241,Fontaine-Chaalis,345,330,15
32,60,216002402,60242,Fontaine-Lavaganne,514,504,10
32,60,216002410,60243,Fontaine-Saint-Lucien,182,175,7
32,60,216002428,60244,Fontenay-Torcy,147,146,1
32,60,200083467,60245,Formerie,2133,2109,24
32,60,216002451,60247,Fouilleuse,147,145,2
32,60,216002469,60248,Fouilloy,223,216,7
32,60,216002477,60249,Foulangues,201,197,4
32,60,216002485,60250,Fouquenies,434,421,13
32,60,216002493,60251,Fouquerolles,285,280,5
32,60,216002501,60252,Fournival,529,526,3
32,60,216002519,60253,Francastel,505,497,8
32,60,216002527,60254,Francières,568,552,16
32,60,216002535,60255,Fréniches,335,332,3
32,60,200087344,60256,Montchevreuil,1345,1324,21
32,60,216002550,60257,Fresne-Léguillon,450,440,10
32,60,216002568,60258,Fresnières,167,161,6
32,60,216002576,60259,Fresnoy-en-Thelle,908,885,23
32,60,216002584,60260,Fresnoy-la-Rivière,698,677,21
32,60,216002592,60261,Fresnoy-le-Luat,551,538,13
32,60,216002600,60262,Le Frestoy-Vaux,250,244,6
32,60,216002618,60263,Frétoy-le-Château,265,264,1
32,60,216002626,60264,Frocourt,523,510,13
32,60,216002634,60265,Froissy,993,978,15
32,60,216002642,60267,Le Gallet,176,170,6
32,60,216002659,60268,Gannes,338,337,1
32,60,216002667,60269,Gaudechart,349,344,5
32,60,216002675,60270,Genvry,420,335,85
32,60,216002683,60271,Gerberoy,85,83,2
32,60,216002691,60272,Gilocourt,650,631,19
32,60,216002709,60273,Giraumont,546,530,16
32,60,216002717,60274,Glaignes,393,379,14
32,60,216002725,60275,Glatigny,221,221,0
32,60,216002733,60276,Godenvillers,210,208,2
32,60,216002741,60277,Goincourt,1600,1560,40
32,60,216002758,60278,Golancourt,411,406,5
32,60,216002766,60279,Gondreville,200,195,5
32,60,216002774,60280,Gourchelles,107,107,0
32,60,216002782,60281,Gournay-sur-Aronde,553,539,14
32,60,216002790,60282,Gouvieux,9332,8946,386
32,60,216002808,60283,Gouy-les-Groseillers,17,16,1
32,60,216002816,60284,Grandfresnoy,1866,1804,62
32,60,216002824,60285,Grandvillers-aux-Bois,319,304,15
32,60,216002832,60286,Grandvilliers,2869,2793,76
32,60,216002840,60287,Grandrû,364,360,4
32,60,216002857,60288,Grémévillers,484,475,9
32,60,216002865,60289,Grez,270,265,5
32,60,216002873,60290,Guignecourt,394,387,7
32,60,216002881,60291,Guiscard,1823,1800,23
32,60,216002899,60292,Gury,242,235,7
32,60,216002907,60293,Hadancourt-le-Haut-Clocher,382,375,7
32,60,216002915,60294,Hainvillers,86,85,1
32,60,216002923,60295,Halloy,453,445,8
32,60,216002931,60296,Hannaches,139,135,4
32,60,216002949,60297,Le Hamel,189,188,1
32,60,216002956,60298,Hanvoile,661,648,13
32,60,216002964,60299,Hardivillers,549,540,9
32,60,216002980,60301,Haucourt,140,134,6
32,60,216002998,60302,Haudivillers,804,781,23
32,60,216003004,60303,Hautbos,199,198,1
32,60,216003012,60304,Haute-Épine,281,272,9
32,60,216003020,60305,Hautefontaine,346,339,7
32,60,216003038,60306,Hécourt,156,153,3
32,60,216003046,60307,Heilles,659,648,11
32,60,216003053,60308,Hémévillers,474,468,6
32,60,216003061,60309,Hénonville,916,896,20
32,60,216003079,60310,Herchies,629,615,14
32,60,216003087,60311,La Hérelle,238,236,2
32,60,216003095,60312,Héricourt-sur-Thérain,114,112,2
32,60,216003103,60313,Hermes,2551,2510,41
32,60,216003111,60314,Hétomesnil,331,327,4
32,60,216003129,60315,Hodenc-en-Bray,504,492,12
32,60,216003137,60316,Hodenc-l'Évêque,245,239,6
32,60,216003145,60317,Hondainville,733,725,8
32,60,216003152,60318,Houdancourt,678,665,13
32,60,216003160,60319,La Houssoye,612,607,5
32,60,216003178,60320,Ivors,263,257,6
32,60,216003186,60321,Ivry-le-Temple,850,843,7
32,60,216003194,60322,Jaméricourt,329,324,5
32,60,216003202,60323,Janville,657,646,11
32,60,216003210,60324,Jaulzy,884,873,11
32,60,216003228,60325,Jaux,2346,2282,64
32,60,216003236,60326,Jonquières,621,599,22
32,60,216003244,60327,Jouy-sous-Thelle,1066,1048,18
32,60,216003251,60328,Juvignies,311,302,9
32,60,216003269,60329,Laberlière,208,202,6
32,60,216003277,60330,Laboissière-en-Thelle,1365,1339,26
32,60,216003285,60331,Labosse,451,445,6
32,60,216003293,60332,Labruyère,733,724,9
32,60,216003301,60333,Lachapelle-aux-Pots,1648,1618,30
32,60,216003319,60334,Lachapelle-Saint-Pierre,860,846,14
32,60,216003327,60335,Lachapelle-sous-Gerberoy,149,148,1
32,60,216003335,60336,Lachaussée-du-Bois-d'Écu,192,189,3
32,60,216003343,60337,Lachelle,802,773,29
32,60,216003350,60338,Lacroix-Saint-Ouen,5107,4943,164
32,60,216003368,60339,Lafraye,367,358,9
32,60,216003376,60340,Lagny,551,533,18
32,60,216003384,60341,Lagny-le-Sec,2110,2055,55
32,60,216003392,60342,Laigneville,4775,4722,53
32,60,216003400,60343,Lalande-en-Son,638,615,23
32,60,216003418,60344,Lalandelle,516,507,9
32,60,216003426,60345,Lamécourt,192,190,2
32,60,216003434,60346,Lamorlaye,9130,8889,241
32,60,216003459,60347,Lannoy-Cuillère,287,282,5
32,60,216003467,60348,Larbroye,525,516,9
32,60,216003475,60350,Lassigny,1396,1371,25
32,60,216003483,60351,Lataule,122,120,2
32,60,216003491,60352,Lattainville,172,170,2
32,60,216003509,60353,Lavacquerie,190,189,1
32,60,216003517,60354,Laverrière,32,31,1
32,60,216003525,60355,Laversines,1221,1169,52
32,60,216003533,60356,Lavilletertre,656,640,16
32,60,216003541,60357,Léglantiers,558,551,7
32,60,216003558,60358,Lévignen,1040,1015,25
32,60,216003566,60359,Lhéraule,202,199,3
32,60,216003574,60360,Liancourt,7149,7083,66
32,60,216003582,60361,Liancourt-Saint-Pierre,599,587,12
32,60,216003590,60362,Libermont,180,174,6
32,60,216003608,60363,Lierville,222,221,1
32,60,216003616,60364,Lieuvillers,710,702,8
32,60,216003624,60365,Lihus,433,428,5
32,60,216003632,60366,Litz,369,364,5
32,60,216003640,60367,Loconville,340,332,8
32,60,216003657,60368,Longueil-Annel,2645,2594,51
32,60,216003665,60369,Longueil-Sainte-Marie,2036,2000,36
32,60,216003673,60370,Lormaison,1328,1314,14
32,60,216003681,60371,Loueuse,154,152,2
32,60,216003699,60372,Luchy,679,663,16
32,60,216003707,60373,Machemont,826,806,20
32,60,216003715,60374,Maignelay-Montigny,2654,2616,38
32,60,216003723,60375,Maimbeville,404,394,10
32,60,216003731,60376,Maisoncelle-Saint-Pierre,176,175,1
32,60,216003749,60377,Maisoncelle-Tuilerie,292,284,8
32,60,216003756,60378,Marest-sur-Matz,393,388,5
32,60,216003764,60379,Mareuil-la-Motte,628,612,16
32,60,216003772,60380,Mareuil-sur-Ourcq,1627,1601,26
32,60,216003780,60381,Margny-aux-Cerises,257,254,3
32,60,216003798,60382,Margny-lès-Compiègne,8883,8704,179
32,60,216003806,60383,Margny-sur-Matz,553,540,13
32,60,216003814,60385,Marolles,673,659,14
32,60,216003822,60386,Marquéglise,487,479,8
32,60,216003830,60387,Marseille-en-Beauvaisis,1480,1469,11
32,60,216003848,60388,Martincourt,142,135,7
32,60,216003855,60389,Maucourt,246,244,2
32,60,216003863,60390,Maulers,336,329,7
32,60,216003871,60391,Maysel,223,220,3
32,60,216003889,60392,Mélicocq,808,792,16
32,60,216003897,60393,Mello,614,601,13
32,60,216003905,60394,Ménévillers,105,104,1
32,60,216003913,60395,Méru,14546,14354,192
32,60,216003921,60396,Méry-la-Bataille,633,628,5
32,60,216003939,60397,Le Mesnil-Conteville,75,74,1
32,60,216003947,60398,Le Mesnil-en-Thelle,2294,2267,27
32,60,216003954,60399,Le Mesnil-Saint-Firmin,254,251,3
32,60,216003962,60400,Le Mesnil-sur-Bulles,276,269,7
32,60,216003970,60401,Le Mesnil-Théribus,805,785,20
32,60,216003988,60402,Le Meux,2386,2331,55
32,60,216003996,60403,Milly-sur-Thérain,1871,1836,35
32,60,216004002,60404,Mogneville,1503,1467,36
32,60,216004010,60405,Moliens,1161,1144,17
32,60,216004028,60406,Monceaux,889,869,20
32,60,216004036,60407,Monceaux-l'Abbaye,217,215,2
32,60,216004044,60408,Monchy-Humières,800,784,16
32,60,216004051,60409,Monchy-Saint-Éloi,2204,2164,40
32,60,216004069,60410,Mondescourt,257,249,8
32,60,216004077,60411,Monneville,796,773,23
32,60,216004085,60412,Montagny-en-Vexin,694,683,11
32,60,216004093,60413,Montagny-Sainte-Félicité,429,420,9
32,60,216004101,60414,Montataire,13834,13683,151
32,60,216004119,60415,Montépilloy,145,136,9
32,60,216004127,60416,Montgérain,172,170,2
32,60,216004143,60418,Montiers,419,406,13
32,60,216004150,60420,Montjavoult,504,495,9
32,60,216004168,60421,Mont-l'Évêque,403,397,6
32,60,216004176,60422,Montlognon,211,200,11
32,60,216004184,60423,Montmacq,1177,1151,26
32,60,216004192,60424,Montmartin,276,272,4
32,60,216004200,60425,Montreuil-sur-Brêche,496,483,13
32,60,216004218,60426,Montreuil-sur-Thérain,249,248,1
32,60,216004226,60427,Monts,185,184,1
32,60,216004234,60428,Le Mont-Saint-Adrien,669,642,27
32,60,216004242,60429,Morangles,424,408,16
32,60,216004259,60430,Morienval,1109,1096,13
32,60,216004267,60431,Morlincourt,549,538,11
32,60,216004275,60432,Mortefontaine,904,875,29
32,60,216004283,60433,Mortefontaine-en-Thelle,1028,1008,20
32,60,216004291,60434,Mortemer,229,223,6
32,60,216004309,60435,Morvillers,500,491,9
32,60,216004317,60436,Mory-Montcrux,74,72,2
32,60,216004325,60437,Mouchy-le-Châtel,82,82,0
32,60,216004333,60438,Moulin-sous-Touvent,201,196,5
32,60,216004341,60439,Mouy,5329,5270,59
32,60,216004358,60440,Moyenneville,615,599,16
32,60,216004366,60441,Moyvillers,712,705,7
32,60,216004374,60442,Muidorge,149,143,6
32,60,216004382,60443,Muirancourt,592,588,4
32,60,216004390,60444,Mureaumont,155,153,2
32,60,216004408,60445,Nampcel,312,310,2
32,60,216004416,60446,Nanteuil-le-Haudouin,4216,4153,63
32,60,216004424,60447,Néry,665,651,14
32,60,216004432,60448,Neufchelles,394,388,6
32,60,216004440,60449,Neufvy-sur-Aronde,285,279,6
32,60,216004457,60450,Neuilly-en-Thelle,4064,4023,41
32,60,216004465,60451,Neuilly-sous-Clermont,1659,1632,27
32,60,216004473,60452,Neuville-Bosc,498,484,14
32,60,216004499,60454,La Neuville-en-Hez,987,956,31
32,60,216004515,60456,La Neuville-Roy,943,915,28
32,60,216004523,60457,La Neuville-Saint-Pierre,165,163,2
32,60,216004531,60458,La Neuville-sur-Oudeuil,327,312,15
32,60,216004549,60459,La Neuville-sur-Ressons,206,203,3
32,60,216004556,60460,La Neuville-Vault,208,200,8
32,60,216004564,60461,Nivillers,212,199,13
32,60,216004572,60462,Noailles,2867,2819,48
32,60,216004580,60463,Nogent-sur-Oise,21933,21589,344
32,60,216004598,60464,Nointel,1137,1122,15
32,60,216004606,60465,Noirémont,189,183,6
32,60,216004614,60466,Noroy,260,257,3
32,60,216004622,60468,Nourard-le-Franc,309,305,4
32,60,216004630,60469,Novillers,367,358,9
32,60,216004648,60470,Noyers-Saint-Martin,917,903,14
32,60,216004655,60471,Noyon,13409,13197,212
32,60,216004663,60472,Offoy,119,118,1
32,60,216004671,60473,Ognes,294,293,1
32,60,216004689,60474,Ognolles,292,286,6
32,60,216004705,60476,Omécourt,207,200,7
32,60,216004713,60477,Ons-en-Bray,1421,1399,22
32,60,216004721,60478,Ormoy-le-Davien,372,363,9
32,60,216004739,60479,Ormoy-Villers,697,687,10
32,60,216004747,60480,Oroër,566,549,17
32,60,216004754,60481,Orrouy,630,617,13
32,60,216004762,60482,Orry-la-Ville,3473,3385,88
32,60,216004770,60483,Orvillers-Sorel,580,535,45
32,60,216004788,60484,Oudeuil,290,284,6
32,60,216004796,60485,Oursel-Maison,245,240,5
32,60,216004804,60486,Paillart,581,571,10
32,60,216004812,60487,Parnes,342,327,15
32,60,216004820,60488,Passel,278,272,6
32,60,216004838,60489,Péroy-les-Gombries,1208,1189,19
32,60,216004846,60490,Pierrefitte-en-Beauvaisis,383,369,14
32,60,216004853,60491,Pierrefonds,2027,1877,150
32,60,216004861,60492,Pimprez,875,856,19
32,60,216004879,60493,Pisseleu,519,509,10
32,60,216004887,60494,Plailly,1889,1852,37
32,60,216004895,60495,Plainval,415,410,5
32,60,216004903,60496,Plainville,165,164,1
32,60,216004911,60497,Le Plessier-sur-Bulles,213,212,1
32,60,216004929,60498,Le Plessier-sur-Saint-Just,535,532,3
32,60,216004937,60499,Plessis-de-Roye,236,231,5
32,60,216004945,60500,Le Plessis-Belleville,3886,3832,54
32,60,216004952,60501,Le Plessis-Brion,1363,1332,31
32,60,216004960,60502,Le Plessis-Patte-d'Oie,99,95,4
32,60,216004978,60503,Le Ployron,115,112,3
32,60,216004986,60504,Ponchon,1142,1127,15
32,60,216004994,60505,Pontarmé,894,872,22
32,60,216005009,60506,Pont-l'Évêque,691,679,12
32,60,216005017,60507,Pontoise-lès-Noyon,464,453,11
32,60,216005025,60508,Pontpoint,3309,3235,74
32,60,216005033,60509,Pont-Sainte-Maxence,12637,12512,125
32,60,216005041,60510,Porcheux,679,663,16
32,60,216005058,60511,Porquéricourt,412,401,11
32,60,216005066,60512,Pouilly,160,158,2
32,60,216005074,60513,Précy-sur-Oise,3298,3227,71
32,60,216005082,60514,Prévillers,248,247,1
32,60,216005090,60515,Pronleroy,387,374,13
32,60,216005108,60516,Puiseux-en-Bray,415,407,8
32,60,216005116,60517,Puiseux-le-Hauberger,857,845,12
32,60,216005124,60518,Puits-la-Vallée,209,205,4
32,60,216005132,60519,Quesmy,179,174,5
32,60,216005140,60520,Le Quesnel-Aubry,232,225,7
32,60,216005157,60521,Quincampoix-Fleuzy,417,400,17
32,60,216005165,60522,Quinquempoix,315,312,3
32,60,216005173,60523,Rainvillers,922,907,15
32,60,216005181,60524,Rantigny,2569,2540,29
32,60,216005199,60525,Raray,129,124,5
32,60,216005207,60526,Ravenel,1077,1064,13
32,60,216005215,60527,Réez-Fosse-Martin,143,143,0
32,60,216005231,60528,Reilly,129,125,4
32,60,216005223,60529,Rémécourt,78,76,2
32,60,216005249,60530,Rémérangles,224,215,9
32,60,216005256,60531,Remy,1999,1960,39
32,60,216005272,60533,Ressons-sur-Matz,1736,1707,29
32,60,216005280,60534,Rethondes,656,636,20
32,60,216005298,60535,Reuil-sur-Brêche,335,329,6
32,60,216005306,60536,Rhuis,142,134,8
32,60,216005314,60537,Ribécourt-Dreslincourt,3857,3683,174
32,60,216005322,60538,Ricquebourg,303,298,5
32,60,216005330,60539,Rieux,1563,1542,21
32,60,216005348,60540,Rivecourt,642,627,15
32,60,216005355,60541,Roberval,366,354,12
32,60,216005363,60542,Rochy-Condé,1012,995,17
32,60,216005371,60543,Rocquemont,119,118,1
32,60,216005389,60544,Rocquencourt,196,195,1
32,60,216005397,60545,Romescamps,538,529,9
32,60,216005405,60546,Rosières,143,139,4
32,60,216005413,60547,Rosoy,641,624,17
32,60,216005421,60548,Rosoy-en-Multien,610,603,7
32,60,216005439,60549,Rotangy,229,223,6
32,60,216005447,60550,Rothois,224,224,0
32,60,216005454,60551,Rousseloy,299,292,7
32,60,216005462,60552,Rouville,252,243,9
32,60,216005470,60553,Rouvillers,279,272,7
32,60,216005488,60554,Rouvres-en-Multien,484,475,9
32,60,216005496,60555,Rouvroy-les-Merles,60,59,1
32,60,216005504,60556,Royaucourt,205,202,3
32,60,216005512,60557,Roy-Boissy,323,315,8
32,60,216005520,60558,Roye-sur-Matz,477,458,19
32,60,216005538,60559,La Rue-Saint-Pierre,843,834,9
32,60,216005546,60560,Rully,763,730,33
32,60,216005553,60561,Russy-Bémont,215,209,6
32,60,216005561,60562,Sacy-le-Grand,1614,1589,25
32,60,216005579,60563,Sacy-le-Petit,624,617,7
32,60,216005587,60564,Sains-Morainvillers,284,281,3
32,60,216005595,60565,Saint-André-Farivillers,520,516,4
32,60,216005603,60566,Saint-Arnoult,202,199,3
32,60,216005611,60567,Saint-Aubin-en-Bray,1203,1175,28
32,60,216005629,60568,Saint-Aubin-sous-Erquery,340,332,8
32,60,216005637,60569,Saint-Crépin-aux-Bois,189,180,9
32,60,200049377,60570,Saint-Crépin-Ibouvillers,1601,1578,23
32,60,216005652,60571,Saint-Deniscourt,84,82,2
32,60,216005660,60572,Saint-Étienne-Roilaye,299,290,9
32,60,216005678,60573,Sainte-Eusoye,337,335,2
32,60,216005686,60574,Saint-Félix,634,620,14
32,60,216005694,60575,Sainte-Geneviève,3423,3380,43
32,60,216005702,60576,Saint-Germain-la-Poterie,498,484,14
32,60,216005710,60577,Saint-Germer-de-Fly,1740,1706,34
32,60,216005728,60578,Saintines,1091,1074,17
32,60,216005736,60579,Saint-Jean-aux-Bois,336,330,6
32,60,216005744,60581,Saint-Just-en-Chaussée,6105,6056,49
32,60,216005751,60582,Saint-Léger-aux-Bois,779,759,20
32,60,216005769,60583,Saint-Léger-en-Bray,374,365,9
32,60,216005777,60584,Saint-Leu-d'Esserent,4747,4637,110
32,60,216005785,60585,Saint-Martin-aux-Bois,290,285,5
32,60,216005793,60586,Saint-Martin-le-Noeud,1047,1025,22
32,60,216005801,60587,Saint-Martin-Longueau,1479,1450,29
32,60,216005819,60588,Saint-Maur,376,370,6
32,60,216005827,60589,Saint-Maximin,3021,2907,114
32,60,216005835,60590,Saint-Omer-en-Chaussée,1269,1245,24
32,60,216005843,60591,Saint-Paul,1636,1571,65
32,60,216005850,60592,Saint-Pierre-es-Champs,717,698,19
32,60,216005868,60593,Saint-Pierre-lès-Bitry,137,135,2
32,60,216005876,60594,Saint-Quentin-des-Prés,283,277,6
32,60,216005884,60595,Saint-Remy-en-l'Eau,441,438,3
32,60,216005892,60596,Saint-Samson-la-Poterie,246,244,2
32,60,216005900,60597,Saint-Sauveur,1768,1735,33
32,60,216005918,60598,Saint-Sulpice,1132,1047,85
32,60,216005926,60599,Saint-Thibault,294,289,5
32,60,216005934,60600,Saint-Vaast-de-Longmont,640,633,7
32,60,216005942,60601,Saint-Vaast-lès-Mello,1051,1037,14
32,60,216005959,60602,Saint-Valery,62,56,6
32,60,216005967,60603,Salency,921,898,23
32,60,216005975,60604,Sarcus,269,267,2
32,60,216005983,60605,Sarnois,354,349,5
32,60,216005991,60608,Le Saulchoy,107,106,1
32,60,216006007,60609,Savignies,933,908,25
32,60,216006015,60610,Sempigny,778,766,12
32,60,216006023,60611,Senantes,603,589,14
32,60,216006031,60612,Senlis,15709,15128,581
32,60,216006049,60613,Senots,351,344,7
32,60,216006056,60614,Serans,203,197,6
32,60,216006064,60615,Sérévillers,134,133,1
32,60,216006072,60616,Sérifontaine,2788,2759,29
32,60,216006080,60617,Sermaize,276,273,3
32,60,216006098,60618,Séry-Magneval,284,279,5
32,60,216006106,60619,Silly-le-Long,1212,1185,27
32,60,216006114,60620,Silly-Tillard,464,455,9
32,60,216006122,60621,Solente,138,138,0
32,60,216006130,60622,Sommereux,487,482,5
32,60,216006148,60623,Songeons,1032,950,82
32,60,216006155,60624,Sully,174,171,3
32,60,216006163,60625,Suzoy,587,574,13
32,60,216006171,60626,Talmontiers,679,662,17
32,60,216006189,60627,Tartigny,259,256,3
32,60,216006197,60628,Therdonne,1090,1067,23
32,60,216006205,60629,Thérines,204,195,9
32,60,216006213,60630,Thibivillers,199,196,3
32,60,216006221,60631,Thiers-sur-Thève,1103,1080,23
32,60,216006239,60632,Thiescourt,770,754,16
32,60,216006247,60633,Thieuloy-Saint-Antoine,406,406,0
32,60,216006254,60634,Thieux,447,438,9
32,60,216006262,60635,Thiverny,1088,1078,10
32,60,216006270,60636,Thourotte,4530,4455,75
32,60,216006288,60637,Thury-en-Valois,508,497,11
32,60,216006296,60638,Thury-sous-Clermont,684,675,9
32,60,216006304,60639,Tillé,1277,1251,26
32,60,216006312,60640,Tourly,173,172,1
32,60,216006320,60641,Tracy-le-Mont,1767,1720,47
32,60,216006338,60642,Tracy-le-Val,1095,1063,32
32,60,216006346,60643,Tricot,1383,1369,14
32,60,200076842,60644,Trie-Château,1947,1914,33
32,60,216006361,60645,Trie-la-Ville,312,306,6
32,60,216006379,60646,Troissereux,1382,1347,35
32,60,216006387,60647,Trosly-Breuil,2105,2050,55
32,60,216006395,60648,Troussencourt,324,321,3
32,60,216006411,60650,Trumilly,554,529,25
32,60,216006429,60651,Ully-Saint-Georges,1926,1895,31
32,60,216006437,60652,Valdampierre,923,913,10
32,60,216006445,60653,Valescourt,306,300,6
32,60,216006452,60654,Vandélicourt,268,263,5
32,60,216006460,60655,Varesnes,374,364,10
32,60,216006478,60656,Varinfroy,282,280,2
32,60,216006486,60657,Vauchelles,251,246,5
32,60,216006494,60658,Vauciennes,703,694,9
32,60,216006502,60659,Vaudancourt,173,171,2
32,60,216006510,60660,Le Vaumain,416,405,11
32,60,216006528,60661,Vaumoise,1060,986,74
32,60,216006536,60662,Le Vauroux,518,505,13
32,60,216006544,60663,Velennes,263,260,3
32,60,216006551,60664,Vendeuil-Caply,457,446,11
32,60,216006569,60665,Venette,2898,2840,58
32,60,216006577,60666,Ver-sur-Launette,1167,1141,26
32,60,216006585,60667,Verberie,3842,3788,54
32,60,216006593,60668,Verderel-lès-Sauqueuse,750,733,17
32,60,216006601,60669,Verderonne,502,490,12
32,60,216006619,60670,Verneuil-en-Halatte,4853,4738,115
32,60,216006627,60671,Versigny,369,350,19
32,60,216006635,60672,Vez,283,270,13
32,60,216006643,60673,Viefvillers,214,213,1
32,60,216006650,60674,Vieux-Moulin,631,600,31
32,60,216006668,60675,Vignemont,434,429,5
32,60,216006676,60676,Ville,772,755,17
32,60,216006684,60677,Villembray,263,253,10
32,60,216006692,60678,Villeneuve-les-Sablons,1177,1153,24
32,60,216006700,60679,La Villeneuve-sous-Thury,157,151,6
32,60,216006718,60680,Villeneuve-sur-Verberie,701,682,19
32,60,216006726,60681,Villers-Saint-Barthélemy,480,463,17
32,60,200083442,60682,Villers-Saint-Frambourg-Ognon,732,714,18
32,60,216006742,60683,Villers-Saint-Genest,406,390,16
32,60,216006759,60684,Villers-Saint-Paul,6507,6442,65
32,60,216006767,60685,Villers-Saint-Sépulcre,1038,1028,10
32,60,216006775,60686,Villers-sous-Saint-Leu,2364,2307,57
32,60,216006783,60687,Villers-sur-Auchy,382,372,10
32,60,216006791,60688,Villers-sur-Bonnières,160,159,1
32,60,216006809,60689,Villers-sur-Coudun,1448,1400,48
32,60,216006825,60691,Villers-Vermont,115,115,0
32,60,216006833,60692,Villers-Vicomte,145,143,2
32,60,216006841,60693,Villeselve,415,412,3
32,60,216006866,60695,Vineuil-Saint-Firmin,1446,1397,49
32,60,216006874,60697,Vrocourt,35,34,1
32,60,216006882,60698,Wacquemoulin,285,276,9
32,60,216006890,60699,Wambez,170,165,5
32,60,216006908,60700,Warluis,1222,1200,22
32,60,216006916,60701,Wavignies,1333,1325,8
32,60,216006924,60702,Welles-Pérennes,250,247,3
32,60,216006932,60703,Aux Marais,910,891,19
28,61,216100016,61001,Alençon,26464,25744,720
28,61,216100024,61002,Almenêches,657,647,10
28,61,216100057,61005,Appenai-sous-Bellême,288,280,8
28,61,216100065,61006,Argentan,13765,13401,364
28,61,200058642,61007,Athis-Val de Rouvre,4307,4224,83
28,61,216100081,61008,Aube,1304,1258,46
28,61,216100107,61010,Aubry-le-Panthou,129,123,6
28,61,216100115,61011,Aubusson,422,408,14
28,61,216100123,61012,Auguaise,212,210,2
28,61,216100131,61013,Aunay-les-Bois,138,138,0
28,61,216100149,61014,Aunou-le-Faucon,257,248,9
28,61,216100156,61015,Aunou-sur-Orne,266,261,5
28,61,216100172,61017,Les Authieux-du-Puits,82,82,0
28,61,216100180,61018,Avernes-Saint-Gourgon,66,65,1
28,61,216100206,61020,Avoine,221,214,7
28,61,216100214,61021,Avrilly,104,100,4
28,61,216100230,61023,Bailleul,634,612,22
28,61,216100248,61024,Banvou,626,610,16
28,61,216100263,61026,Barville,189,181,8
28,61,216100289,61028,Bazoches-au-Houlme,467,456,11
28,61,216100297,61029,Bazoches-sur-Hoëne,861,838,23
28,61,216100305,61030,La Bazoque,278,272,6
28,61,216100321,61032,Beaufai,337,329,8
28,61,216100347,61034,Beaulieu,206,199,7
28,61,216100354,61035,Beauvain,275,272,3
28,61,216100362,61036,Belfonds,204,204,0
28,61,216100370,61037,Bellavilliers,133,130,3
28,61,216100388,61038,Bellême,1475,1455,20
28,61,216100396,61039,La Bellière,132,131,1
28,61,216100404,61040,Bellou-en-Houlme,1083,1053,30
28,61,216100412,61041,Bellou-le-Trichard,209,205,4
28,61,216100438,61043,Berd'huis,1109,1088,21
28,61,216100446,61044,Berjou,461,446,15
28,61,216100461,61046,Bizou,134,134,0
28,61,216100487,61048,Boëcé,128,124,4
28,61,216100495,61049,Boissei-la-Lande,122,121,1
28,61,200059236,61050,Cour-Maugis sur Huisne,609,588,21
28,61,216100511,61051,Boitron,363,358,5
28,61,216100529,61052,Bonnefoi,194,190,4
28,61,216100537,61053,Bonsmoulins,240,233,7
28,61,216100545,61054,Le Bosc-Renoult,258,254,4
28,61,216100552,61055,Boucé,606,598,8
28,61,216100560,61056,Le Bouillon,168,167,1
28,61,216100602,61060,Brethel,161,156,5
28,61,216100610,61061,Bretoncelles,1505,1475,30
28,61,216100628,61062,Brieux,93,92,1
28,61,216100636,61063,Briouze,1548,1510,38
28,61,216100644,61064,Brullemail,94,93,1
28,61,216100669,61066,Buré,111,105,6
28,61,216100677,61067,Bures,164,163,1
28,61,216100685,61068,Bursard,204,203,1
28,61,216100693,61069,Cahan,171,164,7
28,61,216100701,61070,Caligny,848,825,23
28,61,216100719,61071,Camembert,177,170,7
28,61,216100727,61072,Canapville,205,201,4
28,61,216100743,61074,Carrouges,639,630,9
28,61,216100750,61075,Ceaucé,1187,1161,26
28,61,216100768,61076,Le Cercueil,143,138,5
28,61,216100776,61077,Cerisé,893,876,17
28,61,216100784,61078,Cerisy-Belle-Étoile,761,713,48
28,61,216100792,61079,Ceton,1792,1768,24
28,61,216100800,61080,Chahains,86,84,2
28,61,200059178,61081,Chailloué,918,894,24
28,61,216100826,61082,Le Chalange,91,86,5
28,61,216100842,61084,Champcerie,179,175,4
28,61,216100859,61085,Le Champ-de-la-Pierre,31,31,0
28,61,216100867,61086,Les Champeaux,102,102,0
28,61,216100875,61087,Champeaux-sur-Sarthe,164,160,4
28,61,216100883,61088,Champ-Haut,45,44,1
28,61,216100891,61089,Champosoult,96,96,0
28,61,216100917,61091,Champsecret,945,915,30
28,61,216100925,61092,Chandai,691,685,6
28,61,216100933,61093,Chanu,1276,1259,17
28,61,216100941,61094,La Chapelle-au-Moine,607,590,17
28,61,216100958,61095,La Chapelle-Biche,540,532,8
28,61,200058667,61096,Rives d'Andaine,3074,2982,92
28,61,216100974,61097,La Chapelle-Montligeon,529,515,14
28,61,216100982,61098,La Chapelle-près-Sées,493,461,32
28,61,216100990,61099,La Chapelle-Souëf,253,245,8
28,61,216101006,61100,La Chapelle-Viel,304,287,17
28,61,216101014,61101,Le Château-d'Almenêches,200,196,4
28,61,216101022,61102,Le Châtellier,413,404,9
28,61,216101030,61103,Chaumont,173,172,1
28,61,216101048,61104,La Chaux,53,52,1
28,61,216101055,61105,Chemilli,186,179,7
28,61,216101071,61107,Ciral,408,397,11
28,61,216101089,61108,Cisai-Saint-Aubin,179,175,4
28,61,216101113,61111,Colombiers,336,331,5
28,61,216101139,61113,Comblot,65,64,1
28,61,216101147,61114,Commeaux,159,154,5
28,61,200053965,61116,Sablons sur Huisne,2046,2005,41
28,61,216101170,61117,Condé-sur-Sarthe,2542,2494,48
28,61,216101188,61118,Corbon,121,116,5
28,61,216101204,61120,Coudehard,77,76,1
28,61,216101212,61121,Coulimer,306,297,9
28,61,216101220,61122,Coulmer,88,82,6
28,61,216101238,61123,Coulonces,224,219,5
28,61,216101246,61124,La Coulonche,508,503,5
28,61,216101261,61126,Coulonges-sur-Sarthe,499,489,10
28,61,216101295,61129,Courgeon,369,361,8
28,61,216101303,61130,Courgeoût,472,461,11
28,61,216101337,61133,Courtomer,725,708,17
28,61,216101378,61137,Craménil,135,131,4
28,61,216101386,61138,Croisilles,214,210,4
28,61,216101394,61139,Crouttes,312,301,11
28,61,216101402,61140,Crulai,853,832,21
28,61,216101410,61141,Cuissai,433,419,14
28,61,216101428,61142,Dame-Marie,139,135,4
28,61,216101436,61143,Damigny,2499,2436,63
28,61,200059194,61145,Domfront en Poiraie,4297,4180,117
28,61,216101469,61146,Dompierre,399,394,5
28,61,216101485,61148,Durcet,301,292,9
28,61,216101493,61149,Échalou,383,371,12
28,61,216101501,61150,Échauffour,753,740,13
28,61,216101519,61151,Écorcei,406,395,11
28,61,216101527,61152,Écorches,100,100,0
28,61,200077683,61153,Écouché-les-Vallées,2251,2200,51
28,61,216101568,61156,Essay,552,538,14
28,61,216101584,61158,Faverolles,146,143,3
28,61,216101592,61159,Fay,70,69,1
28,61,216101600,61160,Feings,188,184,4
28,61,216101626,61162,La Ferrière-au-Doyen,157,155,2
28,61,216101634,61163,La Ferrière-aux-Étangs,1573,1552,21
28,61,216101642,61164,La Ferrière-Béchet,244,242,2
28,61,216101659,61165,La Ferrière-Bochard,752,733,19
28,61,216101667,61166,Ferrières-la-Verrerie,142,139,3
28,61,200054997,61167,La Ferté-en-Ouche,3092,3029,63
28,61,200060960,61168,La Ferté Macé,5489,5138,351
28,61,216101691,61169,Flers,14928,14589,339
28,61,216101709,61170,Fleuré,207,199,8
28,61,216101717,61171,Fontaine-les-Bassets,109,107,2
28,61,216101766,61176,Francheville,141,139,2
28,61,216101782,61178,La Fresnaie-Fayel,54,53,1
28,61,216101808,61180,Fresnay-le-Samson,93,92,1
28,61,216101816,61181,Gacé,1855,1796,59
28,61,216101824,61182,Gandelain,426,421,5
28,61,216101832,61183,Gâprée,147,145,2
28,61,216101873,61187,Les Genettes,185,183,2
28,61,216101881,61188,La Genevraie,95,90,5
28,61,216101899,61189,Giel-Courteilles,675,468,207
28,61,216101907,61190,Ginai,74,73,1
28,61,216101923,61192,Godisson,109,105,4
28,61,216101931,61193,La Gonfrière,281,278,3
28,61,200077485,61194,Monts-sur-Orne,887,873,14
28,61,216101956,61195,Le Grais,198,197,1
28,61,200064079,61196,Belforêt-en-Perche,1559,1508,51
28,61,216101972,61197,Guêprei,137,133,4
28,61,216101980,61198,Guerquesalles,134,134,0
28,61,216101998,61199,Habloville,339,331,8
28,61,216102020,61202,Hauterive,473,462,11
28,61,216102038,61203,Héloup,922,897,25
28,61,216102061,61206,L'Hôme-Chamondot,254,252,2
28,61,216102079,61207,Igé,619,597,22
28,61,216102087,61208,Irai,636,621,15
28,61,216102095,61209,Joué-du-Bois,417,409,8
28,61,216102103,61210,Joué-du-Plain,255,246,9
28,61,200060069,61211,Juvigny Val d'Andaine,2177,2124,53
28,61,216102129,61212,Juvigny-sur-Orne,134,130,4
28,61,216102137,61213,Lalacelle,280,270,10
28,61,216102145,61214,L'Aigle,8144,7903,241
28,61,216102152,61215,Laleu,359,353,6
28,61,216102160,61216,La Lande-de-Goult,194,191,3
28,61,216102178,61217,La Lande-de-Lougé,55,54,1
28,61,216102186,61218,La Lande-Patry,1833,1784,49
28,61,216102194,61219,La Lande-Saint-Siméon,160,159,1
28,61,216102210,61221,Landigou,456,448,8
28,61,216102228,61222,Landisacq,784,765,19
28,61,216102244,61224,Larré,463,457,6
28,61,216102251,61225,Lignères,29,29,0
28,61,216102277,61227,Lignou,149,146,3
28,61,200081669,61228,L'Orée-d'Écouves,789,773,16
28,61,216102293,61229,Loisail,131,129,2
28,61,200058980,61230,Longny les Villages,2978,2930,48
28,61,216102327,61232,Lonlay-l'Abbaye,1156,1117,39
28,61,216102335,61233,Lonlay-le-Tesson,236,231,5
28,61,216102343,61234,Lonrai,1163,1127,36
28,61,216102376,61237,Lougé-sur-Maire,316,316,0
28,61,216102384,61238,Louvières-en-Auge,92,91,1
28,61,216102400,61240,Macé,403,393,10
28,61,216102418,61241,La Madeleine-Bouvet,421,410,11
28,61,216102426,61242,Le Mage,227,219,8
28,61,216102434,61243,Magny-le-Désert,1417,1377,40
28,61,216102442,61244,Mahéru,281,269,12
28,61,216102483,61248,Mantilly,523,513,10
28,61,216102517,61251,Marchemaisons,160,154,6
28,61,216102525,61252,Mardilly,140,136,4
28,61,216102558,61255,Mauves-sur-Huisne,543,529,14
28,61,216102566,61256,Médavy,157,152,5
28,61,216102574,61257,Méhoudin,121,121,0
28,61,216102582,61258,Le Mêle-sur-Sarthe,672,659,13
28,61,216102590,61259,Le Ménil-Bérard,71,71,0
28,61,216102608,61260,Le Ménil-de-Briouze,545,535,10
28,61,216102616,61261,Le Ménil-Broût,173,170,3
28,61,216102624,61262,Le Ménil-Ciboult,112,111,1
28,61,216102632,61263,Ménil-Erreux,208,202,6
28,61,216102640,61264,Ménil-Froger,58,57,1
28,61,216102657,61265,Ménil-Gondouin,165,162,3
28,61,216102665,61266,Le Ménil-Guyon,80,78,2
28,61,216102673,61267,Ménil-Hermei,206,203,3
28,61,216102681,61268,Ménil-Hubert-en-Exmes,114,109,5
28,61,216102699,61269,Ménil-Hubert-sur-Orne,490,482,8
28,61,216102715,61271,Le Ménil-Scelleur,84,84,0
28,61,216102723,61272,Le Ménil-Vicomte,23,23,0
28,61,216102731,61273,Ménil-Vin,54,51,3
28,61,216102749,61274,Les Menus,244,239,5
28,61,216102756,61275,Le Merlerault,770,753,17
28,61,216102764,61276,Merri,159,153,6
28,61,216102772,61277,La Mesnière,290,279,11
28,61,216102780,61278,Messei,1900,1846,54
28,61,216102798,61279,Mieuxcé,626,610,16
28,61,216102814,61281,Moncy,264,259,5
28,61,216102830,61283,Montabard,293,284,9
28,61,216102848,61284,Montchevrel,223,221,2
28,61,216102863,61286,Montgaudry,79,79,0
28,61,216102871,61287,Montilly-sur-Noireau,742,724,18
28,61,216102889,61288,Montmerrei,537,531,6
28,61,216102897,61289,Mont-Ormel,50,49,1
28,61,216102905,61290,Montreuil-au-Houlme,132,129,3
28,61,216102913,61291,Montreuil-la-Cambe,71,69,2
28,61,200049781,61292,Montsecret-Clairefougère,659,650,9
28,61,216102939,61293,Mortagne-au-Perche,4055,3758,297
28,61,200082923,61294,Mortrée,1167,1144,23
28,61,216102954,61295,La Motte-Fouquet,165,163,2
28,61,216102970,61297,Moulins-la-Marche,742,731,11
28,61,216102988,61298,Moulins-sur-Orne,327,316,11
28,61,216103002,61300,Moutiers-au-Perche,385,378,7
28,61,216103010,61301,Neauphe-sous-Essai,213,212,1
28,61,216103028,61302,Neauphe-sur-Dive,139,136,3
28,61,216103036,61303,Nécy,532,519,13
28,61,216103044,61304,Neuilly-le-Bisson,302,293,9
28,61,216103077,61307,Neuville-sur-Touques,232,230,2
28,61,216103085,61308,Neuvy-au-Houlme,208,204,4
28,61,200053866,61309,Perche en Nocé,2073,2010,63
28,61,216103101,61310,Nonant-le-Pin,448,421,27
28,61,216103143,61314,Occagnes,693,676,17
28,61,216103168,61316,Ommoy,116,113,3
28,61,216103176,61317,Orgères,187,182,5
28,61,216103192,61319,Origny-le-Roux,265,258,7
28,61,216103218,61321,Pacé,426,419,7
28,61,216103226,61322,Parfondeval,111,108,3
28,61,216103234,61323,Le Pas-Saint-l'Homer,127,125,2
28,61,200060028,61324,Passais Villages,1179,1163,16
28,61,216103267,61326,Perrou,354,349,5
28,61,216103275,61327,Pervenchères,350,339,11
28,61,216103283,61328,Le Pin-au-Haras,271,266,5
28,61,216103291,61329,Le Pin-la-Garenne,642,632,10
28,61,216103309,61330,Planches,186,183,3
28,61,216103317,61331,Le Plantis,134,132,2
28,61,216103325,61332,Pointel,340,311,29
28,61,216103333,61333,Pontchardon,170,167,3
28,61,216103366,61336,Pouvrai,109,102,7
28,61,200056752,61339,Putanges-le-Lac,2172,2140,32
28,61,200053700,61341,Écouves,1699,1656,43
28,61,216103424,61342,Rai,1437,1416,21
28,61,216103440,61344,Rânes,1044,1033,11
28,61,200054070,61345,Rémalard en Perche,1940,1898,42
28,61,216103465,61346,Le Renouard,210,204,6
28,61,216103473,61347,Résenlieu,178,178,0
28,61,216103481,61348,Réveillon,377,370,7
28,61,216103499,61349,Ri,161,158,3
28,61,216103507,61350,La Roche-Mabile,169,161,8
28,61,216103515,61351,Roiville,138,134,4
28,61,216103523,61352,Rônai,182,177,5
28,61,216103572,61357,Rouperroux,197,191,6
28,61,216103580,61358,Sai,231,226,5
28,61,216103606,61360,Saint-Agnan-sur-Sarthe,92,90,2
28,61,216103614,61361,Saint-André-de-Briouze,175,170,5
28,61,216103622,61362,Saint-André-de-Messei,547,529,18
28,61,216103630,61363,Saint-Aquilin-de-Corbion,58,57,1
28,61,216103655,61365,Saint-Aubin-d'Appenai,415,407,8
28,61,216103663,61366,Saint-Aubin-de-Bonneval,134,132,2
28,61,216103671,61367,Saint-Aubin-de-Courteraie,133,131,2
28,61,216103697,61369,Saint-Bômer-les-Forges,1062,1027,35
28,61,216103705,61370,Saint-Brice,151,149,2
28,61,216103713,61371,Saint-Brice-sous-Rânes,136,134,2
28,61,216103721,61372,Saint-Céneri-le-Gérei,116,112,4
28,61,216103739,61373,Sainte-Céronne-lès-Mortagne,254,246,8
28,61,216103747,61374,Saint-Christophe-de-Chaulieu,100,96,4
28,61,200049757,61375,Boischampré,1226,1189,37
28,61,216103762,61376,Saint-Clair-de-Halouze,867,849,18
28,61,216103796,61379,Saint-Cyr-la-Rosière,239,234,5
28,61,216103812,61381,Saint-Denis-sur-Huisne,63,59,4
28,61,216103820,61382,Saint-Denis-sur-Sarthon,1144,1125,19
28,61,216103846,61384,Saint-Ellier-les-Bois,260,258,2
28,61,216103853,61385,Saint-Evroult-de-Montfort,345,336,9
28,61,216103861,61386,Saint-Evroult-Notre-Dame-du-Bois,472,441,31
28,61,216103879,61387,Saint-Fraimbault,555,537,18
28,61,216103887,61388,Saint-Fulgent-des-Ormes,170,163,7
28,61,216103895,61389,Sainte-Gauburge-Sainte-Colombe,1045,1022,23
28,61,216103903,61390,Saint-Georges-d'Annebecq,161,161,0
28,61,216103911,61391,Saint-Georges-des-Groseillers,3276,3164,112
28,61,216103929,61392,Saint-Germain-d'Aunay,134,133,1
28,61,216103937,61393,Saint-Germain-de-Clairefeuille,139,134,5
28,61,216103945,61394,Saint-Germain-de-la-Coudre,837,816,21
28,61,216103952,61395,Saint-Germain-des-Grois,231,227,4
28,61,216103960,61396,Saint-Germain-de-Martigny,86,81,5
28,61,216103978,61397,Saint-Germain-du-Corbéis,3836,3738,98
28,61,216103986,61398,Saint-Germain-le-Vieux,61,60,1
28,61,216103994,61399,Saint-Gervais-des-Sablons,76,73,3
28,61,216104000,61400,Saint-Gervais-du-Perron,361,357,4
28,61,216104018,61401,Saint-Gilles-des-Marais,108,104,4
28,61,216104026,61402,Saint-Hilaire-de-Briouze,316,308,8
28,61,216104042,61404,Saint-Hilaire-le-Châtel,666,654,12
28,61,216104059,61405,Saint-Hilaire-sur-Erre,533,516,17
28,61,216104067,61406,Saint-Hilaire-sur-Risle,311,307,4
28,61,216104075,61407,Sainte-Honorine-la-Chardonne,705,692,13
28,61,216104083,61408,Sainte-Honorine-la-Guillaume,343,336,7
28,61,216104117,61411,Saint-Jouin-de-Blavou,296,289,7
28,61,216104125,61412,Saint-Julien-sur-Sarthe,708,694,14
28,61,216104133,61413,Saint-Lambert-sur-Dive,140,136,4
28,61,216104141,61414,Saint-Langis-lès-Mortagne,901,878,23
28,61,216104158,61415,Saint-Léger-sur-Sarthe,320,314,6
28,61,216104166,61416,Saint-Léonard-des-Parcs,78,77,1
28,61,216104182,61418,Saint-Mard-de-Réno,425,413,12
28,61,216104190,61419,Sainte-Marguerite-de-Carrouges,217,212,5
28,61,216104208,61420,Sainte-Marie-la-Robert,90,89,1
28,61,216104216,61421,Saint-Mars-d'Égrenne,671,653,18
28,61,216104224,61422,Les Aspres,626,611,15
28,61,216104232,61423,Saint-Martin-d'Écublei,663,637,26
28,61,216104240,61424,Saint-Martin-des-Landes,194,190,4
28,61,216104257,61425,Saint-Martin-des-Pézerits,140,137,3
28,61,216104265,61426,Saint-Martin-du-Vieux-Bellême,569,553,16
28,61,216104273,61427,Saint-Martin-l'Aiguillon,195,192,3
28,61,200076412,61429,Charencey,788,773,15
28,61,216104323,61432,Saint-Michel-Tuboeuf,610,589,21
28,61,216104331,61433,Saint-Nicolas-des-Bois,293,285,8
28,61,216104356,61435,Saint-Nicolas-de-Sommaire,277,272,5
28,61,216104364,61436,Sainte-Opportune,239,237,2
28,61,216104380,61438,Saint-Ouen-de-Sécherouvre,177,172,5
28,61,216104398,61439,Saint-Ouen-le-Brisoult,123,119,4
28,61,216104406,61440,Saint-Ouen-sur-Iton,865,830,35
28,61,216104422,61442,Saint-Patrice-du-Désert,233,227,6
28,61,216104430,61443,Saint-Paul,709,694,15
28,61,216104448,61444,Saint-Philbert-sur-Orne,117,117,0
28,61,216104455,61445,Saint-Pierre-d'Entremont,669,660,9
28,61,216104463,61446,Saint-Pierre-des-Loges,163,157,6
28,61,216104471,61447,Saint-Pierre-du-Regard,1413,1381,32
28,61,216104489,61448,Saint-Pierre-la-Bruyère,437,431,6
28,61,216104505,61450,Saint-Quentin-de-Blavou,73,72,1
28,61,216104513,61451,Saint-Quentin-les-Chardonnets,319,313,6
28,61,216104521,61452,Saint-Roch-sur-Égrenne,170,166,4
28,61,216104539,61453,Saint-Sauveur-de-Carrouges,251,244,7
28,61,216104547,61454,Sainte-Scolasse-sur-Sarthe,601,586,15
28,61,216104562,61456,Saint-Sulpice-sur-Risle,1679,1642,37
28,61,216104570,61457,Saint-Symphorien-des-Bruyères,484,476,8
28,61,216104596,61459,Saires-la-Verrerie,311,304,7
28,61,200056588,61460,Sap-en-Auge,970,960,10
28,61,216104612,61461,Le Sap-André,130,127,3
28,61,216104620,61462,Sarceaux,1076,1042,34
28,61,200053692,61463,Les Monts d'Andaine,1769,1737,32
28,61,216104646,61464,Sées,4634,4199,435
28,61,216104661,61466,La Selle-la-Forge,1482,1451,31
28,61,216104679,61467,Semallé,343,333,10
28,61,216104729,61472,Sévigny,316,304,12
28,61,216104737,61473,Sevrai,277,272,5
28,61,200066256,61474,Gouffern en Auge,3768,3687,81
28,61,216104752,61475,Soligny-la-Trappe,682,667,15
28,61,216104760,61476,Suré,279,274,5
28,61,216104794,61479,Tanques,161,157,4
28,61,216104802,61480,Tanville,236,231,5
28,61,216104810,61481,Tellières-le-Plessis,80,77,3
28,61,216104828,61482,Tessé-Froulay,389,380,9
28,61,200055812,61483,Bagnoles de l'Orne Normandie,2767,2720,47
28,61,200053817,61484,Val-au-Perche,3482,3410,72
28,61,216104851,61485,Ticheville,200,193,7
28,61,200049765,61486,Tinchebray-Bocage,4982,4896,86
28,61,216104877,61487,Torchamp,305,301,4
28,61,216104885,61488,Touquettes,87,85,2
28,61,216104901,61490,Tournai-sur-Dive,304,300,4
28,61,200060622,61491,Tourouvre au Perche,3117,3069,48
28,61,216104927,61492,Trémont,122,119,3
28,61,216104935,61493,La Trinité-des-Laitiers,62,57,5
28,61,216104943,61494,Trun,1290,1223,67
28,61,216104976,61497,Valframbert,1791,1760,31
28,61,216104984,61498,Vaunoise,103,99,4
28,61,216104992,61499,Les Ventes-de-Bourse,148,145,3
28,61,216105007,61500,La Ventrouze,129,125,4
28,61,216105015,61501,Verrières,426,421,5
28,61,216105023,61502,Vidai,92,90,2
28,61,216105031,61503,Vieux-Pont,202,198,4
28,61,216105056,61505,Villedieu-lès-Bailleul,221,215,6
28,61,216105072,61507,Villiers-sous-Mortagne,274,268,6
28,61,216105080,61508,Vimoutiers,3184,3096,88
28,61,216105106,61510,Vitrai-sous-Laigle,231,225,6
28,61,216105122,61512,Les Yveteaux,106,104,2
32,62,216200014,62001,Ablain-Saint-Nazaire,1968,1929,39
32,62,216200022,62002,Ablainzevelle,234,231,3
32,62,216200030,62003,Acheville,621,599,22
32,62,216200048,62004,Achicourt,8091,7981,110
32,62,216200055,62005,Achiet-le-Grand,974,969,5
32,62,216200063,62006,Achiet-le-Petit,317,312,5
32,62,216200071,62007,Acq,810,805,5
32,62,216200089,62008,Acquin-Westbécourt,807,796,11
32,62,216200097,62009,Adinfer,289,282,7
32,62,216200105,62010,Affringues,256,256,0
32,62,216200113,62011,Agnez-lès-Duisans,678,662,16
32,62,216200121,62012,Agnières,259,255,4
32,62,216200139,62013,Agny,1926,1891,35
32,62,216200147,62014,Aire-sur-la-Lys,9869,9610,259
32,62,216200154,62015,Airon-Notre-Dame,250,245,5
32,62,216200162,62016,Airon-Saint-Vaast,194,189,5
32,62,216200170,62017,Aix-en-Ergny,203,202,1
32,62,216200188,62018,Aix-en-Issart,278,273,5
32,62,216200196,62019,Aix-Noulette,3958,3917,41
32,62,216200204,62020,Alembon,633,622,11
32,62,216200212,62021,Alette,386,385,1
32,62,216200220,62022,Alincthun,316,306,10
32,62,216200238,62023,Allouagne,2902,2871,31
32,62,216200246,62024,Alquines,1007,994,13
32,62,216200253,62025,Ambleteuse,2031,1998,33
32,62,216200261,62026,Ambricourt,129,120,9
32,62,216200279,62027,Ambrines,217,217,0
32,62,216200287,62028,Ames,635,627,8
32,62,216200295,62029,Amettes,462,461,1
32,62,216200303,62030,Amplier,305,301,4
32,62,216200311,62031,Andres,1575,1552,23
32,62,216200329,62032,Angres,4834,4777,57
32,62,216200337,62033,Annay,4502,4477,25
32,62,216200345,62034,Annequin,2156,2143,13
32,62,216200352,62035,Annezin,5857,5807,50
32,62,216200360,62036,Anvin,750,736,14
32,62,216200378,62037,Anzin-Saint-Aubin,2850,2778,72
32,62,216200386,62038,Ardres,4453,4404,49
32,62,216200394,62039,Arleux-en-Gohelle,907,886,21
32,62,216200402,62040,Arques,9641,9521,120
32,62,216200410,62041,Arras,43133,42337,796
32,62,216200428,62042,Athies,1070,1058,12
32,62,216200436,62043,Les Attaques,2060,2040,20
32,62,216200444,62044,Attin,818,811,7
32,62,216200451,62045,Aubigny-en-Artois,1496,1479,17
32,62,216200469,62046,Aubin-Saint-Vaast,740,734,6
32,62,216200477,62047,Aubrometz,149,148,1
32,62,216200485,62048,Auchel,10263,10221,42
32,62,216200493,62049,Auchy-au-Bois,535,534,1
32,62,216200501,62050,Auchy-lès-Hesdin,1559,1544,15
32,62,216200519,62051,Auchy-les-Mines,4686,4656,30
32,62,216200527,62052,Audembert,471,458,13
32,62,216200535,62053,Audincthun,667,662,5
32,62,216200543,62054,Audinghen,602,594,8
32,62,216200550,62055,Audrehem,531,522,9
32,62,216200568,62056,Audresselles,633,628,5
32,62,216200576,62057,Audruicq,5480,5428,52
32,62,216200584,62058,Aumerval,206,201,5
32,62,216200592,62059,Autingues,302,288,14
32,62,216200600,62060,Auxi-le-Château,2588,2563,25
32,62,216200618,62061,Averdoingt,300,293,7
32,62,216200626,62062,Avesnes,56,55,1
32,62,216200634,62063,Avesnes-le-Comte,1849,1820,29
32,62,216200642,62064,Avesnes-lès-Bapaume,169,167,2
32,62,216200659,62065,Avion,17812,17676,136
32,62,216200667,62066,Avondance,36,34,2
32,62,216200675,62067,Avroult,600,593,7
32,62,216200683,62068,Ayette,331,324,7
32,62,216200691,62069,Azincourt,319,311,8
32,62,216200709,62070,Bailleul-aux-Cornailles,268,263,5
32,62,216200717,62071,Bailleul-lès-Pernes,413,406,7
32,62,216200725,62072,Bailleulmont,222,220,2
32,62,216200733,62073,Bailleul-Sir-Berthoult,1453,1428,25
32,62,216200741,62074,Bailleulval,240,232,8
32,62,216200758,62075,Baincthun,1325,1296,29
32,62,216200766,62076,Bainghen,218,217,1
32,62,216200774,62077,Bajus,369,363,6
32,62,216200782,62078,Balinghem,1248,1225,23
32,62,216200790,62079,Bancourt,87,86,1
32,62,216200808,62080,Bapaume,4068,3749,319
32,62,216200816,62081,Baralle,473,463,10
32,62,216200824,62082,Barastre,323,319,4
32,62,216200832,62083,Barlin,7501,7456,45
32,62,216200840,62084,Barly,214,207,7
32,62,216200857,62085,Basseux,139,134,5
32,62,216200865,62086,Bavincourt,402,396,6
32,62,216200873,62087,Bayenghem-lès-Éperlecques,1033,1010,23
32,62,216200881,62088,Bayenghem-lès-Seninghem,334,328,6
32,62,216200899,62089,Bazinghen,407,398,9
32,62,216200907,62090,Béalencourt,132,128,4
32,62,216200915,62091,Beaudricourt,92,90,2
32,62,216200923,62092,Beaufort-Blavincourt,409,406,3
32,62,216200931,62093,Beaulencourt,226,226,0
32,62,216200949,62094,Beaumerie-Saint-Martin,410,401,9
32,62,216200956,62095,Beaumetz-lès-Aire,242,241,1
32,62,216200964,62096,Beaumetz-lès-Cambrai,568,559,9
32,62,216200972,62097,Beaumetz-lès-Loges,1013,999,14
32,62,216200998,62099,Beaurains,5571,5509,62
32,62,216201004,62100,Beaurainville,2099,2071,28
32,62,216201012,62101,Beauvois,137,136,1
32,62,216201020,62102,Bécourt,278,275,3
32,62,216201038,62103,Béhagnies,136,134,2
32,62,216201046,62104,Bellebrune,444,437,7
32,62,216201053,62105,Belle-et-Houllefort,581,565,16
32,62,216201061,62106,Bellonne,208,206,2
32,62,216201079,62107,Bénifontaine,358,350,8
32,62,216201087,62108,Berck,13778,13442,336
32,62,216201095,62109,Bergueneuse,219,218,1
32,62,216201111,62111,Berlencourt-le-Cauroy,359,280,79
32,62,216201129,62112,Berles-au-Bois,528,520,8
32,62,216201137,62113,Berles-Monchel,508,496,12
32,62,216201145,62114,Bermicourt,176,172,4
32,62,216201152,62115,Berneville,484,466,18
32,62,216201160,62116,Bernieulles,180,178,2
32,62,216201178,62117,Bertincourt,927,913,14
32,62,216201186,62118,Béthonsart,147,143,4
32,62,216209106,62119,Béthune,25314,24983,331
32,62,216201202,62120,Beugin,474,466,8
32,62,216201210,62121,Beugnâtre,178,174,4
32,62,216201228,62122,Beugny,362,358,4
32,62,216201236,62123,Beussent,541,537,4
32,62,216201244,62124,Beutin,451,446,5
32,62,216201251,62125,Beuvrequen,471,460,11
32,62,216201269,62126,Beuvry,9323,9164,159
32,62,216201277,62127,Bezinghem,395,383,12
32,62,216201285,62128,Biache-Saint-Vaast,4459,4413,46
32,62,216201293,62129,Biefvillers-lès-Bapaume,98,96,2
32,62,216201301,62130,Bienvillers-au-Bois,668,654,14
32,62,216201319,62131,Bihucourt,341,338,3
32,62,216201327,62132,Billy-Berclau,5075,5034,41
32,62,216201335,62133,Billy-Montigny,8222,8185,37
32,62,216201343,62134,Bimont,111,109,2
32,62,216201350,62135,Blairville,309,307,2
32,62,216201376,62137,Blangerval-Blangermont,94,94,0
32,62,216201384,62138,Blangy-sur-Ternoise,717,704,13
32,62,216201392,62139,Blendecques,5100,4926,174
32,62,216201400,62140,Bléquin,497,492,5
32,62,216201418,62141,Blessy,915,903,12
32,62,216201426,62142,Blingel,164,157,7
32,62,216201434,62143,Boffles,49,48,1
32,62,216201442,62144,Boiry-Becquerelle,476,469,7
32,62,216201459,62145,Boiry-Notre-Dame,445,439,6
32,62,216201467,62146,Boiry-Saint-Martin,270,268,2
32,62,216201475,62147,Boiry-Sainte-Rictrude,406,402,4
32,62,216201483,62148,Bois-Bernard,829,821,8
32,62,216201491,62149,Boisdinghem,252,244,8
32,62,216201509,62150,Boisjean,509,502,7
32,62,216201517,62151,Boisleux-au-Mont,520,510,10
32,62,216201525,62152,Boisleux-Saint-Marc,250,248,2
32,62,216201533,62153,Bomy,662,653,9
32,62,200083418,62154,Bonnières,696,682,14
32,62,216201558,62155,Bonningues-lès-Ardres,649,635,14
32,62,216201566,62156,Bonningues-lès-Calais,592,572,20
32,62,216201574,62157,Boubers-lès-Hesmond,77,75,2
32,62,216201582,62158,Boubers-sur-Canche,592,580,12
32,62,216201608,62160,Boulogne-sur-Mer,40985,40588,397
32,62,216201616,62161,Bouquehault,792,787,5
32,62,216201624,62162,Bourecq,595,589,6
32,62,216201632,62163,Bouret-sur-Canche,252,249,3
32,62,216201640,62164,Bourlon,1152,1133,19
32,62,216201657,62165,Bournonville,236,231,5
32,62,216201665,62166,Bours,622,612,10
32,62,216201673,62167,Boursin,258,254,4
32,62,216201681,62168,Bourthes,853,841,12
32,62,216201699,62169,Bouvelinghem,252,246,6
32,62,216201707,62170,Bouvigny-Boyeffles,2471,2376,95
32,62,216201715,62171,Boyaval,132,130,2
32,62,216201723,62172,Boyelles,366,362,4
32,62,216201731,62173,Brebières,5201,5128,73
32,62,216201749,62174,Brêmes,1306,1294,12
32,62,216201756,62175,Brévillers,162,158,4
32,62,216201764,62176,Bréxent-Énocq,660,642,18
32,62,216201772,62177,Brimeux,878,861,17
32,62,216201780,62178,Bruay-la-Buissière,22306,21953,353
32,62,216201798,62179,Brunembert,415,408,7
32,62,216201806,62180,Brias,298,293,5
32,62,216201814,62181,Bucquoy,1562,1454,108
32,62,216201822,62182,Buire-au-Bois,246,239,7
32,62,216201830,62183,Buire-le-Sec,762,759,3
32,62,216201848,62184,Buissy,297,294,3
32,62,216201855,62185,Bullecourt,229,227,2
32,62,216201863,62186,Bully-les-Mines,12152,12080,72
32,62,216201871,62187,Buneville,184,182,2
32,62,216201889,62188,Burbure,2840,2812,28
32,62,216201897,62189,Bus,134,132,2
32,62,216201905,62190,Busnes,1261,1244,17
32,62,216201913,62191,Caffiers,731,728,3
32,62,216201921,62192,Cagnicourt,437,426,11
32,62,216201939,62193,Calais,68193,67544,649
32,62,216201947,62194,Calonne-Ricouart,5539,5511,28
32,62,216201954,62195,Calonne-sur-la-Lys,1563,1543,20
32,62,216201962,62196,La Calotterie,610,599,11
32,62,216201970,62197,Camblain-Châtelain,1791,1774,17
32,62,216201988,62198,Cambligneul,348,338,10
32,62,216201996,62199,Camblain-l'Abbé,793,671,122
32,62,216202002,62200,Cambrin,1234,1221,13
32,62,216202010,62201,Camiers,2746,2707,39
32,62,216202028,62202,Campagne-lès-Boulonnais,774,676,98
32,62,216202036,62203,Campagne-lès-Guines,443,437,6
32,62,216202044,62204,Campagne-lès-Hesdin,1975,1945,30
32,62,216202051,62205,Campagne-lès-Wardrecques,1315,1288,27
32,62,216202069,62206,Campigneulles-les-Grandes,299,284,15
32,62,216202077,62207,Campigneulles-les-Petites,558,544,14
32,62,216202085,62208,Canettemont,73,71,2
32,62,216202093,62209,Canlers,162,152,10
32,62,216202119,62211,Capelle-Fermont,221,217,4
32,62,216202127,62212,Capelle-lès-Hesdin,518,507,11
32,62,216202135,62213,Carency,807,796,11
32,62,216202143,62214,Carly,618,607,11
32,62,216202150,62215,Carvin,17761,17667,94
32,62,216202168,62216,La Cauchie,210,208,2
32,62,216202176,62217,Cauchy-à-la-Tour,2737,2723,14
32,62,216202184,62218,Caucourt,342,334,8
32,62,216202192,62219,Caumont,162,158,4
32,62,216202200,62220,Cavron-Saint-Martin,450,445,5
32,62,216202218,62221,Chelers,250,245,5
32,62,216202226,62222,Chériennes,160,159,1
32,62,216202234,62223,Chérisy,295,290,5
32,62,216202242,62224,Chocques,2848,2821,27
32,62,216202259,62225,Clairmarais,611,600,11
32,62,216202275,62227,Clenleu,187,185,2
32,62,216202283,62228,Clerques,324,320,4
32,62,216202291,62229,Cléty,820,804,16
32,62,216202309,62230,Colembert,965,950,15
32,62,216202317,62231,Colline-Beaumont,128,128,0
32,62,216202325,62232,La Comté,907,892,15
32,62,216202333,62233,Conchil-le-Temple,1127,1113,14
32,62,216202341,62234,Conchy-sur-Canche,225,221,4
32,62,216202358,62235,Condette,2571,2482,89
32,62,216202366,62236,Contes,351,343,8
32,62,216202374,62237,Conteville-lès-Boulogne,528,518,10
32,62,216202382,62238,Conteville-en-Ternois,82,81,1
32,62,216202390,62239,Coquelles,2635,2601,34
32,62,216202408,62240,Corbehem,2287,2272,15
32,62,216202416,62241,Cormont,317,312,5
32,62,216202424,62242,Couin,93,88,5
32,62,216202432,62243,Coullemont,128,125,3
32,62,216202440,62244,Coulogne,5658,5451,207
32,62,216202457,62245,Coulomby,770,763,7
32,62,216202465,62246,Coupelle-Neuve,150,150,0
32,62,216202473,62247,Coupelle-Vieille,613,602,11
32,62,216202481,62248,Courcelles-le-Comte,479,473,6
32,62,216202499,62249,Courcelles-lès-Lens,8204,8166,38
32,62,216202507,62250,Courrières,10455,10360,95
32,62,216202515,62251,Courset,703,512,191
32,62,216202523,62252,La Couture,2713,2643,70
32,62,216202531,62253,Couturelle,74,74,0
32,62,216202549,62254,Coyecques,615,602,13
32,62,216202556,62255,Crémarest,811,796,15
32,62,216202564,62256,Crépy,155,153,2
32,62,216202572,62257,Créquy,473,463,10
32,62,216202580,62258,Croisette,270,265,5
32,62,216202598,62259,Croisilles,1985,1961,24
32,62,216202606,62260,Croix-en-Ternois,333,330,3
32,62,216202614,62261,Cucq,5178,5094,84
32,62,216202622,62262,Cuinchy,1773,1751,22
32,62,216202630,62263,Dainville,5791,5689,102
32,62,216202648,62264,Dannes,1336,1332,4
32,62,216202655,62265,Delettes,1208,1192,16
32,62,216202663,62266,Denier,92,90,2
32,62,216202671,62267,Dennebroeucq,406,400,6
32,62,216202689,62268,Desvres,4898,4861,37
32,62,216202697,62269,Diéval,736,725,11
32,62,216202705,62270,Divion,6994,6957,37
32,62,216202713,62271,Dohem,852,834,18
32,62,216202721,62272,Douchy-lès-Ayette,316,314,2
32,62,216202739,62273,Doudeauville,639,630,9
32,62,216202747,62274,Dourges,5967,5927,40
32,62,216202754,62275,Douriez,307,300,7
32,62,216202762,62276,Douvrin,5781,5733,48
32,62,216202770,62277,Drocourt,2951,2935,16
32,62,216202788,62278,Drouvin-le-Marais,630,610,20
32,62,216202796,62279,Duisans,1440,1374,66
32,62,216202804,62280,Dury,320,318,2
32,62,216202812,62281,Echinghen,393,384,9
32,62,216202820,62282,Éclimeux,181,181,0
32,62,216202838,62283,Écoivres,131,131,0
32,62,216202846,62284,Écourt-Saint-Quentin,1705,1686,19
32,62,216202853,62285,Écoust-Saint-Mein,500,490,10
32,62,216202861,62286,Ecquedecques,510,506,4
32,62,216202887,62288,Ecques,2222,2178,44
32,62,216202895,62289,Écuires,715,694,21
32,62,216202903,62290,Écurie,387,380,7
32,62,216202911,62291,Éleu-dit-Leauwette,2875,2844,31
32,62,216202929,62292,Elnes,882,868,14
32,62,216202937,62293,Embry,236,231,5
32,62,200063006,62295,Enquin-lez-Guinegatte,1639,1613,26
32,62,216202960,62296,Enquin-sur-Baillons,277,268,9
32,62,216202978,62297,Éperlecques,3790,3745,45
32,62,216202986,62298,Épinoy,562,549,13
32,62,216202994,62299,Eps,252,246,6
32,62,216203000,62300,Équihen-Plage,2652,2624,28
32,62,216203018,62301,Équirre,82,81,1
32,62,216203026,62302,Ergny,238,236,2
32,62,216203034,62303,Érin,240,237,3
32,62,216203042,62304,Erny-Saint-Julien,337,335,2
32,62,216203067,62306,Ervillers,394,391,3
32,62,216203075,62307,Escalles,228,219,9
32,62,216203083,62308,Escoeuilles,486,476,10
32,62,216203091,62309,Esquerdes,1652,1631,21
32,62,216203109,62310,Essars,1777,1758,19
32,62,216203117,62311,Estevelles,2039,2031,8
32,62,216203125,62312,Estrée,296,290,6
32,62,216203133,62313,Estrée-Blanche,921,915,6
32,62,216203141,62314,Estrée-Cauchy,359,357,2
32,62,216203158,62315,Estréelles,355,346,9
32,62,216203166,62316,Estrée-Wamin,214,208,6
32,62,216203174,62317,Étaing,458,455,3
32,62,216203182,62318,Étaples,10928,10813,115
32,62,216203190,62319,Éterpigny,261,258,3
32,62,216203208,62320,Étrun,321,316,5
32,62,216203216,62321,Évin-Malmaison,4688,4662,26
32,62,216203224,62322,Famechon,112,111,1
32,62,216203232,62323,Fampoux,1228,1209,19
32,62,216203240,62324,Farbus,615,604,11
32,62,216203257,62325,Fauquembergues,966,949,17
32,62,216203265,62326,Favreuil,250,245,5
32,62,216203273,62327,Febvin-Palfart,618,614,4
32,62,216203281,62328,Ferfay,902,895,7
32,62,216203299,62329,Ferques,1771,1751,20
32,62,216203307,62330,Festubert,1292,1268,24
32,62,216203315,62331,Feuchy,1047,1027,20
32,62,216203323,62332,Ficheux,511,501,10
32,62,216203331,62333,Fiefs,396,390,6
32,62,216203349,62334,Fiennes,872,856,16
32,62,216203356,62335,Fillièvres,519,514,5
32,62,216203364,62336,Fléchin,487,480,7
32,62,216203372,62337,Flers,227,222,5
32,62,216203380,62338,Fleurbaix,2830,2779,51
32,62,216203398,62339,Fleury,110,109,1
32,62,216203406,62340,Floringhem,890,883,7
32,62,216203414,62341,Foncquevillers,420,412,8
32,62,216203422,62342,Fontaine-lès-Boulans,107,106,1
32,62,216203430,62343,Fontaine-lès-Croisilles,264,262,2
32,62,216203448,62344,Fontaine-lès-Hermans,114,111,3
32,62,216203455,62345,Fontaine-l'Étalon,98,97,1
32,62,216203463,62346,Fortel-en-Artois,220,216,4
32,62,216203471,62347,Fosseux,131,128,3
32,62,216203489,62348,Foufflin-Ricametz,161,159,2
32,62,216203497,62349,Fouquereuil,1652,1629,23
32,62,216203505,62350,Fouquières-lès-Béthune,1144,1124,20
32,62,216203513,62351,Fouquières-lès-Lens,6368,6333,35
32,62,216203521,62352,Framecourt,112,109,3
32,62,216203539,62353,Frémicourt,240,237,3
32,62,216203547,62354,Frencq,914,896,18
32,62,216203554,62355,Fresnes-lès-Montauban,595,590,5
32,62,216203562,62356,Fresnicourt-le-Dolmen,809,801,8
32,62,216203570,62357,Fresnoy,72,71,1
32,62,216203588,62358,Fresnoy-en-Gohelle,241,235,6
32,62,216203596,62359,Fressin,595,583,12
32,62,216203604,62360,Fréthun,1404,1390,14
32,62,216203612,62361,Frévent,3395,3348,47
32,62,216203620,62362,Frévillers,243,240,3
32,62,216203638,62363,Frévin-Capelle,389,380,9
32,62,216203646,62364,Fruges,2580,2338,242
32,62,216203653,62365,Galametz,201,201,0
32,62,216203661,62366,Gauchin-Légal,315,308,7
32,62,216203679,62367,Gauchin-Verloingt,829,811,18
32,62,216203687,62368,Gaudiempré,210,210,0
32,62,216203695,62369,Gavrelle,834,817,17
32,62,216203703,62370,Gennes-Ivergny,125,124,1
32,62,216203711,62371,Givenchy-en-Gohelle,2048,2003,45
32,62,216203729,62372,Givenchy-le-Noble,153,150,3
32,62,216203737,62373,Givenchy-lès-la-Bassée,1034,1023,11
32,62,216203745,62374,Gomiécourt,154,153,1
32,62,216203752,62375,Gommecourt,90,89,1
32,62,216203760,62376,Gonnehem,2550,2512,38
32,62,216203778,62377,Gosnay,956,949,7
32,62,216203786,62378,Gouves,204,200,4
32,62,216203794,62379,Gouy-en-Artois,333,325,8
32,62,216203802,62380,Gouy-Servins,351,350,1
32,62,216203810,62381,Gouy-en-Ternois,133,132,1
32,62,216203828,62382,Gouy-Saint-André,665,652,13
32,62,216203836,62383,Gouy-sous-Bellonne,1410,1392,18
32,62,216203844,62384,Graincourt-lès-Havrincourt,657,649,8
32,62,216203851,62385,Grand-Rullecourt,385,381,4
32,62,216203869,62386,Grenay,6778,6748,30
32,62,216203877,62387,Grévillers,368,358,10
32,62,216203885,62388,Grigny,298,295,3
32,62,216203893,62389,Grincourt-lès-Pas,31,29,2
32,62,216203901,62390,Groffliers,1551,1514,37
32,62,216203919,62391,Guarbecque,1401,1388,13
32,62,216203927,62392,Guémappe,387,378,9
32,62,216203935,62393,Guemps,1134,1112,22
32,62,216203950,62395,Guigny,134,130,4
32,62,216203968,62396,Guinecourt,16,15,1
32,62,216203976,62397,Guînes,5654,5581,73
32,62,216203984,62398,Guisy,282,270,12
32,62,216203992,62399,Habarcq,672,658,14
32,62,216204008,62400,Haillicourt,4900,4864,36
32,62,216204016,62401,Haisnes,4446,4416,30
32,62,216204024,62402,Halinghen,316,310,6
32,62,216204032,62403,Hallines,1226,1211,15
32,62,216204040,62404,Halloy,204,202,2
32,62,216204057,62405,Hamblain-les-Prés,480,470,10
32,62,216204065,62406,Hamelincourt,275,267,8
32,62,216204073,62407,Ham-en-Artois,960,947,13
32,62,216204081,62408,Hames-Boucres,1475,1457,18
32,62,216204099,62409,Hannescamps,199,196,3
32,62,216204107,62410,Haplincourt,188,185,3
32,62,216204115,62411,Haravesnes,54,54,0
32,62,216204123,62412,Hardinghen,1223,1217,6
32,62,216204131,62413,Harnes,12369,12277,92
32,62,216204149,62414,Haucourt,215,213,2
32,62,216204156,62415,Haute-Avesnes,446,437,9
32,62,216204164,62416,Hautecloque,218,216,2
32,62,216204180,62418,Hauteville,316,308,8
32,62,216204198,62419,Haut-Loquin,177,176,1
32,62,216204214,62421,Havrincourt,394,389,5
32,62,216204222,62422,Hébuterne,526,521,5
32,62,216204230,62423,Helfaut,1766,1737,29
32,62,216204248,62424,Hendecourt-lès-Cagnicourt,327,316,11
32,62,216204255,62425,Hendecourt-lès-Ransart,143,139,4
32,62,216204263,62426,Héninel,188,186,2
32,62,216204271,62427,Hénin-Beaumont,26258,25886,372
32,62,216204289,62428,Hénin-sur-Cojeul,534,527,7
32,62,216204297,62429,Henneveux,284,280,4
32,62,216204305,62430,Hénu,162,161,1
32,62,216204321,62432,Herbinghen,413,405,8
32,62,216204339,62433,Héricourt,89,83,6
32,62,216204347,62434,La Herlière,141,139,2
32,62,216204354,62435,Herlincourt,107,107,0
32,62,216204362,62436,Herlin-le-Sec,164,161,3
32,62,216204370,62437,Herly,315,308,7
32,62,216204388,62438,Hermaville,544,536,8
32,62,216204396,62439,Hermelinghen,425,418,7
32,62,216204404,62440,Hermies,1184,1159,25
32,62,216204412,62441,Hermin,211,209,2
32,62,216204420,62442,Hernicourt,559,548,11
32,62,216204438,62443,Hersin-Coupigny,6239,6196,43
32,62,216204446,62444,Hervelinghen,231,225,6
32,62,216204453,62445,Hesdigneul-lès-Béthune,844,827,17
32,62,216204461,62446,Hesdigneul-lès-Boulogne,828,805,23
32,62,216204479,62447,Hesdin,2229,2218,11
32,62,216204487,62448,Hesdin-l'Abbé,1920,1891,29
32,62,216204495,62449,Hesmond,165,159,6
32,62,216204503,62450,Hestrus,231,225,6
32,62,216204511,62451,Heuchin,502,492,10
32,62,216204529,62452,Heuringhem,1407,1371,36
32,62,216204537,62453,Hézecques,131,128,3
32,62,216204545,62454,Hinges,2463,2413,50
32,62,216204552,62455,Hocquinghen,112,111,1
32,62,216204560,62456,Houchin,725,718,7
32,62,216204578,62457,Houdain,7125,7066,59
32,62,216204586,62458,Houlle,1175,1163,12
32,62,216204594,62459,Houvin-Houvigneul,241,238,3
32,62,216204602,62460,Hubersent,275,270,5
32,62,216204610,62461,Huby-Saint-Leu,876,869,7
32,62,216204628,62462,Huclier,159,154,5
32,62,216204636,62463,Hucqueliers,504,454,50
32,62,216204644,62464,Hulluch,3399,3380,19
32,62,216204651,62465,Humbercamps,218,218,0
32,62,216204669,62466,Humbert,239,238,1
32,62,216204677,62467,Humeroeuille,181,180,1
32,62,216204685,62468,Humières,215,214,1
32,62,216204693,62469,Inchy-en-Artois,585,578,7
32,62,216204701,62470,Incourt,86,86,0
32,62,200062677,62471,Bellinghem,1105,1084,21
32,62,216204727,62472,Inxent,166,160,6
32,62,216204735,62473,Isbergues,8760,8683,77
32,62,216204743,62474,Isques,1175,1154,21
32,62,216204750,62475,Ivergny,246,243,3
32,62,216204768,62476,Izel-lès-Équerchin,1067,1056,11
32,62,216204776,62477,Izel-lès-Hameau,747,730,17
32,62,216204784,62478,Journy,291,288,3
32,62,216204792,62479,Labeuvrière,1676,1662,14
32,62,216204800,62480,Labourse,2935,2912,23
32,62,216204818,62481,Labroye,153,150,3
32,62,216204834,62483,Lacres,250,248,2
32,62,216204842,62484,Lagnicourt-Marcel,325,319,6
32,62,216204859,62485,Laires,372,369,3
32,62,216204867,62486,Lambres,1071,1058,13
32,62,216204875,62487,Landrethun-le-Nord,1274,1252,22
32,62,216204883,62488,Landrethun-lès-Ardres,795,775,20
32,62,216204891,62489,Lapugnoy,3554,3525,29
32,62,216204909,62490,Lattre-Saint-Quentin,282,279,3
32,62,216204917,62491,Laventie,5052,4969,83
32,62,216204925,62492,Lebiez,243,240,3
32,62,216204933,62493,Lebucquière,237,233,4
32,62,216204941,62494,Léchelle,46,46,0
32,62,216204958,62495,Ledinghem,333,327,6
32,62,216204966,62496,Lefaux,236,230,6
32,62,216204974,62497,Leforest,7285,7236,49
32,62,216204982,62498,Lens,32651,32458,193
32,62,216204990,62499,Lépine,297,289,8
32,62,216205005,62500,Lespesses,407,404,3
32,62,216205013,62501,Lespinoy,231,227,4
32,62,216205021,62502,Lestrem,5188,5104,84
32,62,216205039,62503,Leubringhen,303,297,6
32,62,216205047,62504,Leulinghem,263,258,5
32,62,216205054,62505,Leulinghen-Bernes,521,512,9
32,62,216205062,62506,Licques,1659,1639,20
32,62,216205070,62507,Liencourt,304,297,7
32,62,216205088,62508,Lières,374,367,7
32,62,216205096,62509,Liettres,352,343,9
32,62,216205104,62510,Liévin,30432,30102,330
32,62,216205112,62511,Lignereuil,142,141,1
32,62,216205120,62512,Ligny-lès-Aire,583,568,15
32,62,216205138,62513,Ligny-sur-Canche,193,187,6
32,62,216205146,62514,Ligny-Saint-Flochel,247,244,3
32,62,216205153,62515,Ligny-Thilloy,538,521,17
32,62,216205161,62516,Lillers,9957,9866,91
32,62,216205179,62517,Linghem,198,192,6
32,62,216205187,62518,Linzeux,172,171,1
32,62,216205195,62519,Lisbourg,617,609,8
32,62,216205203,62520,Locon,2417,2361,56
32,62,216205211,62521,La Loge,210,205,5
32,62,216205229,62522,Loison-sur-Créquoise,281,278,3
32,62,216205237,62523,Loison-sous-Lens,5343,5308,35
32,62,216205245,62524,Longfossé,1521,1504,17
32,62,216205252,62525,Longuenesse,11078,10600,478
32,62,216205260,62526,Longueville,149,147,2
32,62,216205278,62527,Longvilliers,261,256,5
32,62,216205286,62528,Loos-en-Gohelle,6966,6904,62
32,62,216205294,62529,Lorgies,1608,1589,19
32,62,216205302,62530,Lottinghen,542,533,9
32,62,216205310,62531,Louches,964,945,19
32,62,216205328,62532,Lozinghem,1313,1300,13
32,62,216205336,62533,Lugy,147,145,2
32,62,216205344,62534,Lumbres,3651,3582,69
32,62,216205351,62535,La Madelaine-sous-Montreuil,159,151,8
32,62,216205369,62536,Magnicourt-en-Comte,645,640,5
32,62,216205377,62537,Magnicourt-sur-Canche,106,103,3
32,62,216205385,62538,Maintenay,465,456,9
32,62,216205393,62539,Maisnil,241,238,3
32,62,216205401,62540,Maisnil-lès-Ruitz,1713,1698,15
32,62,216205419,62541,Maisoncelle,125,121,4
32,62,216205427,62542,Maizières,207,203,4
32,62,216205435,62543,Mametz,2038,2006,32
32,62,216205443,62544,Manin,182,181,1
32,62,216205450,62545,Maninghem,145,145,0
32,62,216205468,62546,Maninghen-Henne,316,307,9
32,62,216205476,62547,Marant,61,60,1
32,62,216205484,62548,Marck,10665,10523,142
32,62,216205492,62549,Marconne,1134,1070,64
32,62,216205500,62550,Marconnelle,1110,1090,20
32,62,216205518,62551,Marenla,242,240,2
32,62,216205526,62552,Maresquel-Ecquemicourt,1046,1038,8
32,62,216205534,62553,Marest,288,282,6
32,62,216205542,62554,Maresville,105,101,4
32,62,216205559,62555,Marles-les-Mines,5549,5524,25
32,62,216205567,62556,Marles-sur-Canche,318,313,5
32,62,216205575,62557,Maroeuil,2510,2454,56
32,62,216205583,62558,Marquay,179,179,0
32,62,216205591,62559,Marquion,989,976,13
32,62,216205609,62560,Marquise,5133,5072,61
32,62,216205617,62561,Martinpuich,193,192,1
32,62,216205625,62562,Matringhem,178,175,3
32,62,216205633,62563,Mazingarbe,8068,8029,39
32,62,216205641,62564,Mazinghem,475,466,9
32,62,216205658,62565,Mencas,76,76,0
32,62,216205666,62566,Menneville,680,664,16
32,62,216205674,62567,Mentque-Nortbécourt,654,647,7
32,62,216205682,62568,Mercatel,735,726,9
32,62,216205690,62569,Merck-Saint-Liévin,674,668,6
32,62,216205708,62570,Méricourt,11432,11374,58
32,62,216205716,62571,Merlimont,3459,3389,70
32,62,216205724,62572,Metz-en-Couture,625,615,10
32,62,216205732,62573,Meurchin,3752,3728,24
32,62,216205740,62574,Mingoval,238,233,5
32,62,216205765,62576,Moncheaux-lès-Frévent,146,146,0
32,62,216205773,62577,Monchel-sur-Canche,79,77,2
32,62,216205781,62578,Monchiet,102,98,4
32,62,216205799,62579,Monchy-au-Bois,548,545,3
32,62,216205807,62580,Monchy-Breton,534,526,8
32,62,216205815,62581,Monchy-Cayeux,299,297,2
32,62,216205823,62582,Monchy-le-Preux,694,657,37
32,62,216205831,62583,Mondicourt,570,561,9
32,62,216205849,62584,Mont-Bernanchon,1358,1326,32
32,62,216205856,62585,Montcavrel,401,396,5
32,62,216205864,62586,Montenescourt,451,446,5
32,62,216205872,62587,Montigny-en-Gohelle,10128,10086,42
32,62,216205880,62588,Montreuil-sur-Mer,2036,1913,123
32,62,216205898,62589,Mont-Saint-Éloi,1037,1016,21
32,62,216205906,62590,Monts-en-Ternois,63,63,0
32,62,216205914,62591,Morchies,214,209,5
32,62,216205922,62592,Moringhem,568,556,12
32,62,216205930,62593,Morval,89,89,0
32,62,216205948,62594,Mory,311,308,3
32,62,216205955,62595,Moulle,1166,1136,30
32,62,216205963,62596,Mouriez,246,241,5
32,62,216205971,62597,Moyenneville,289,286,3
32,62,216205989,62598,Muncq-Nieurlet,724,712,12
32,62,216205997,62599,Nabringhen,231,224,7
32,62,216206003,62600,Nédon,155,152,3
32,62,216206011,62601,Nédonchel,355,350,5
32,62,216206029,62602,Nempont-Saint-Firmin,205,202,3
32,62,216206037,62603,Nesles,1074,1067,7
32,62,216206045,62604,Neufchâtel-Hardelot,3818,3748,70
32,62,216206052,62605,Neulette,25,25,0
32,62,216206060,62606,Neuve-Chapelle,1458,1435,23
32,62,216206078,62607,Neuville-au-Cornet,67,64,3
32,62,216206086,62608,Neuville-Bourjonval,169,168,1
32,62,216206094,62609,Neuville-Saint-Vaast,1631,1594,37
32,62,216206102,62610,Neuville-sous-Montreuil,659,650,9
32,62,216206110,62611,Neuville-Vitasse,509,496,13
32,62,216206128,62612,Neuvireuil,597,585,12
32,62,216206136,62613,Nielles-lès-Bléquin,906,898,8
32,62,216206144,62614,Nielles-lès-Ardres,606,592,14
32,62,216206151,62615,Nielles-lès-Calais,292,286,6
32,62,216206169,62616,Noeux-lès-Auxi,186,184,2
32,62,216206177,62617,Noeux-les-Mines,11690,11638,52
32,62,216206185,62618,Nordausques,1351,1336,15
32,62,216206193,62619,Noreuil,143,141,2
32,62,216206201,62620,Norrent-Fontes,1399,1377,22
32,62,216206219,62621,Nortkerque,1774,1743,31
32,62,216206227,62622,Nort-Leulinghem,269,266,3
32,62,216206235,62623,Nouvelle-Église,720,710,10
32,62,216206243,62624,Noyelles-Godault,5892,5864,28
32,62,216206250,62625,Noyelles-lès-Humières,58,56,2
32,62,216206268,62626,Noyelles-lès-Vermelles,2318,2297,21
32,62,216206276,62627,Noyelles-sous-Bellonne,843,829,14
32,62,216206284,62628,Noyelles-sous-Lens,6634,6590,44
32,62,216206292,62629,Noyellette,162,161,1
32,62,216206300,62630,Noyelle-Vion,302,297,5
32,62,216206318,62631,Nuncq-Hautecôte,495,488,7
32,62,216206326,62632,Oblinghem,387,381,6
32,62,216206334,62633,oeuf-en-Ternois,258,256,2
32,62,216206342,62634,Offekerque,1224,1214,10
32,62,216206359,62635,Offin,201,199,2
32,62,216206367,62636,Offrethun,271,269,2
32,62,216206375,62637,Oignies,10173,10130,43
32,62,216206383,62638,Oisy-le-Verger,1189,1175,14
32,62,216206391,62639,Oppy,392,383,9
32,62,216206409,62640,Orville,371,370,1
32,62,216206417,62641,Ostreville,216,213,3
32,62,216206425,62642,Ourton,755,750,5
32,62,216206433,62643,Outreau,13340,13178,162
32,62,216206441,62644,Ouve-Wirquin,510,503,7
32,62,216206458,62645,Oye-Plage,5713,5630,83
32,62,216206466,62646,Palluel,580,573,7
32,62,216206474,62647,Le Parcq,753,738,15
32,62,216206482,62648,Parenty,531,522,9
32,62,216206490,62649,Pas-en-Artois,764,754,10
32,62,216206508,62650,Pelves,773,765,8
32,62,216206516,62651,Penin,495,488,7
32,62,216206524,62652,Pernes,1635,1606,29
32,62,216206532,62653,Pernes-lès-Boulogne,433,414,19
32,62,216206540,62654,Peuplingues,797,784,13
32,62,216206557,62655,Pierremont,324,316,8
32,62,216206565,62656,Pihem,974,947,27
32,62,216206573,62657,Pihen-lès-Guînes,510,503,7
32,62,216206581,62658,Pittefaux,126,117,9
32,62,216206599,62659,Planques,105,102,3
32,62,216206607,62660,Plouvain,464,457,7
32,62,216206615,62661,Bouin-Plumoison,507,507,0
32,62,216206623,62662,Polincove,891,870,21
32,62,216206631,62663,Pommera,314,310,4
32,62,216206649,62664,Pommier,240,234,6
32,62,216206656,62665,Le Ponchel,219,213,6
32,62,216206664,62666,Pont-à-Vendin,3134,3116,18
32,62,216206672,62667,Le Portel,9098,8985,113
32,62,216206680,62668,Prédefin,190,189,1
32,62,216206698,62669,Pressy,314,309,5
32,62,216206706,62670,Preures,630,623,7
32,62,216206714,62671,Pronville-en-Artois,321,316,5
32,62,216206722,62672,Puisieux,652,647,5
32,62,216206730,62673,Quéant,651,643,8
32,62,216206748,62674,Quelmes,562,544,18
32,62,216206755,62675,Quercamps,277,275,2
32,62,216206763,62676,Quernes,455,448,7
32,62,216206771,62677,Le Quesnoy-en-Artois,345,340,5
32,62,216206789,62678,Quesques,710,701,9
32,62,216206797,62679,Questrecques,332,324,8
32,62,216206805,62680,Quiéry-la-Motte,742,729,13
32,62,216206813,62681,Quiestède,647,625,22
32,62,216206821,62682,Quilen,66,66,0
32,62,216206839,62683,Quoeux-Haut-Maînil,228,226,2
32,62,216206847,62684,Racquinghem,2248,2218,30
32,62,216206854,62685,Radinghem,433,270,163
32,62,216206862,62686,Ramecourt,354,348,6
32,62,216206888,62688,Rang-du-Fliers,4448,4329,119
32,62,216206896,62689,Ransart,397,395,2
32,62,216206904,62690,Raye-sur-Authie,239,233,6
32,62,200057099,62691,Saint-Augustin,836,824,12
32,62,216206920,62692,Rebergues,378,374,4
32,62,216206938,62693,Rebreuve-Ranchicourt,1093,1071,22
32,62,216206946,62694,Rebreuve-sur-Canche,190,188,2
32,62,216206953,62695,Rebreuviette,263,261,2
32,62,216206961,62696,Reclinghem,236,233,3
32,62,216206979,62697,Récourt,248,248,0
32,62,216206987,62698,Recques-sur-Course,277,272,5
32,62,216206995,62699,Recques-sur-Hem,668,655,13
32,62,216207001,62700,Regnauville,214,213,1
32,62,216207019,62701,Rely,455,453,2
32,62,216207027,62702,Remilly-Wirquin,362,358,4
32,62,216207035,62703,Rémy,381,378,3
32,62,216207043,62704,Renty,606,588,18
32,62,216207050,62705,Rety,2103,2087,16
32,62,216207068,62706,Richebourg,2686,2628,58
32,62,216207084,62708,Riencourt-lès-Bapaume,32,31,1
32,62,216207092,62709,Riencourt-lès-Cagnicourt,254,249,5
32,62,216207100,62710,Rimboval,186,182,4
32,62,216207118,62711,Rinxent,3079,3048,31
32,62,216207126,62712,Rivière,1154,1125,29
32,62,216207134,62713,Robecq,1358,1335,23
32,62,216207142,62714,Roclincourt,801,783,18
32,62,216207159,62715,Rocquigny,289,289,0
32,62,216207167,62716,Rodelinghem,556,550,6
32,62,216207175,62717,Roëllecourt,537,528,9
32,62,216207183,62718,Roeux,1426,1404,22
32,62,216207191,62719,Rollancourt,315,280,35
32,62,216207209,62720,Rombly,45,43,2
32,62,216207217,62721,Roquetoire,1994,1947,47
32,62,216207225,62722,Rougefay,92,89,3
32,62,216207233,62723,Roussent,239,238,1
32,62,216207241,62724,Rouvroy,8960,8925,35
32,62,216207258,62725,Royon,140,140,0
32,62,216207266,62726,Ruisseauville,209,204,5
32,62,216207274,62727,Ruitz,1544,1521,23
32,62,216207282,62728,Rumaucourt,704,693,11
32,62,216207290,62729,Rumilly,254,246,8
32,62,216207308,62730,Ruminghem,1635,1612,23
32,62,216207316,62731,Ruyaulcourt,284,281,3
32,62,216207324,62732,Sachin,325,323,2
32,62,216207332,62733,Sailly-au-Bois,304,301,3
32,62,216207340,62734,Sailly-en-Ostrevent,680,672,8
32,62,216207357,62735,Sailly-Labourse,2539,2520,19
32,62,216207365,62736,Sailly-sur-la-Lys,3972,3900,72
32,62,216207373,62737,Sains-en-Gohelle,6069,6035,34
32,62,216207381,62738,Sains-lès-Fressin,156,155,1
32,62,216207399,62739,Sains-lès-Marquion,330,327,3
32,62,216207407,62740,Sains-lès-Pernes,315,306,9
32,62,216207415,62741,Saint-Amand,120,117,3
32,62,216207423,62742,Saint-Aubin,276,270,6
32,62,216207431,62743,Sainte-Austreberthe,389,380,9
32,62,216207449,62744,Sainte-Catherine,3713,3653,60
32,62,216207456,62745,Saint-Denoeux,165,159,6
32,62,216207464,62746,Saint-Étienne-au-Mont,5159,5094,65
32,62,216207472,62747,Saint-Floris,641,625,16
32,62,216207480,62748,Saint-Folquin,2358,2318,40
32,62,216207498,62749,Saint-Georges,344,338,6
32,62,216207506,62750,Saint-Hilaire-Cottes,826,817,9
32,62,216207514,62751,Saint-Inglevert,810,801,9
32,62,216207522,62752,Saint-Josse,1146,1105,41
32,62,216207530,62753,Saint-Laurent-Blangy,6578,6522,56
32,62,216207548,62754,Saint-Léger,498,495,3
32,62,216207555,62755,Saint-Léonard,3427,3377,50
32,62,216207563,62756,Sainte-Marie-Kerque,1688,1671,17
32,62,200059608,62757,Saint-Martin-lez-Tatinghem,6104,5970,134
32,62,216207589,62758,Saint-Martin-Boulogne,11338,11165,173
32,62,216207597,62759,Saint-Martin-Choquel,473,463,10
32,62,216207605,62760,Saint-Martin-d'Hardinghem,281,275,6
32,62,216207613,62761,Saint-Martin-sur-Cojeul,215,211,4
32,62,216207621,62762,Saint-Michel-sous-Bois,127,122,5
32,62,216207639,62763,Saint-Michel-sur-Ternoise,869,854,15
32,62,216207647,62764,Saint-Nicolas,4710,4659,51
32,62,216207654,62765,Saint-Omer,15428,14782,646
32,62,216207662,62766,Saint-Omer-Capelle,1121,1109,12
32,62,216207670,62767,Saint-Pol-sur-Ternoise,5023,4870,153
32,62,216207688,62768,Saint-Rémy-au-Bois,107,105,2
32,62,216207696,62769,Saint-Tricat,779,765,14
32,62,216207704,62770,Saint-Venant,3136,3041,95
32,62,216207712,62771,Sallaumines,9618,9575,43
32,62,216207720,62772,Salperwick,502,492,10
32,62,216207738,62773,Samer,4794,4656,138
32,62,216207746,62774,Sangatte,4969,4840,129
32,62,216207753,62775,Sanghen,353,351,2
32,62,216207761,62776,Sapignies,197,193,4
32,62,216207779,62777,Le Sars,161,160,1
32,62,216207787,62778,Sars-le-Bois,78,77,1
32,62,216207795,62779,Sarton,190,189,1
32,62,216207803,62780,Sauchy-Cauchy,367,364,3
32,62,216207811,62781,Sauchy-Lestrée,469,466,3
32,62,216207829,62782,Saudemont,439,433,6
32,62,216207837,62783,Saulchoy,321,317,4
32,62,216207845,62784,Saulty,783,771,12
32,62,216207852,62785,Savy-Berlette,1076,891,185
32,62,216207860,62786,Selles,324,320,4
32,62,216207878,62787,Sempy,322,319,3
32,62,216207886,62788,Seninghem,711,694,17
32,62,216207894,62789,Senlecques,273,268,5
32,62,216207902,62790,Senlis,169,162,7
32,62,216207910,62791,Séricourt,49,49,0
32,62,216207928,62792,Serques,1183,1151,32
32,62,216207936,62793,Servins,1151,1133,18
32,62,216207944,62794,Setques,600,589,11
32,62,216207951,62795,Sibiville,112,110,2
32,62,216207969,62796,Simencourt,569,557,12
32,62,216207977,62797,Siracourt,281,278,3
32,62,216207985,62798,Sombrin,233,228,5
32,62,216207993,62799,Sorrus,942,914,28
32,62,216208009,62800,Souastre,381,378,3
32,62,216208017,62801,Souchez,2693,2643,50
32,62,216208025,62802,Le Souich,187,185,2
32,62,216208033,62803,Surques,645,640,5
32,62,216208041,62804,Sus-Saint-Léger,370,365,5
32,62,216208058,62805,Tangry,271,267,4
32,62,216208066,62806,Tardinghen,155,150,5
32,62,216208082,62808,Teneur,260,258,2
32,62,216208090,62809,Ternas,142,139,3
32,62,216208108,62810,Thélus,1262,1239,23
32,62,216208116,62811,Thérouanne,1127,1101,26
32,62,216208124,62812,Thiembronne,842,835,7
32,62,216208132,62813,La Thieuloye,496,494,2
32,62,216208140,62814,Thièvres,98,97,1
32,62,216208157,62815,Tigny-Noyelle,174,174,0
32,62,216208165,62816,Tilloy-lès-Hermaville,223,218,5
32,62,216208173,62817,Tilloy-lès-Mofflaines,1585,1475,110
32,62,216208181,62818,Tilly-Capelle,156,155,1
32,62,216208199,62819,Tilques,1107,1077,30
32,62,216208207,62820,Tincques,829,811,18
32,62,216208215,62821,Tingry,301,294,7
32,62,216208223,62822,Tollent,95,92,3
32,62,216208231,62823,Torcy,177,172,5
32,62,216208249,62824,Tortefontaine,224,219,5
32,62,216208256,62825,Tortequesne,847,839,8
32,62,216208264,62826,Le Touquet-Paris-Plage,4527,4226,301
32,62,216208272,62827,Tournehem-sur-la-Hem,1408,1391,17
32,62,216208280,62828,Tramecourt,57,57,0
32,62,216208298,62829,Le Transloy,434,430,4
32,62,216208306,62830,Trescault,177,175,2
32,62,216208314,62831,Troisvaux,306,296,10
32,62,216208322,62832,Tubersent,594,575,19
32,62,216208330,62833,Vacquerie-le-Boucq,77,75,2
32,62,216208348,62834,Vacqueriette-Erquières,256,252,4
32,62,216208355,62835,Valhuon,568,551,17
32,62,216208363,62836,Vaudricourt,1098,1079,19
32,62,216208371,62837,Vaudringhem,509,501,8
32,62,216208389,62838,Vaulx,93,90,3
32,62,216208397,62839,Vaulx-Vraucourt,1055,1047,8
32,62,216208405,62840,Vélu,132,132,0
32,62,216208413,62841,Vendin-lès-Béthune,2437,2413,24
32,62,216208421,62842,Vendin-le-Vieil,8465,8419,46
32,62,216208439,62843,Verchin,235,233,2
32,62,216208447,62844,Verchocq,645,631,14
32,62,216208454,62845,Verlincthun,506,502,4
32,62,216208462,62846,Vermelles,4809,4767,42
32,62,216208470,62847,Verquigneul,2045,2021,24
32,62,216208488,62848,Verquin,3514,3477,37
32,62,216208496,62849,Verton,2565,2510,55
32,62,216208504,62850,Vieil-Hesdin,350,344,6
32,62,216208512,62851,Vieille-Chapelle,850,833,17
32,62,216208520,62852,Vieille-Église,1451,1440,11
32,62,216208538,62853,Vieil-Moutier,386,376,10
32,62,216208546,62854,Villers-au-Bois,623,614,9
32,62,216208553,62855,Villers-au-Flos,247,246,1
32,62,216208561,62856,Villers-Brûlin,371,368,3
32,62,216208579,62857,Villers-Châtel,139,130,9
32,62,216208587,62858,Villers-lès-Cagnicourt,261,256,5
32,62,216208595,62859,Villers-l'Hôpital,264,260,4
32,62,216208603,62860,Villers-Sir-Simon,129,126,3
32,62,216208611,62861,Vimy,4390,4332,58
32,62,216208629,62862,Vincly,157,154,3
32,62,216208637,62863,Violaines,3843,3814,29
32,62,216208645,62864,Vis-en-Artois,659,644,15
32,62,216208652,62865,Vitry-en-Artois,4781,4732,49
32,62,216208660,62866,Waben,450,435,15
32,62,216208678,62867,Wacquinghen,271,264,7
32,62,216208686,62868,Wail,263,257,6
32,62,216208694,62869,Wailly,1109,1076,33
32,62,216208702,62870,Wailly-Beaucamp,1067,1041,26
32,62,216208710,62871,Wambercourt,262,261,1
32,62,216208728,62872,Wamin,238,233,5
32,62,216208736,62873,Wancourt,647,637,10
32,62,216208744,62874,Wanquetin,731,716,15
32,62,216208751,62875,Wardrecques,1372,1354,18
32,62,216208769,62876,Warlencourt-Eaucourt,134,132,2
32,62,216208777,62877,Warlincourt-lès-Pas,161,156,5
32,62,216208785,62878,Warlus,389,382,7
32,62,216208793,62879,Warluzel,227,224,3
32,62,216208801,62880,Le Wast,201,198,3
32,62,216208819,62881,Beauvoir-Wavans,383,374,9
32,62,216208827,62882,Wavrans-sur-l'Aa,1273,1240,33
32,62,216208835,62883,Wavrans-sur-Ternoise,197,195,2
32,62,216208850,62885,Westrehem,255,253,2
32,62,216208868,62886,Wicquinghem,274,271,3
32,62,216208876,62887,Widehem,246,245,1
32,62,216208884,62888,Wierre-au-Bois,235,226,9
32,62,216208892,62889,Wierre-Effroy,886,867,19
32,62,216208900,62890,Willeman,186,183,3
32,62,216208918,62891,Willencourt,141,137,4
32,62,216208926,62892,Willerval,667,657,10
32,62,216208934,62893,Wimereux,6475,6311,164
32,62,216208942,62894,Wimille,3989,3937,52
32,62,216208959,62895,Wingles,8797,8750,47
32,62,216208967,62896,Wirwignes,768,748,20
32,62,216208975,62897,Wismes,521,512,9
32,62,216208983,62898,Wisques,233,224,9
32,62,216208991,62899,Wissant,866,850,16
32,62,216209007,62900,Witternesse,614,599,15
32,62,216209015,62901,Wittes,1012,999,13
32,62,216209023,62902,Wizernes,3349,3308,41
32,62,216209031,62903,Zoteux,622,609,13
32,62,216209049,62904,Zouafques,605,596,9
32,62,216209056,62905,Zudausques,1083,1033,50
32,62,216209064,62906,Zutkerque,1799,1788,11
32,62,216209072,62907,Libercourt,8271,8230,41
32,62,216209080,62908,La Capelle-lès-Boulogne,1648,1610,38
32,62,216209098,62909,Ytres,438,433,5
84,63,216300012,63001,Aigueperse,2804,2770,34
84,63,216300020,63002,Aix-la-Fayette,99,96,3
84,63,216300038,63003,Ambert,6877,6636,241
84,63,216300046,63004,Les Ancizes-Comps,1736,1705,31
84,63,216300053,63005,Antoingt,416,411,5
84,63,216300061,63006,Anzat-le-Luguet,175,173,2
84,63,216300079,63007,Apchat,164,161,3
84,63,216300087,63008,Arconsat,596,585,11
84,63,216300095,63009,Ardes,603,598,5
84,63,216300103,63010,Arlanc,1841,1803,38
84,63,216300111,63011,Ars-les-Favets,232,219,13
84,63,216300129,63012,Artonne,936,918,18
84,63,216300137,63013,Aubiat,964,955,9
84,63,216300145,63014,Aubière,10756,10581,175
84,63,216300152,63015,Aubusson-d'Auvergne,225,223,2
84,63,216300160,63016,Augerolles,899,879,20
84,63,216300178,63017,Augnat,194,193,1
84,63,216300194,63019,Aulnat,4142,4103,39
84,63,216300202,63020,Aurières,382,369,13
84,63,216300210,63021,Authezat,695,680,15
84,63,216300228,63022,Auzat-la-Combelle,2010,1985,25
84,63,216300236,63023,Auzelles,391,381,10
84,63,216300244,63024,Avèze,177,174,3
84,63,216300251,63025,Ayat-sur-Sioule,142,137,5
84,63,216300269,63026,Aydat,2556,2511,45
84,63,216300277,63027,Baffie,112,111,1
84,63,216300285,63028,Bagnols,417,405,12
84,63,216300293,63029,Bansat,264,261,3
84,63,216300301,63030,Bas-et-Lezat,346,342,4
84,63,216300319,63031,Beaulieu,482,477,5
84,63,216300327,63032,Beaumont,10848,10630,218
84,63,216300335,63033,Beaumont-lès-Randan,313,310,3
84,63,216300343,63034,Beauregard-l'Évêque,1572,1547,25
84,63,216300350,63035,Beauregard-Vendon,1288,1269,19
84,63,216300368,63036,Bergonne,324,320,4
84,63,216300376,63037,Bertignat,468,455,13
84,63,216300384,63038,Besse-et-Saint-Anastaise,1543,1476,67
84,63,216300392,63039,Beurières,295,285,10
84,63,216300400,63040,Billom,4885,4790,95
84,63,216300418,63041,Biollet,328,319,9
84,63,216300426,63042,Blanzat,3834,3795,39
84,63,216300434,63043,Blot-l'Église,449,445,4
84,63,216300442,63044,Bongheat,434,427,7
84,63,216300459,63045,Bort-l'Étang,722,705,17
84,63,216300467,63046,Boudes,287,282,5
84,63,216300475,63047,La Bourboule,1790,1757,33
84,63,216300483,63048,Bourg-Lastic,884,867,17
84,63,216300491,63049,Bouzel,736,730,6
84,63,216300509,63050,Brassac-les-Mines,3506,3373,133
84,63,216300517,63051,Brenat,642,629,13
84,63,216300525,63052,Le Breuil-sur-Couze,1134,1046,88
84,63,216300533,63053,Briffons,269,262,7
84,63,216300541,63054,Le Broc,677,661,16
84,63,216300558,63055,Bromont-Lamothe,1008,994,14
84,63,216300566,63056,Brousse,334,330,4
84,63,216300574,63057,Le Brugeron,249,243,6
84,63,216300582,63058,Bulhon,560,550,10
84,63,216300590,63059,Busséol,223,218,5
84,63,216300608,63060,Bussières,97,96,1
84,63,216300616,63061,Bussières-et-Pruns,488,481,7
84,63,216300624,63062,Buxières-sous-Montaigut,237,235,2
84,63,216300632,63063,Cébazat,9075,8951,124
84,63,216300640,63064,La Celle,79,79,0
84,63,216300657,63065,Ceilloux,174,172,2
84,63,216300665,63066,Celles-sur-Durolle,1675,1646,29
84,63,216300673,63067,La Cellette,164,162,2
84,63,216300699,63069,Le Cendre,5578,5525,53
84,63,216300707,63070,Ceyrat,6473,6338,135
84,63,216300715,63071,Ceyssat,704,691,13
84,63,216300723,63072,Chabreloche,1203,1189,14
84,63,216300731,63073,Chadeleuf,447,434,13
84,63,216300749,63074,Chalus,182,182,0
84,63,216300756,63075,Chamalières,17756,17196,560
84,63,216300764,63076,Chambon-sur-Dolore,146,143,3
84,63,216300772,63077,Chambon-sur-Lac,431,418,13
84,63,216300798,63079,Champagnat-le-Jeune,153,151,2
84,63,216300806,63080,Champeix,1447,1424,23
84,63,216300814,63081,Champétières,279,275,4
84,63,216300822,63082,Champs,411,403,8
84,63,216300830,63083,Chanat-la-Mouteyre,960,932,28
84,63,216300848,63084,Chanonat,1750,1712,38
84,63,216300855,63085,Chapdes-Beaufort,1144,1136,8
84,63,216300863,63086,La Chapelle-Agnon,345,332,13
84,63,216300871,63087,La Chapelle-Marcousse,69,68,1
84,63,216300889,63088,La Chapelle-sur-Usson,84,84,0
84,63,216300897,63089,Chappes,1661,1632,29
84,63,216300905,63090,Chaptuzat,516,509,7
84,63,216300913,63091,Charbonnier-les-Mines,935,919,16
84,63,216300921,63092,Charbonnières-les-Varennes,1868,1840,28
84,63,216300939,63093,Charbonnières-les-Vieilles,1167,1145,22
84,63,216300947,63094,Charensat,485,480,5
84,63,216300954,63095,Charnat,209,206,3
84,63,216300962,63096,Chas,389,381,8
84,63,216300970,63097,Chassagne,82,80,2
84,63,216300988,63098,Chastreix,232,227,5
84,63,216300996,63099,Châteaugay,3156,3104,52
84,63,216301002,63100,Châteauneuf-les-Bains,331,328,3
84,63,216301010,63101,Château-sur-Cher,70,68,2
84,63,216301028,63102,Châteldon,791,776,15
84,63,216301036,63103,Châtel-Guyon,6461,6283,178
84,63,216301044,63104,La Chaulme,118,113,5
84,63,216301051,63105,Chaumont-le-Bourg,234,228,6
84,63,216301069,63106,Chauriat,1747,1731,16
84,63,216301077,63107,Chavaroux,526,516,10
84,63,216301085,63108,Le Cheix,699,681,18
84,63,216301093,63109,Chidrac,544,531,13
84,63,216301101,63110,Cisternes-la-Forêt,471,464,7
84,63,216301119,63111,Clémensat,125,120,5
84,63,216301127,63112,Clerlande,645,627,18
84,63,216301135,63113,Clermont-Ferrand,149898,147284,2614
84,63,216301143,63114,Collanges,159,157,2
84,63,216301150,63115,Combrailles,223,218,5
84,63,216301168,63116,Combronde,2179,2143,36
84,63,216301176,63117,Compains,131,127,4
84,63,216301184,63118,Condat-en-Combraille,417,410,7
84,63,216301192,63119,Condat-lès-Montboissier,235,228,7
84,63,216301200,63120,Corent,775,766,9
84,63,216301218,63121,Coudes,1287,1273,14
84,63,216301226,63122,Courgoul,62,61,1
84,63,216301234,63123,Cournols,239,233,6
84,63,216301242,63124,Cournon-d'Auvergne,20712,20356,356
84,63,216301259,63125,Courpière,4148,4005,143
84,63,216301267,63126,Le Crest,1301,1279,22
84,63,216301283,63128,Crevant-Laveine,983,968,15
84,63,216301291,63129,Cros,167,167,0
84,63,216301309,63130,La Crouzille,269,259,10
84,63,216301317,63131,Culhat,1158,1139,19
84,63,216301325,63132,Cunlhat,1342,1319,23
84,63,216301341,63134,Dauzat-sur-Vodable,71,68,3
84,63,216301358,63135,Davayat,612,606,6
84,63,216301366,63136,Domaize,390,382,8
84,63,216301374,63137,Doranges,177,174,3
84,63,216301382,63138,Dorat,735,725,10
84,63,216301390,63139,Dore-l'Église,668,660,8
84,63,216301408,63140,Durmignat,218,213,5
84,63,216301416,63141,Durtol,2109,2065,44
84,63,216301424,63142,Échandelys,261,249,12
84,63,216301432,63143,Effiat,1153,1134,19
84,63,216301440,63144,Égliseneuve-d'Entraigues,344,338,6
84,63,216301457,63145,Égliseneuve-des-Liards,158,153,5
84,63,216301465,63146,Égliseneuve-près-Billom,873,808,65
84,63,216301473,63147,Églisolles,277,272,5
84,63,216301481,63148,Ennezat,2591,2532,59
84,63,216301499,63149,Entraigues,709,697,12
84,63,216301507,63150,Enval,1578,1556,22
84,63,216301515,63151,Escoutoux,1387,1348,39
84,63,216301523,63152,Espinasse,290,286,4
84,63,216301531,63153,Espinchal,98,95,3
84,63,216301549,63154,Espirat,444,436,8
84,63,216301556,63155,Estandeuil,505,491,14
84,63,216301564,63156,Esteil,57,57,0
84,63,216301572,63157,Fayet-le-Château,379,372,7
84,63,216301580,63158,Fayet-Ronaye,111,107,4
84,63,216301598,63159,Fernoël,135,135,0
84,63,200056422,63160,Aulhat-Flat,963,930,33
84,63,216301614,63161,La Forie,331,319,12
84,63,216301622,63162,Fournols,325,315,10
84,63,216301630,63163,Gelles,1001,940,61
84,63,216301648,63164,Gerzat,10491,10395,96
84,63,216301655,63165,Giat,831,796,35
84,63,216301663,63166,Gignat,254,249,5
84,63,216301671,63167,Gimeaux,403,398,5
84,63,216301689,63168,Glaine-Montaigut,600,589,11
84,63,216301697,63169,La Godivelle,16,16,0
84,63,216301705,63170,La Goutelle,634,622,12
84,63,216301713,63171,Gouttières,339,326,13
84,63,216301721,63172,Grandeyrolles,54,53,1
84,63,216301739,63173,Grandrif,208,201,7
84,63,216301747,63174,Grandval,122,119,3
84,63,216301754,63175,Herment,238,230,8
84,63,216301762,63176,Heume-l'Église,111,108,3
84,63,216301770,63177,Isserteaux,420,412,8
84,63,216301788,63178,Issoire,15681,15297,384
84,63,216301796,63179,Job,1043,1013,30
84,63,216301804,63180,Joze,1163,1145,18
84,63,216301812,63181,Jozerand,562,549,13
84,63,216301820,63182,Jumeaux,580,566,14
84,63,216301838,63183,Labessette,68,67,1
84,63,216301846,63184,Lachaux,283,278,5
84,63,216301853,63185,Lamontgie,653,641,12
84,63,216301861,63186,Landogne,231,223,8
84,63,216301879,63187,Lapeyrouse,531,520,11
84,63,216301887,63188,Laps,602,586,16
84,63,216301895,63189,Laqueuille,378,364,14
84,63,216301903,63190,Larodde,288,284,4
84,63,216301911,63191,Lastic,105,102,3
84,63,216301929,63192,La Tour-d'Auvergne,662,629,33
84,63,216301937,63193,Lempdes,9105,8669,436
84,63,216301945,63194,Lempty,404,398,6
84,63,216301952,63195,Lezoux,6355,6287,68
84,63,216301960,63196,Limons,761,747,14
84,63,216301978,63197,Lisseuil,124,121,3
84,63,216301986,63198,Loubeyrat,1439,1418,21
84,63,216301994,63199,Ludesse,514,509,5
84,63,216302000,63200,Lussat,942,925,17
84,63,216302018,63201,Luzillat,1164,1145,19
84,63,216302026,63202,Madriat,119,117,2
84,63,216302034,63203,Malauzat,1178,1160,18
84,63,216302042,63204,Malintrat,1153,1134,19
84,63,216302059,63205,Manglieu,478,469,9
84,63,216302067,63206,Manzat,1416,1395,21
84,63,216302075,63207,Marat,825,814,11
84,63,216302083,63208,Marcillat,312,309,3
84,63,216302091,63209,Mareugheol,220,215,5
84,63,216302109,63210,Maringues,3165,3112,53
84,63,216302117,63211,Marsac-en-Livradois,1474,1434,40
84,63,216302125,63212,Marsat,1494,1456,38
84,63,216302133,63213,Les Martres-d'Artière,2207,2185,22
84,63,216302141,63214,Les Martres-de-Veyre,4004,3941,63
84,63,216302158,63215,Martres-sur-Morge,687,680,7
84,63,216302166,63216,Mauzun,118,116,2
84,63,216302182,63218,Mayres,203,197,6
84,63,216302190,63219,Mazaye,718,707,11
84,63,216302208,63220,Mazoires,99,96,3
84,63,216302216,63221,Medeyrolles,127,125,2
84,63,216302224,63222,Meilhaud,493,485,8
84,63,216302232,63223,Menat,549,536,13
84,63,216302240,63224,Ménétrol,1667,1643,24
84,63,216302257,63225,Messeix,1054,1034,20
84,63,200083921,63226,Mur-sur-Allier,3376,3313,63
84,63,216302273,63227,Mirefleurs,2410,2353,57
84,63,216302281,63228,Miremont,302,292,10
84,63,216302299,63229,Moissat,1267,1245,22
84,63,216302307,63230,Le Monestier,241,236,5
84,63,216302315,63231,La Monnerie-le-Montel,1699,1669,30
84,63,216302323,63232,Mons,567,553,14
84,63,216302331,63233,Montaigut-en-Combraille,992,985,7
84,63,216302349,63234,Montaigut-le-Blanc,919,891,28
84,63,216302356,63235,Montcel,552,546,6
84,63,216302364,63236,Mont-Dore,1292,1274,18
84,63,216302372,63237,Montel-de-Gelat,428,422,6
84,63,216302380,63238,Montfermy,230,229,1
84,63,216302398,63239,Montmorin,752,727,25
84,63,216302406,63240,Montpensier,474,466,8
84,63,216302414,63241,Montpeyroux,338,324,14
84,63,216302422,63242,Moriat,397,387,10
84,63,216302430,63243,Moureuille,391,385,6
84,63,200057818,63244,Chambaron sur Morge,1832,1805,27
84,63,216302455,63245,Mozac,3942,3874,68
84,63,216302463,63246,Murat-le-Quaire,506,488,18
84,63,216302471,63247,Murol,621,610,11
84,63,216302489,63248,Nébouzat,875,853,22
84,63,216302497,63249,Néronde-sur-Dore,520,510,10
84,63,216302505,63250,Neschers,873,855,18
84,63,216302513,63251,Neuf-Église,302,297,5
84,63,216302521,63252,Neuville,387,378,9
84,63,216302539,63253,Noalhat,237,235,2
84,63,216302547,63254,Nohanent,2258,2223,35
84,63,200053155,63255,Nonette-Orsonnette,615,599,16
84,63,216302562,63256,Novacelles,154,151,3
84,63,216302570,63257,Olby,850,840,10
84,63,216302588,63258,Olliergues,770,750,20
84,63,216302596,63259,Olloix,321,312,9
84,63,216302604,63260,Olmet,161,156,5
84,63,216302612,63261,Orbeil,883,859,24
84,63,216302620,63262,Orcet,2821,2781,40
84,63,216302638,63263,Orcines,3654,3545,109
84,63,216302646,63264,Orcival,248,247,1
84,63,216302653,63265,Orléat,2262,2218,44
84,63,216302679,63267,Palladuc,543,524,19
84,63,216302687,63268,Pardines,300,296,4
84,63,216302695,63269,Parent,902,887,15
84,63,216302703,63270,Parentignat,503,488,15
84,63,216302711,63271,Paslières,1518,1478,40
84,63,216302729,63272,Pérignat-lès-Sarliève,2770,2718,52
84,63,216302737,63273,Pérignat-sur-Allier,1527,1504,23
84,63,216302745,63274,Perpezat,441,426,15
84,63,216302752,63275,Perrier,910,890,20
84,63,216302760,63276,Peschadoires,2157,2115,42
84,63,216302778,63277,Peslières,62,61,1
84,63,216302786,63278,Pessat-Villeneuve,732,719,13
84,63,216302794,63279,Picherande,328,318,10
84,63,216302802,63280,Pignols,352,346,6
84,63,216302810,63281,Pionsat,1076,1057,19
84,63,216302828,63282,Plauzat,1780,1758,22
84,63,216302836,63283,Pontaumur,748,632,116
84,63,216302844,63284,Pont-du-Château,12641,12324,317
84,63,216302851,63285,Pontgibaud,750,746,4
84,63,216302869,63286,Pouzol,270,267,3
84,63,216302877,63287,Les Pradeaux,352,345,7
84,63,216302885,63288,Prompsat,470,458,12
84,63,216302893,63289,Prondines,272,265,7
84,63,216302901,63290,Pulvérières,410,402,8
84,63,216302919,63291,Puy-Guillaume,2783,2735,48
84,63,216302927,63292,Puy-Saint-Gulmier,148,145,3
84,63,216302935,63293,Le Quartier,225,215,10
84,63,216302943,63294,Queuille,293,288,5
84,63,216302950,63295,Randan,1632,1618,14
84,63,216302968,63296,Ravel,797,783,14
84,63,216302976,63297,Reignat,382,379,3
84,63,216302984,63298,La Renaudie,132,128,4
84,63,216302992,63299,Rentières,102,102,0
84,63,216303008,63300,Riom,19476,18733,743
84,63,216303016,63301,Ris,748,739,9
84,63,216303024,63302,La Roche-Blanche,3562,3498,64
84,63,216303032,63303,Roche-Charles-la-Mayrand,43,42,1
84,63,216303040,63304,Roche-d'Agoux,110,110,0
84,63,216303057,63305,Rochefort-Montagne,995,850,145
84,63,216303065,63306,La Roche-Noire,637,624,13
84,63,216303073,63307,Romagnat,7987,7833,154
84,63,216303081,63308,Royat,4514,4395,119
84,63,216303099,63309,Saillant,309,306,3
84,63,216303107,63310,Sainte-Agathe,173,170,3
84,63,216303115,63311,Saint-Agoulin,342,330,12
84,63,216303123,63312,Saint-Alyre-d'Arlanc,144,141,3
84,63,216303131,63313,Saint-Alyre-ès-Montagne,114,107,7
84,63,216303149,63314,Saint-Amant-Roche-Savine,527,513,14
84,63,216303156,63315,Saint-Amant-Tallende,1790,1752,38
84,63,216303172,63317,Saint-André-le-Coq,537,535,2
84,63,216303180,63318,Saint-Angel,473,464,9
84,63,216303198,63319,Saint-Anthème,730,707,23
84,63,216303206,63320,Saint-Avit,219,213,6
84,63,216303214,63321,Saint-Babel,949,933,16
84,63,216303222,63322,Saint-Beauzire,2242,2214,28
84,63,216303230,63323,Saint-Bonnet-le-Bourg,173,169,4
84,63,216303248,63324,Saint-Bonnet-le-Chastel,210,204,6
84,63,216303255,63325,Saint-Bonnet-lès-Allier,426,420,6
84,63,216303263,63326,Saint-Bonnet-près-Orcival,541,533,8
84,63,216303271,63327,Saint-Bonnet-près-Riom,2072,2033,39
84,63,216303289,63328,Sainte-Catherine,53,51,2
84,63,216303297,63329,Sainte-Christine,132,127,5
84,63,216303305,63330,Saint-Cirgues-sur-Couze,358,351,7
84,63,216303313,63331,Saint-Clément-de-Valorgue,239,233,6
84,63,216303321,63332,Saint-Clément-de-Régnat,539,530,9
84,63,216303339,63333,Saint-Denis-Combarnazat,239,236,3
84,63,216303347,63334,Saint-Dier-d'Auvergne,563,544,19
84,63,200085686,63335,Saint-Diéry,546,530,16
84,63,216303362,63336,Saint-Donat,204,200,4
84,63,216303370,63337,Saint-Éloy-la-Glacière,65,64,1
84,63,216303388,63338,Saint-Éloy-les-Mines,3636,3492,144
84,63,216303396,63339,Saint-Étienne-des-Champs,132,130,2
84,63,216303404,63340,Saint-Étienne-sur-Usson,260,257,3
84,63,216303412,63341,Saint-Ferréol-des-Côtes,565,549,16
84,63,216303420,63342,Saint-Floret,250,246,4
84,63,216303438,63343,Saint-Flour-l'Étang,283,277,6
84,63,216303446,63344,Saint-Gal-sur-Sioule,153,149,4
84,63,216303453,63345,Saint-Genès-Champanelle,3897,3791,106
84,63,216303461,63346,Saint-Genès-Champespe,223,216,7
84,63,216303479,63347,Saint-Genès-du-Retz,479,461,18
84,63,216303487,63348,Saint-Genès-la-Tourette,183,182,1
84,63,216303495,63349,Saint-Georges-de-Mons,1962,1914,48
84,63,216303503,63350,Saint-Georges-sur-Allier,1325,1307,18
84,63,216303511,63351,Saint-Germain-près-Herment,68,66,2
84,63,216303529,63352,Saint-Germain-Lembron,2054,2012,42
84,63,216303537,63353,Saint-Germain-l'Herm,515,485,30
84,63,216303545,63354,Saint-Gervais-d'Auvergne,1402,1239,163
84,63,216303552,63355,Saint-Gervais-sous-Meymont,222,218,4
84,63,216303560,63356,Saint-Gervazy,349,335,14
84,63,216303578,63357,Saint-Hérent,118,114,4
84,63,216303586,63358,Saint-Hilaire-la-Croix,374,364,10
84,63,216303594,63359,Saint-Hilaire-les-Monges,86,86,0
84,63,216303602,63360,Saint-Hilaire,153,150,3
84,63,216303628,63362,Saint-Ignat,936,921,15
84,63,216303636,63363,Saint-Jacques-d'Ambur,290,282,8
84,63,216303644,63364,Saint-Jean-d'Heurs,690,675,15
84,63,216303651,63365,Saint-Jean-des-Ollières,435,423,12
84,63,216303669,63366,Saint-Jean-en-Val,354,352,2
84,63,216303677,63367,Saint-Jean-Saint-Gervais,126,125,1
84,63,216303685,63368,Saint-Julien-de-Coppel,1339,1309,30
84,63,216303693,63369,Saint-Julien-la-Geneste,123,120,3
84,63,216303701,63370,Saint-Julien-Puy-Lavèze,373,368,5
84,63,216303719,63371,Saint-Just,157,152,5
84,63,216303727,63372,Saint-Laure,674,667,7
84,63,216303735,63373,Saint-Maigner,193,189,4
84,63,216303743,63374,Saint-Martin-des-Olmes,298,295,3
84,63,216303750,63375,Saint-Martin-des-Plains,176,170,6
84,63,216303768,63376,Saint-Martin-d'Ollières,153,147,6
84,63,216303776,63377,Saint-Maurice-près-Pionsat,378,372,6
84,63,216303784,63378,Saint-Maurice,972,963,9
84,63,216303792,63379,Saint-Myon,534,528,6
84,63,216303800,63380,Saint-Nectaire,768,765,3
84,63,216303818,63381,Saint-Ours,1688,1665,23
84,63,216303826,63382,Saint-Pardoux,419,406,13
84,63,216303834,63383,Saint-Pierre-Colamine,255,250,5
84,63,216303842,63384,Saint-Pierre-la-Bourlhonne,139,134,5
84,63,216303859,63385,Saint-Pierre-le-Chastel,453,442,11
84,63,216303867,63386,Saint-Pierre-Roche,500,494,6
84,63,216303875,63387,Saint-Priest-Bramefant,882,866,16
84,63,216303883,63388,Saint-Priest-des-Champs,719,703,16
84,63,216303891,63389,Saint-Quentin-sur-Sauxillanges,112,110,2
84,63,216303909,63390,Saint-Quintin-sur-Sioule,399,386,13
84,63,216303917,63391,Saint-Rémy-de-Blot,246,242,4
84,63,216303925,63392,Saint-Rémy-de-Chargnat,602,595,7
84,63,216303933,63393,Saint-Rémy-sur-Durolle,1786,1753,33
84,63,216303941,63394,Saint-Romain,210,204,6
84,63,216303958,63395,Saint-Sandoux,1001,980,21
84,63,216303966,63396,Saint-Saturnin,1222,1160,62
84,63,216303974,63397,Saint-Sauves-d'Auvergne,1148,1127,21
84,63,216303982,63398,Saint-Sauveur-la-Sagne,88,85,3
84,63,216303990,63399,Saint-Sulpice,88,84,4
84,63,216304006,63400,Saint-Sylvestre-Pragoulin,1092,1069,23
84,63,216304014,63401,Saint-Victor-la-Rivière,256,249,7
84,63,216304022,63402,Saint-Victor-Montvianeix,262,255,7
84,63,216304030,63403,Saint-Vincent,427,416,11
84,63,216304048,63404,Saint-Yvoine,605,590,15
84,63,216304055,63405,Sallèdes,595,582,13
84,63,216304063,63406,Sardon,303,297,6
84,63,216304071,63407,Saulzet-le-Froid,291,284,7
84,63,216304089,63408,Sauret-Besserve,172,167,5
84,63,216304097,63409,Saurier,269,269,0
84,63,216304105,63410,Sauvagnat,146,143,3
84,63,216304113,63411,Sauvagnat-Sainte-Marthe,487,472,15
84,63,216304121,63412,Sauvessanges,540,530,10
84,63,216304139,63413,La Sauvetat,717,706,11
84,63,216304147,63414,Sauviat,574,563,11
84,63,216304154,63415,Sauxillanges,1324,1311,13
84,63,216304162,63416,Savennes,95,93,2
84,63,216304170,63417,Sayat,2518,2472,46
84,63,216304188,63418,Sermentizon,585,576,9
84,63,216304196,63419,Servant,569,557,12
84,63,216304204,63420,Seychalles,800,791,9
84,63,216304212,63421,Singles,161,157,4
84,63,216304220,63422,Solignat,528,518,10
84,63,216304238,63423,Sugères,609,601,8
84,63,216304246,63424,Surat,601,591,10
84,63,216304253,63425,Tallende,1544,1502,42
84,63,216304261,63426,Tauves,737,719,18
84,63,216304279,63427,Teilhède,509,493,16
84,63,216304287,63428,Teilhet,284,282,2
84,63,216304295,63429,Ternant-les-Eaux,31,29,2
84,63,216304303,63430,Thiers,11841,11470,371
84,63,216304311,63431,Thiolières,163,162,1
84,63,216304329,63432,Thuret,957,920,37
84,63,216304337,63433,Tortebesse,79,76,3
84,63,216304345,63434,Tours-sur-Meymont,537,522,15
84,63,216304352,63435,Tourzel-Ronzières,206,200,6
84,63,216304360,63436,Tralaigues,72,72,0
84,63,216304378,63437,Trémouille-Saint-Loup,158,153,5
84,63,216304386,63438,Trézioux,497,489,8
84,63,216304394,63439,Usson,303,301,2
84,63,216304402,63440,Valbeleix,132,132,0
84,63,216304410,63441,Valcivières,219,215,4
84,63,216304428,63442,Valz-sous-Châteauneuf,55,53,2
84,63,216304436,63443,Varennes-sur-Morge,436,424,12
84,63,216304444,63444,Varennes-sur-Usson,312,308,4
84,63,216304451,63445,Vassel,304,300,4
84,63,216304469,63446,Vensat,534,528,6
84,63,216304477,63447,Vergheas,71,66,5
84,63,200085033,63448,Le Vernet-Chaméane,877,792,85
84,63,216304493,63449,Le Vernet-Sainte-Marguerite,319,311,8
84,63,216304501,63450,Verneugheol,235,233,2
84,63,216304519,63451,Vernines,434,417,17
84,63,216304527,63452,Verrières,73,72,1
84,63,216304535,63453,Vertaizon,3330,3301,29
84,63,216304543,63454,Vertolaye,551,540,11
84,63,216304550,63455,Veyre-Monton,3723,3664,59
84,63,216304568,63456,Vichel,352,338,14
84,63,216304576,63457,Vic-le-Comte,5283,5188,95
84,63,216304584,63458,Villeneuve,147,146,1
84,63,216304592,63459,Villeneuve-les-Cerfs,524,519,5
84,63,216304600,63460,Villossanges,380,369,11
84,63,216304618,63461,Vinzelles,366,363,3
84,63,216304626,63462,Virlet,271,266,5
84,63,216304634,63463,Viscomtat,520,511,9
84,63,216304642,63464,Vitrac,356,343,13
84,63,216304659,63465,Viverols,427,418,9
84,63,216304667,63466,Vodable,196,193,3
84,63,216304675,63467,Voingt,41,39,2
84,63,216304683,63468,Vollore-Montagne,314,304,10
84,63,216304691,63469,Vollore-Ville,732,715,17
84,63,216304709,63470,Volvic,4778,4702,76
84,63,216304717,63471,Youx,914,895,19
84,63,216304725,63472,Yronde-et-Buron,665,649,16
84,63,216304733,63473,Yssac-la-Tourette,400,393,7
75,64,216400010,64001,Aast,195,188,7
75,64,216400028,64002,Abère,166,165,1
75,64,216400036,64003,Abidos,220,212,8
75,64,216400044,64004,Abitain,108,107,1
75,64,216400051,64005,Abos,545,537,8
75,64,216400069,64006,Accous,471,459,12
75,64,216405803,64007,Agnos,1066,1039,27
75,64,216400085,64008,Ahaxe-Alciette-Bascassan,275,266,9
75,64,216400093,64009,Ahetze,2057,2027,30
75,64,216400101,64010,Aïcirits-Camou-Suhast,701,678,23
75,64,216400119,64011,Aincille,121,115,6
75,64,216400127,64012,Ainharp,137,133,4
75,64,216400135,64013,Ainhice-Mongelos,177,172,5
75,64,216400143,64014,Ainhoa,675,668,7
75,64,216400150,64015,Alçay-Alçabéhéty-Sunharette,211,209,2
75,64,216400168,64016,Aldudes,330,324,6
75,64,216400176,64017,Alos-Sibas-Abense,338,334,4
75,64,216400184,64018,Amendeuix-Oneix,464,455,9
75,64,216400192,64019,Amorots-Succos,234,233,1
75,64,216400218,64021,Andoins,698,675,23
75,64,216400226,64022,Andrein,141,138,3
75,64,216400234,64023,Angaïs,931,908,23
75,64,216400242,64024,Anglet,41388,40310,1078
75,64,216400259,64025,Angous,100,95,5
75,64,216400267,64026,Anhaux,387,376,11
75,64,216400275,64027,Anos,191,188,3
75,64,216400283,64028,Anoye,134,132,2
75,64,216400291,64029,Aramits,677,662,15
75,64,216405878,64031,Arancou,180,177,3
75,64,216400325,64032,Araujuzon,186,178,8
75,64,216400333,64033,Araux,134,133,1
75,64,216400341,64034,Arbérats-Sillègue,322,317,5
75,64,216400358,64035,Arbonne,2403,2339,64
75,64,216400366,64036,Arbouet-Sussaute,320,314,6
75,64,216400374,64037,Arbus,1277,1254,23
75,64,216400382,64038,Arcangues,3394,3326,68
75,64,216400390,64039,Aren,253,245,8
75,64,216400408,64040,Arette,1104,1071,33
75,64,216400416,64041,Aressy,809,796,13
75,64,216400424,64042,Argagnon,711,702,9
75,64,216400432,64043,Argelos,300,296,4
75,64,216400440,64044,Arget,80,79,1
75,64,216400457,64045,Arhansus,74,74,0
75,64,216400465,64046,Armendarits,395,390,5
75,64,216400473,64047,Arnéguy,239,237,2
75,64,216400481,64048,Arnos,135,134,1
75,64,216400499,64049,Aroue-Ithorots-Olhaïby,239,231,8
75,64,216400507,64050,Arrast-Larrebieu,97,94,3
75,64,216400515,64051,Arraute-Charritte,422,417,5
75,64,216400523,64052,Arricau-Bordes,111,107,4
75,64,216400531,64053,Arrien,195,192,3
75,64,216400549,64054,Arros-de-Nay,802,783,19
75,64,216400564,64056,Arrosès,147,138,9
75,64,216400572,64057,Arthez-de-Béarn,1870,1829,41
75,64,216400580,64058,Arthez-d'Asson,474,464,10
75,64,216400598,64059,Artigueloutan,1105,1077,28
75,64,216400606,64060,Artiguelouve,2037,1982,55
75,64,216400614,64061,Artix,3496,3434,62
75,64,216400622,64062,Arudy,2300,2253,47
75,64,216400630,64063,Arzacq-Arraziguet,1074,1054,20
75,64,216400648,64064,Asasp-Arros,454,445,9
75,64,216400655,64065,Ascain,4483,4368,115
75,64,216400663,64066,Ascarat,344,334,10
75,64,216400671,64067,Assat,2073,2025,48
75,64,216400689,64068,Asson,2047,1998,49
75,64,216400697,64069,Aste-Béon,236,230,6
75,64,216400705,64070,Astis,323,321,2
75,64,216400713,64071,Athos-Aspis,213,210,3
75,64,216400721,64072,Aubertin,663,649,14
75,64,216400739,64073,Aubin,269,264,5
75,64,216400747,64074,Aubous,45,44,1
75,64,216400754,64075,Audaux,166,165,1
75,64,216400770,64077,Auga,179,176,3
75,64,216400788,64078,Auriac,232,226,6
75,64,216400796,64079,Aurions-Idernes,104,101,3
75,64,216400804,64080,Aussevielle,829,805,24
75,64,216400812,64081,Aussurucq,241,238,3
75,64,216400820,64082,Auterrive,144,141,3
75,64,216400838,64083,Autevielle-Saint-Martin-Bideren,204,201,3
75,64,216400846,64084,Aydie,143,141,2
75,64,216400853,64085,Aydius,107,106,1
75,64,216400861,64086,Ayherre,1154,1120,34
75,64,216400879,64087,Baigts-de-Béarn,887,866,21
75,64,216400887,64088,Balansun,314,305,9
75,64,216400895,64089,Baleix,143,139,4
75,64,216400903,64090,Baliracq-Maumusson,122,120,2
75,64,216400911,64091,Baliros,510,503,7
75,64,216400929,64092,Banca,355,348,7
75,64,216400937,64093,Barcus,645,640,5
75,64,216400945,64094,Bardos,1886,1838,48
75,64,216400952,64095,Barinque,604,592,12
75,64,216400960,64096,Barraute-Camu,181,179,2
75,64,216400978,64097,Barzun,629,618,11
75,64,216400986,64098,Bassillon-Vauzé,67,65,2
75,64,216400994,64099,Bastanès,101,97,4
75,64,216401000,64100,Bassussarry,3356,3261,95
75,64,216401018,64101,Baudreix,683,575,108
75,64,216401026,64102,Bayonne,53296,52006,1290
75,64,216401034,64103,Bédeille,210,207,3
75,64,216401042,64104,Bedous,605,592,13
75,64,216401059,64105,Béguios,281,269,12
75,64,216401067,64106,Béhasque-Lapiste,524,514,10
75,64,216401075,64107,Béhorléguy,74,71,3
75,64,216405886,64108,Bellocq,923,913,10
75,64,216401091,64109,Bénéjacq,1995,1951,44
75,64,216401109,64110,Béost,223,221,2
75,64,216401117,64111,Bentayou-Sérée,112,109,3
75,64,216401125,64112,Bérenx,427,423,4
75,64,216401133,64113,Bergouey-Viellenave,123,116,7
75,64,216401141,64114,Bernadets,588,586,2
75,64,216401158,64115,Berrogain-Laruns,227,160,67
75,64,216401166,64116,Bescat,250,245,5
75,64,216401174,64117,Bésingrand,149,145,4
75,64,216401182,64118,Bétracq,50,50,0
75,64,216401190,64119,Beuste,685,674,11
75,64,216401208,64120,Beyrie-sur-Joyeuse,549,538,11
75,64,216401216,64121,Beyrie-en-Béarn,193,191,2
75,64,216401224,64122,Biarritz,26583,25885,698
75,64,216401232,64123,Bidache,1378,1353,25
75,64,216401240,64124,Bidarray,677,662,15
75,64,216401257,64125,Bidart,7354,7224,130
75,64,216401265,64126,Bidos,1142,1109,33
75,64,216401273,64127,Bielle,404,390,14
75,64,216401281,64128,Bilhères,164,159,5
75,64,216401299,64129,Billère,13449,13229,220
75,64,216401307,64130,Biriatou,1251,1231,20
75,64,216401315,64131,Biron,638,617,21
75,64,216401323,64132,Bizanos,4647,4522,125
75,64,216401331,64133,Boeil-Bezing,1365,1342,23
75,64,216401349,64134,Bonloc,376,369,7
75,64,216401356,64135,Bonnut,827,813,14
75,64,216401364,64136,Borce,131,129,2
75,64,216401372,64137,Bordères,693,673,20
75,64,216401380,64138,Bordes,2939,2888,51
75,64,216401398,64139,Bosdarros,999,976,23
75,64,216401406,64140,Boucau,8935,8764,171
75,64,216401414,64141,Boueilh-Boueilho-Lasque,395,386,9
75,64,216401422,64142,Bougarber,862,835,27
75,64,216401430,64143,Bouillon,157,157,0
75,64,216401448,64144,Boumourt,169,167,2
75,64,216401455,64145,Bourdettes,520,512,8
75,64,216401463,64146,Bournos,341,337,4
75,64,216401471,64147,Briscous,2927,2882,45
75,64,216401489,64148,Bruges-Capbis-Mifaget,887,862,25
75,64,216401497,64149,Bugnein,251,245,6
75,64,216401505,64150,Bunus,135,133,2
75,64,216401513,64151,Burgaronne,104,99,5
75,64,216401521,64152,Buros,1994,1940,54
75,64,216401539,64153,Burosse-Mendousse,73,72,1
75,64,216401547,64154,Bussunarits-Sarrasquette,210,208,2
75,64,216401554,64155,Bustince-Iriberry,106,105,1
75,64,216401562,64156,Buziet,488,474,14
75,64,216401570,64157,Buzy,1017,996,21
75,64,216401588,64158,Cabidos,180,173,7
75,64,216401596,64159,Cadillon,123,119,4
75,64,216401604,64160,Cambo-les-Bains,6731,6623,108
75,64,216401612,64161,Came,1037,1017,20
75,64,216401620,64162,Camou-Cihigue,104,101,3
75,64,216401653,64165,Cardesse,309,299,10
75,64,216401661,64166,Caro,196,187,9
75,64,216401679,64167,Carrère,219,217,2
75,64,216401687,64168,Carresse-Cassaber,679,664,15
75,64,216401703,64170,Castagnède,202,201,1
75,64,216401711,64171,Casteide-Cami,268,266,2
75,64,216401729,64172,Casteide-Candau,315,312,3
75,64,216401737,64173,Casteide-Doat,162,161,1
75,64,216401745,64174,Castéra-Loubix,52,51,1
75,64,216401752,64175,Castet,154,150,4
75,64,216401760,64176,Castetbon,162,159,3
75,64,216401778,64177,Castétis,662,636,26
75,64,216401786,64178,Castetnau-Camblong,478,463,15
75,64,216405845,64179,Castetner,140,134,6
75,64,216401802,64180,Castetpugon,214,209,5
75,64,216401810,64181,Castillon (Canton d'Arthez-de-Béarn),339,335,4
75,64,216401828,64182,Castillon (Canton de Lembeye),73,71,2
75,64,216401836,64183,Caubios-Loos,645,626,19
75,64,216401844,64184,Cescau,647,619,28
75,64,216401851,64185,Cette-Eygun,61,60,1
75,64,216401869,64186,Charre,221,218,3
75,64,216401877,64187,Charritte-de-Bas,259,251,8
75,64,216401885,64188,Chéraute,1225,1067,158
75,64,216401893,64189,Ciboure,6241,6109,132
75,64,216401901,64190,Claracq,249,240,9
75,64,216401919,64191,Coarraze,2309,2168,141
75,64,216401927,64192,Conchez-de-Béarn,111,111,0
75,64,216401935,64193,Corbère-Abères,99,97,2
75,64,216401943,64194,Coslédaà-Lube-Boast,386,376,10
75,64,216401950,64195,Coublucq,94,92,2
75,64,216401968,64196,Crouseilles,123,120,3
75,64,216401976,64197,Cuqueron,194,189,5
75,64,216401984,64198,Denguin,1825,1775,50
75,64,216401992,64199,Diusse,145,141,4
75,64,216402008,64200,Doazon,181,178,3
75,64,216402016,64201,Dognen,237,229,8
75,64,216402024,64202,Domezain-Berraute,477,464,13
75,64,216402032,64203,Doumy,328,322,6
75,64,216402040,64204,Eaux-Bonnes,194,191,3
75,64,216402057,64205,Escos,239,237,2
75,64,216402065,64206,Escot,123,122,1
75,64,216402073,64207,Escou,440,428,12
75,64,216402081,64208,Escoubès,435,427,8
75,64,216402099,64209,Escout,443,435,8
75,64,216402107,64210,Escurès,144,143,1
75,64,216402115,64211,Eslourenties-Daban,373,369,4
75,64,216402123,64212,Espéchède,143,141,2
75,64,216402131,64213,Espelette,2084,2036,48
75,64,216402149,64214,Espès-Undurein,505,490,15
75,64,216402156,64215,Espiute,107,104,3
75,64,216402164,64216,Espoey,1242,1195,47
75,64,216402172,64217,Esquiule,548,536,12
75,64,216402180,64218,Estérençuby,321,319,2
75,64,216402198,64219,Estialescq,265,259,6
75,64,216402206,64220,Estos,506,495,11
75,64,216402214,64221,Etcharry,183,154,29
75,64,216402222,64222,Etchebar,75,75,0
75,64,216402230,64223,Etsaut,57,55,2
75,64,216402248,64224,Eysus,650,632,18
75,64,200064350,64225,Ance Féas,629,615,14
75,64,216402263,64226,Fichous-Riumayou,188,186,2
75,64,216402271,64227,Gabaston,681,667,14
75,64,216402289,64228,Gabat,275,273,2
75,64,216402297,64229,Gamarthe,135,130,5
75,64,216402305,64230,Gan,5705,5594,111
75,64,216402313,64231,Garindein,494,485,9
75,64,216402321,64232,Garlède-Mondebat,222,220,2
75,64,216402339,64233,Garlin,1375,1351,24
75,64,216402347,64234,Garos,272,264,8
75,64,216402354,64235,Garris,300,293,7
75,64,216402362,64236,Gayon,56,55,1
75,64,216402370,64237,Gelos,3768,3639,129
75,64,216402388,64238,Ger,2056,2004,52
75,64,216402396,64239,Gerderest,139,138,1
75,64,216402404,64240,Gère-Bélesten,186,179,7
75,64,216402412,64241,Géronce,487,478,9
75,64,216402420,64242,Gestas,76,76,0
75,64,216402438,64243,Géus-d'Arzacq,206,203,3
75,64,216402446,64244,Geüs-d'Oloron,269,259,10
75,64,216402453,64245,Goès,565,552,13
75,64,216402461,64246,Gomer,308,301,7
75,64,216402479,64247,Gotein-Libarrenx,485,472,13
75,64,216402495,64249,Guéthary,1365,1328,37
75,64,216402503,64250,Guiche,1037,1006,31
75,64,216402511,64251,Guinarthe-Parenties,231,222,9
75,64,216405860,64252,Gurmençon,905,878,27
75,64,216402537,64253,Gurs,427,417,10
75,64,216402545,64254,Hagetaubin,595,578,17
75,64,216402552,64255,Halsou,643,637,6
75,64,216402560,64256,Hasparren,7808,7538,270
75,64,216402578,64257,Haut-de-Bosdarros,344,341,3
75,64,216402586,64258,Haux,86,85,1
75,64,216402594,64259,Hélette,763,747,16
75,64,216402602,64260,Hendaye,18071,17621,450
75,64,216402610,64261,Herrère,395,389,6
75,64,216402628,64262,Higuères-Souye,282,276,6
75,64,216402636,64263,L'Hôpital-d'Orion,132,128,4
75,64,216402644,64264,L'Hôpital-Saint-Blaise,61,59,2
75,64,216402651,64265,Hosta,100,100,0
75,64,216402669,64266,Hours,240,231,9
75,64,216402677,64267,Ibarrolle,76,75,1
75,64,216402685,64268,Idaux-Mendy,279,275,4
75,64,216402693,64269,Idron,5078,4915,163
75,64,216402701,64270,Igon,1035,986,49
75,64,216402719,64271,Iholdy,555,538,17
75,64,216402727,64272,Ilharre,148,147,1
75,64,216402735,64273,Irissarry,934,921,13
75,64,216402743,64274,Irouléguy,369,367,2
75,64,216402750,64275,Ispoure,687,674,13
75,64,216402768,64276,Issor,242,236,6
75,64,216402776,64277,Isturits,531,518,13
75,64,216402792,64279,Itxassou,2230,2163,67
75,64,216402800,64280,Izeste,438,435,3
75,64,216402818,64281,Jasses,149,146,3
75,64,216402826,64282,Jatxou,1206,1176,30
75,64,216402834,64283,Jaxu,202,201,1
75,64,216402842,64284,Jurançon,7320,7083,237
75,64,216402859,64285,Juxue,212,204,8
75,64,216402867,64286,Laà-Mondrans,450,437,13
75,64,216402875,64287,Laàs,142,139,3
75,64,216402883,64288,Labastide-Cézéracq,571,557,14
75,64,216402891,64289,La Bastide-Clairence,993,969,24
75,64,216402909,64290,Labastide-Monréjeau,616,599,17
75,64,216402917,64291,Labastide-Villefranche,324,318,6
75,64,216402925,64292,Labatmale,262,260,2
75,64,216402933,64293,Labatut-Figuières,171,169,2
75,64,216402941,64294,Labets-Biscay,156,154,2
75,64,216402958,64295,Labeyrie,114,111,3
75,64,216402966,64296,Lacadée,153,148,5
75,64,216402974,64297,Lacarre,183,179,4
75,64,216402982,64298,Lacarry-Arhan-Charritte-de-Haut,131,131,0
75,64,216402990,64299,Lacommande,190,183,7
75,64,216403006,64300,Lacq,743,729,14
75,64,216403014,64301,Lagor,1170,1140,30
75,64,216403022,64302,Lagos,476,465,11
75,64,216403030,64303,Laguinge-Restoue,164,156,8
75,64,216403048,64304,Lahonce,2606,2549,57
75,64,216403055,64305,Lahontan,534,522,12
75,64,216403063,64306,Lahourcade,722,702,20
75,64,216403071,64307,Lalongue,209,206,3
75,64,216403089,64308,Lalonquette,267,262,5
75,64,216403097,64309,Lamayou,213,208,5
75,64,216403105,64310,Lanne-en-Barétous,497,489,8
75,64,216405829,64311,Lannecaube,155,152,3
75,64,216403121,64312,Lanneplaà,313,304,9
75,64,216403139,64313,Lantabat,285,280,5
75,64,216403147,64314,Larceveau-Arros-Cibits,444,441,3
75,64,216403154,64315,Laroin,1117,1088,29
75,64,216403162,64316,Larrau,196,194,2
75,64,216403170,64317,Larressore,2185,2134,51
75,64,216403188,64318,Larreule,187,185,2
75,64,216403196,64319,Larribar-Sorhapuru,181,181,0
75,64,216403204,64320,Laruns,1205,1181,24
75,64,216403212,64321,Lasclaveries,246,244,2
75,64,216403220,64322,Lasse,348,342,6
75,64,216403238,64323,Lasserre,112,109,3
75,64,216403246,64324,Lasseube,1797,1746,51
75,64,216403253,64325,Lasseubetat,213,209,4
75,64,216403261,64326,Lay-Lamidou,123,119,4
75,64,216403279,64327,Lecumberry,175,170,5
75,64,216403287,64328,Ledeuix,1056,1025,31
75,64,216405712,64329,Lée,1317,1257,60
75,64,216403303,64330,Lées-Athas,251,242,9
75,64,216403311,64331,Lembeye,785,768,17
75,64,216403329,64332,Lème,171,166,5
75,64,216403345,64334,Léren,217,214,3
75,64,216403352,64335,Lescar,10007,9590,417
75,64,216403360,64336,Lescun,170,169,1
75,64,216403378,64337,Lespielle,155,152,3
75,64,216403386,64338,Lespourcy,194,188,6
75,64,216403394,64339,Lestelle-Bétharram,902,821,81
75,64,216403402,64340,Lichans-Sunhar,87,86,1
75,64,216403410,64341,Lichos,137,136,1
75,64,216403428,64342,Licq-Athérey,205,198,7
75,64,216403436,64343,Limendous,751,743,8
75,64,216403444,64344,Livron,389,374,15
75,64,216403451,64345,Lohitzun-Oyhercq,205,200,5
75,64,216403469,64346,Lombia,210,209,1
75,64,216403477,64347,Lonçon,216,213,3
75,64,216403485,64348,Lons,14121,13843,278
75,64,216405811,64349,Loubieng,515,497,18
75,64,216403501,64350,Louhossoa,883,864,19
75,64,216403519,64351,Lourdios-Ichère,143,134,9
75,64,216403527,64352,Lourenties,416,405,11
75,64,216403535,64353,Louvie-Juzon,1092,1052,40
75,64,216403543,64354,Louvie-Soubiron,125,124,1
75,64,216403550,64355,Louvigny,140,138,2
75,64,216403568,64356,Luc-Armau,109,109,0
75,64,216403576,64357,Lucarré,63,63,0
75,64,216403584,64358,Lucgarier,251,249,2
75,64,216403592,64359,Lucq-de-Béarn,951,921,30
75,64,216403600,64360,Lurbe-Saint-Christau,204,196,8
75,64,216403618,64361,Lussagnet-Lusson,189,182,7
75,64,216403626,64362,Luxe-Sumberraute,435,412,23
75,64,216403634,64363,Lys,328,325,3
75,64,216403642,64364,Macaye,592,582,10
75,64,216403659,64365,Malaussanne,428,420,8
75,64,216403667,64366,Mascaraàs-Haron,121,120,1
75,64,216403675,64367,Maslacq,906,881,25
75,64,216403683,64368,Masparraute,261,253,8
75,64,216403691,64369,Maspie-Lalonquère-Juillacq,255,244,11
75,64,216403709,64370,Maucor,582,566,16
75,64,216403717,64371,Mauléon-Licharre,3189,2953,236
75,64,216403725,64372,Maure,92,91,1
75,64,216403733,64373,Mazères-Lezons,1858,1817,41
75,64,216403741,64374,Mazerolles,1179,1155,24
75,64,216403758,64375,Méharin,288,284,4
75,64,216403766,64376,Meillon,961,935,26
75,64,216403774,64377,Mendionde,860,836,24
75,64,216403782,64378,Menditte,332,204,128
75,64,216403790,64379,Mendive,161,156,5
75,64,216403808,64380,Méracq,238,233,5
75,64,216403816,64381,Méritein,288,279,9
75,64,216403824,64382,Mesplède,343,334,9
75,64,216403832,64383,Mialos,138,137,1
75,64,216403857,64385,Miossens-Lanusse,284,277,7
75,64,216403865,64386,Mirepeix,1275,1250,25
75,64,216403873,64387,Momas,639,627,12
75,64,216403881,64388,Momy,115,114,1
75,64,216403899,64389,Monassut-Audiracq,375,369,6
75,64,216403907,64390,Moncaup,169,157,12
75,64,216403915,64391,Moncayolle-Larrory-Mendibieu,309,300,9
75,64,216403923,64392,Moncla,83,81,2
75,64,216403931,64393,Monein,4520,4417,103
75,64,216403949,64394,Monpezat,86,84,2
75,64,216403956,64395,Monségur,128,127,1
75,64,216403964,64396,Mont,1225,1131,94
75,64,216403972,64397,Montagut,125,119,6
75,64,216403980,64398,Montaner,442,433,9
75,64,216403998,64399,Montardon,2644,2340,304
75,64,216404004,64400,Montaut,1154,1109,45
75,64,216404012,64401,Mont-Disse,82,81,1
75,64,216404038,64403,Montfort,179,176,3
75,64,216404046,64404,Montory,319,311,8
75,64,216404053,64405,Morlaàs,4587,4353,234
75,64,216404061,64406,Morlanne,630,614,16
75,64,216404079,64407,Mouguerre,5448,5299,149
75,64,216404087,64408,Mouhous,62,62,0
75,64,216404095,64409,Moumour,848,826,22
75,64,216404103,64410,Mourenx,6075,5903,172
75,64,216404111,64411,Musculdy,237,234,3
75,64,216404129,64412,Nabas,89,88,1
75,64,216404137,64413,Narcastet,777,765,12
75,64,216404145,64414,Narp,120,116,4
75,64,216404152,64415,Navailles-Angos,1556,1523,33
75,64,216404160,64416,Navarrenx,1076,1053,23
75,64,216404178,64417,Nay,3464,3245,219
75,64,216404186,64418,Noguères,140,137,3
75,64,216404194,64419,Nousty,1626,1596,30
75,64,216404202,64420,Ogenne-Camptort,250,245,5
75,64,216404210,64421,Ogeu-les-Bains,1304,1275,29
75,64,216404228,64422,Oloron-Sainte-Marie,11309,10653,656
75,64,216404236,64423,Oraàs,187,184,3
75,64,216404244,64424,Ordiarp,547,543,4
75,64,216404251,64425,Orègue,499,490,9
75,64,216404269,64426,Orin,273,262,11
75,64,216404277,64427,Orion,152,150,2
75,64,216404285,64428,Orriule,144,143,1
75,64,216404293,64429,Orsanco,112,110,2
75,64,216404301,64430,Orthez,11106,10466,640
75,64,216404319,64431,Os-Marsillon,546,537,9
75,64,216404327,64432,Ossas-Suhare,87,86,1
75,64,216404335,64433,Osse-en-Aspe,352,333,19
75,64,216404343,64434,Ossenx,49,49,0
75,64,216404350,64435,Osserain-Rivareyte,224,214,10
75,64,216404368,64436,Ossès,855,837,18
75,64,216404376,64437,Ostabat-Asme,212,205,7
75,64,216404384,64438,Ouillon,560,545,15
75,64,216414052,64439,Ousse,1723,1672,51
75,64,216404400,64440,Ozenx-Montestrucq,406,389,17
75,64,216404418,64441,Pagolle,266,261,5
75,64,216404426,64442,Parbayse,337,330,7
75,64,216404434,64443,Pardies,922,898,24
75,64,216404442,64444,Pardies-Piétat,479,468,11
75,64,216404459,64445,Pau,77061,75665,1396
75,64,216404467,64446,Peyrelongue-Abos,160,159,1
75,64,216404475,64447,Piets-Plasence-Moustrou,141,140,1
75,64,216404483,64448,Poey-de-Lescar,1868,1818,50
75,64,216404491,64449,Poey-d'Oloron,165,163,2
75,64,216404509,64450,Pomps,301,297,4
75,64,216404517,64451,Ponson-Debat-Pouts,100,97,3
75,64,216404525,64452,Ponson-Dessus,266,259,7
75,64,216404533,64453,Pontacq,2978,2921,57
75,64,216404541,64454,Pontiacq-Viellepinte,189,187,2
75,64,216404558,64455,Portet,168,165,3
75,64,216404566,64456,Pouliacq,52,49,3
75,64,216404574,64457,Poursiugues-Boucoue,190,185,5
75,64,216404582,64458,Préchacq-Josbaig,303,295,8
75,64,216404590,64459,Préchacq-Navarrenx,178,176,2
75,64,216404608,64460,Précilhon,407,400,7
75,64,216405894,64461,Puyoô,1130,1108,22
75,64,216405852,64462,Ramous,497,491,6
75,64,216404632,64463,Rébénacq,659,653,6
75,64,216404640,64464,Ribarrouy,83,82,1
75,64,216404657,64465,Riupeyrous,229,228,1
75,64,216404665,64466,Rivehaute,277,270,7
75,64,216404673,64467,Rontignon,872,855,17
75,64,216404681,64468,Roquiague,123,121,2
75,64,216404699,64469,Saint-Abit,316,308,8
75,64,216404707,64470,Saint-Armou,651,640,11
75,64,216404715,64471,Saint-Boès,370,358,12
75,64,216404723,64472,Saint-Castin,866,855,11
75,64,216404731,64473,Sainte-Colome,364,360,4
75,64,216404749,64474,Saint-Dos,160,157,3
75,64,216404756,64475,Sainte-Engrâce,191,187,4
75,64,216404764,64476,Saint-Esteben,429,421,8
75,64,216404772,64477,Saint-Étienne-de-Baïgorry,1532,1499,33
75,64,216404780,64478,Saint-Faust,768,743,25
75,64,216404798,64479,Saint-Girons-en-Béarn,170,166,4
75,64,216404806,64480,Saint-Gladie-Arrive-Munein,203,198,5
75,64,216404814,64481,Saint-Goin,236,232,4
75,64,216404822,64482,Saint-Jammes,625,617,8
75,64,216404830,64483,Saint-Jean-de-Luz,14702,14282,420
75,64,216404848,64484,Saint-Jean-le-Vieux,849,831,18
75,64,216404855,64485,Saint-Jean-Pied-de-Port,1810,1510,300
75,64,216404863,64486,Saint-Jean-Poudge,64,64,0
75,64,216404871,64487,Saint-Just-Ibarre,207,201,6
75,64,216404889,64488,Saint-Laurent-Bretagne,455,446,9
75,64,216404897,64489,Saint-Martin-d'Arberoue,351,341,10
75,64,216404905,64490,Saint-Martin-d'Arrossa,556,541,15
75,64,216404913,64491,Saint-Médard,205,199,6
75,64,216404921,64492,Saint-Michel,297,291,6
75,64,216404939,64493,Saint-Palais,2023,1948,75
75,64,216404947,64494,Saint-Pé-de-Léren,267,261,6
75,64,216404954,64495,Saint-Pée-sur-Nivelle,7287,7102,185
75,64,216404962,64496,Saint-Pierre-d'Irube,5917,5814,103
75,64,216404988,64498,Saint-Vincent,403,393,10
75,64,216404996,64499,Salies-de-Béarn,4684,4555,129
75,64,216405001,64500,Salles-Mongiscard,309,302,7
75,64,216405019,64501,Sallespisse,577,569,8
75,64,216405027,64502,Sames,729,707,22
75,64,216405035,64503,Samsons-Lion,95,92,3
75,64,216405043,64504,Sare,2742,2705,37
75,64,216405050,64505,Sarpourenx,309,296,13
75,64,216405068,64506,Sarrance,161,159,2
75,64,216405076,64507,Saubole,140,137,3
75,64,216405084,64508,Saucède,133,130,3
75,64,216405092,64509,Sauguis-Saint-Étienne,177,173,4
75,64,216405100,64510,Sault-de-Navailles,965,946,19
75,64,216405118,64511,Sauvagnon,3547,3460,87
75,64,216405126,64512,Sauvelade,271,267,4
75,64,216405134,64513,Sauveterre-de-Béarn,1467,1369,98
75,64,216405142,64514,Séby,201,201,0
75,64,216405159,64515,Sedze-Maubecq,245,240,5
75,64,216405167,64516,Sedzère,386,383,3
75,64,216405175,64517,Séméacq-Blachon,168,159,9
75,64,216414060,64518,Sendets,1148,1126,22
75,64,216405191,64519,Serres-Castet,4519,4393,126
75,64,216405209,64520,Serres-Morlaàs,860,827,33
75,64,216405217,64521,Serres-Sainte-Marie,578,561,17
75,64,216405225,64522,Sévignacq-Meyracq,554,544,10
75,64,216405233,64523,Sévignacq,793,778,15
75,64,216405241,64524,Simacourbe,421,418,3
75,64,216405258,64525,Siros,814,804,10
75,64,216405266,64526,Soumoulou,1603,1584,19
75,64,216405274,64527,Souraïde,1551,1523,28
75,64,216405282,64528,Suhescun,174,166,8
75,64,216405290,64529,Sus,385,375,10
75,64,216405308,64530,Susmiou,364,357,7
75,64,216405316,64531,Tabaille-Usquain,46,46,0
75,64,216405324,64532,Tadousse-Ussau,72,71,1
75,64,216405332,64533,Tardets-Sorholus,576,566,10
75,64,216405340,64534,Taron-Sadirac-Viellenave,187,184,3
75,64,216405357,64535,Tarsacq,538,532,6
75,64,216405365,64536,Thèze,888,872,16
75,64,216405373,64537,Trois-Villes,131,127,4
75,64,216405381,64538,Uhart-Cize,817,801,16
75,64,216405399,64539,Uhart-Mixe,217,212,5
75,64,216405407,64540,Urcuit,2920,2845,75
75,64,216405415,64541,Urdès,310,308,2
75,64,216405423,64542,Urdos,68,67,1
75,64,216405431,64543,Urepel,283,276,7
75,64,216405449,64544,Urost,78,76,2
75,64,216405456,64545,Urrugne,10656,10495,161
75,64,216405464,64546,Urt,2374,2340,34
75,64,216405472,64547,Ustaritz,7673,7399,274
75,64,216405480,64548,Uzan,168,164,4
75,64,216405498,64549,Uzein,1278,1258,20
75,64,216405506,64550,Uzos,858,825,33
75,64,216405514,64551,Verdets,295,291,4
75,64,216405522,64552,Vialer,181,173,8
75,64,216405548,64554,Viellenave-d'Arthez,217,214,3
75,64,216405555,64555,Viellenave-de-Navarrenx,171,169,2
75,64,216405563,64556,Vielleségure,394,386,8
75,64,216405571,64557,Vignes,472,451,21
75,64,216405589,64558,Villefranque,2914,2836,78
75,64,216405597,64559,Viodos-Abense-de-Bas,753,736,17
75,64,216405605,64560,Viven,177,177,0
76,65,216500017,65001,Adast,305,298,7
76,65,216500025,65002,Adé,836,826,10
76,65,216504837,65003,Adervielle-Pouchergues,148,147,1
76,65,216500041,65004,Agos-Vidalos,416,406,10
76,65,216500058,65005,Allier,446,435,11
76,65,216500066,65006,Ancizan,276,268,8
76,65,216500074,65007,Andrest,1397,1371,26
76,65,216500090,65009,Anères,177,171,6
76,65,216500108,65010,Angos,226,222,4
76,65,216500116,65011,Les Angles,136,131,5
76,65,216500124,65012,Anla,80,78,2
76,65,216500132,65013,Ansost,59,57,2
76,65,216500140,65014,Antichan,40,40,0
76,65,216500157,65015,Antin,106,101,5
76,65,216500165,65016,Antist,187,184,3
76,65,216500173,65017,Aragnouet,251,249,2
76,65,216500181,65018,Arbéost,83,82,1
76,65,216500199,65019,Arcizac-Adour,584,572,12
76,65,216500207,65020,Arcizac-ez-Angles,269,264,5
76,65,216500215,65021,Arcizans-Avant,397,389,8
76,65,216500223,65022,Arcizans-Dessus,121,114,7
76,65,216500231,65023,Ardengost,12,12,0
76,65,216500249,65024,Argelès-Bagnères,105,103,2
76,65,216500256,65025,Argelès-Gazost,3069,2897,172
76,65,216500264,65026,Aries-Espénan,76,76,0
76,65,216500280,65028,Arné,206,198,8
76,65,216500298,65029,Arras-en-Lavedan,499,488,11
76,65,216500314,65031,Arreau,788,772,16
76,65,216500322,65032,Arrens-Marsous,707,687,20
76,65,216500330,65033,Arrodets-ez-Angles,118,115,3
76,65,216500348,65034,Arrodets,22,21,1
76,65,216500355,65035,Artagnan,533,515,18
76,65,216500363,65036,Artalens-Souin,134,131,3
76,65,216500371,65037,Artiguemy,88,87,1
76,65,216500389,65038,Artigues,15,14,1
76,65,216500397,65039,Aspin-Aure,40,40,0
76,65,216500405,65040,Aspin-en-Lavedan,318,315,3
76,65,216500413,65041,Asque,127,120,7
76,65,216500421,65042,Asté,593,581,12
76,65,216500439,65043,Astugue,272,265,7
76,65,216500447,65044,Aubarède,298,292,6
76,65,216500454,65045,Aucun,236,227,9
76,65,216500462,65046,Aulon,101,98,3
76,65,216500470,65047,Aureilhan,8100,7932,168
76,65,216500488,65048,Aurensan,799,783,16
76,65,216500496,65049,Auriébat,245,242,3
76,65,216500504,65050,Avajan,82,80,2
76,65,216500512,65051,Aventignan,212,208,4
76,65,216500520,65052,Averan,73,73,0
76,65,216500538,65053,Aveux,43,42,1
76,65,216500546,65054,Avezac-Prat-Lahitte,612,601,11
76,65,216500553,65055,Ayros-Arbouix,356,344,12
76,65,216500561,65056,Ayzac-Ost,465,452,13
76,65,216500579,65057,Azereix,999,979,20
76,65,216500587,65058,Azet,144,143,1
76,65,216500595,65059,Bagnères-de-Bigorre,7318,7034,284
76,65,216500603,65060,Banios,66,63,3
76,65,216500611,65061,Barbachen,51,48,3
76,65,216500629,65062,Barbazan-Debat,3572,3497,75
76,65,216500637,65063,Barbazan-Dessus,175,172,3
76,65,216500645,65064,Bareilles,47,46,1
76,65,216500652,65065,Barlest,300,292,8
76,65,216500660,65066,Barrancoueu,33,33,0
76,65,216500678,65067,Barry,137,130,7
76,65,216500686,65068,Barthe,25,24,1
76,65,216500694,65069,La Barthe-de-Neste,1260,1230,30
76,65,216500702,65070,Bartrès,578,560,18
76,65,216500710,65071,Batsère,32,32,0
76,65,216500728,65072,Bazet,1864,1849,15
76,65,216500736,65073,Bazillac,366,359,7
76,65,216500744,65074,Bazordan,110,108,2
76,65,216500751,65075,Bazus-Aure,143,137,6
76,65,216500769,65076,Bazus-Neste,62,61,1
76,65,216500777,65077,Beaucens,447,423,24
76,65,216500785,65078,Beaudéan,412,402,10
76,65,216500793,65079,Bégole,199,195,4
76,65,216500801,65080,Bénac,562,546,16
76,65,200064236,65081,Benqué-Molère,139,136,3
76,65,216500827,65082,Berbérust-Lias,50,49,1
76,65,216500835,65083,Bernac-Debat,741,724,17
76,65,216500843,65084,Bernac-Dessus,289,286,3
76,65,216500850,65085,Bernadets-Debat,112,107,5
76,65,216500868,65086,Bernadets-Dessus,155,149,6
76,65,216500876,65087,Bertren,175,169,6
76,65,216500884,65088,Betbèze,49,48,1
76,65,216500892,65089,Betpouey,88,84,4
76,65,216500900,65090,Betpouy,80,77,3
76,65,216500918,65091,Bettes,60,59,1
76,65,200087674,65092,Beyrède-Jumet-Camous,228,226,2
76,65,216500934,65093,Bize,217,210,7
76,65,216500942,65094,Bizous,129,128,1
76,65,216500959,65095,Bonnefont,339,328,11
76,65,216500967,65096,Bonnemazon,71,68,3
76,65,216500975,65097,Bonrepos,199,191,8
76,65,216500983,65098,Boô-Silhen,341,334,7
76,65,216500991,65099,Bordères-Louron,142,139,3
76,65,216501007,65100,Bordères-sur-l'Échez,5543,5421,122
76,65,216501015,65101,Bordes,773,762,11
76,65,216501023,65102,Bouilh-Devant,20,19,1
76,65,216501031,65103,Bouilh-Péreuilh,112,111,1
76,65,216501049,65104,Boulin,308,299,9
76,65,216501056,65105,Bourg-de-Bigorre,197,196,1
76,65,216501064,65106,Bourisp,176,173,3
76,65,216501072,65107,Bourréac,114,112,2
76,65,216501080,65108,Bours,899,880,19
76,65,216501098,65109,Bramevaque,32,31,1
76,65,216501106,65110,Bugard,96,96,0
76,65,216501114,65111,Bulan,62,62,0
76,65,216501122,65112,Bun,160,155,5
76,65,216501130,65113,Burg,295,284,11
76,65,216501148,65114,Buzon,79,77,2
76,65,216501155,65115,Cabanac,302,294,8
76,65,216501163,65116,Cadéac,303,298,5
76,65,216501171,65117,Cadeilhan-Trachère,44,43,1
76,65,216501189,65118,Caharet,36,36,0
76,65,216501197,65119,Caixon,369,358,11
76,65,216501205,65120,Calavanté,352,338,14
76,65,216501213,65121,Camalès,400,388,12
76,65,216501239,65123,Campan,1358,1304,54
76,65,216501247,65124,Camparan,58,55,3
76,65,216501254,65125,Campistrous,320,313,7
76,65,216501262,65126,Campuzan,151,146,5
76,65,216501270,65127,Capvern,1289,1266,23
76,65,216501288,65128,Castelbajac,143,140,3
76,65,216501296,65129,Castelnau-Magnoac,814,794,20
76,65,216501304,65130,Castelnau-Rivière-Basse,630,625,5
76,65,216501312,65131,Castelvieilh,246,244,2
76,65,216501320,65132,Castéra-Lanusse,45,45,0
76,65,216501338,65133,Castéra-Lou,238,234,4
76,65,216501346,65134,Casterets,15,14,1
76,65,216501353,65135,Castillon,82,82,0
76,65,216501361,65136,Caubous,32,32,0
76,65,216501379,65137,Caussade-Rivière,99,96,3
76,65,216501387,65138,Cauterets,889,870,19
76,65,216501395,65139,Cazarilh,55,53,2
76,65,216501403,65140,Cazaux-Debat,32,31,1
76,65,216501411,65141,Cazaux-Fréchet-Anéran-Camors,63,60,3
76,65,216501429,65142,Chelle-Debat,215,211,4
76,65,216501437,65143,Chelle-Spou,112,110,2
76,65,216501445,65144,Cheust,88,87,1
76,65,216501452,65145,Chèze,48,48,0
76,65,216501460,65146,Chis,313,312,1
76,65,216501478,65147,Cieutat,624,612,12
76,65,216501486,65148,Cizos,135,134,1
76,65,216501494,65149,Clarac,167,163,4
76,65,216501502,65150,Clarens,520,495,25
76,65,216501510,65151,Collongues,152,148,4
76,65,216501536,65153,Coussan,127,123,4
76,65,216501544,65154,Créchets,56,55,1
76,65,216501551,65155,Devèze,54,52,2
76,65,216501569,65156,Dours,219,214,5
76,65,216501577,65157,Ens,22,20,2
76,65,216501585,65158,Esbareich,80,80,0
76,65,216501593,65159,Escala,366,354,12
76,65,216501601,65160,Escaunets,124,121,3
76,65,216501619,65161,Escondeaux,286,282,4
76,65,216501627,65162,Esconnets,34,33,1
76,65,216501635,65163,Escots,41,40,1
76,65,216501643,65164,Escoubès-Pouts,104,103,1
76,65,216501650,65165,Esparros,180,180,0
76,65,216501668,65166,Espèche,51,50,1
76,65,216501676,65167,Espieilh,25,25,0
76,65,216501684,65168,Esquièze-Sère,423,411,12
76,65,216501692,65169,Estaing,94,92,2
76,65,216501700,65170,Estampures,77,76,1
76,65,216501718,65171,Estarvielle,43,43,0
76,65,216501726,65172,Estensan,38,38,0
76,65,216501734,65173,Esterre,197,190,7
76,65,216501742,65174,Estirac,108,104,4
76,65,216501759,65175,Ferrère,42,39,3
76,65,216501767,65176,Ferrières,82,82,0
76,65,216501775,65177,Fontrailles,170,167,3
76,65,216501783,65178,Fréchède,56,56,0
76,65,216501791,65179,Fréchendets,27,27,0
76,65,216501809,65180,Fréchet-Aure,14,14,0
76,65,216501817,65181,Fréchou-Fréchet,170,167,3
76,65,216501825,65182,Gaillagos,122,121,1
76,65,216501833,65183,Galan,711,698,13
76,65,216501841,65184,Galez,173,172,1
76,65,216501858,65185,Gardères,456,443,13
76,65,216501866,65186,Gaudent,35,35,0
76,65,216501874,65187,Gaussan,102,98,4
76,65,216501890,65189,Gayan,289,276,13
76,65,216501908,65190,Gazave,71,71,0
76,65,216501916,65191,Gazost,124,122,2
76,65,200060309,65192,Gavarnie-Gèdre,349,340,9
76,65,216501932,65193,Gembrie,95,92,3
76,65,216501940,65194,Générest,98,95,3
76,65,216501957,65195,Génos,141,141,0
76,65,216501965,65196,Gensac,93,91,2
76,65,216501973,65197,Ger,163,154,9
76,65,216501981,65198,Gerde,1169,1142,27
76,65,216501999,65199,Germ,35,35,0
76,65,216502005,65200,Germs-sur-l'Oussouet,107,106,1
76,65,216502013,65201,Geu,191,187,4
76,65,216502021,65202,Gez,342,329,13
76,65,216502039,65203,Gez-ez-Angles,27,26,1
76,65,216502047,65204,Gonez,28,28,0
76,65,216502054,65205,Gouaux,54,54,0
76,65,216502062,65206,Goudon,240,234,6
76,65,216502070,65207,Gourgue,64,64,0
76,65,216502088,65208,Grailhen,23,23,0
76,65,216502096,65209,Grézian,76,76,0
76,65,216502104,65210,Grust,35,34,1
76,65,216502112,65211,Guchan,154,149,5
76,65,216502120,65212,Guchen,338,327,11
76,65,216502138,65213,Guizerix,125,122,3
76,65,216502146,65214,Hachan,45,45,0
76,65,216502153,65215,Hagedet,45,43,2
76,65,216502161,65216,Hauban,101,101,0
76,65,216502179,65217,Hautaget,59,57,2
76,65,216502187,65218,Hèches,624,613,11
76,65,216502195,65219,Hères,118,115,3
76,65,216502203,65220,Hibarette,240,238,2
76,65,216502211,65221,Hiis,263,258,5
76,65,216502229,65222,Hitte,162,154,8
76,65,216502237,65223,Horgues,1220,1194,26
76,65,216502245,65224,Houeydets,286,280,6
76,65,216502252,65225,Hourc,108,107,1
76,65,216502260,65226,Ibos,3043,2905,138
76,65,216502286,65228,Ilhet,121,121,0
76,65,216502294,65229,Ilheu,48,48,0
76,65,216502302,65230,Izaourt,262,256,6
76,65,216502310,65231,Izaux,211,199,12
76,65,216502328,65232,Jacque,67,65,2
76,65,216502336,65233,Jarret,316,312,4
76,65,216502344,65234,Jézeau,97,96,1
76,65,216502351,65235,Juillan,4141,4045,96
76,65,216502369,65236,Julos,467,454,13
76,65,216502377,65237,Juncalas,164,159,5
76,65,216502385,65238,Labassère,244,234,10
76,65,216502393,65239,Labastide,156,151,5
76,65,216502401,65240,Labatut-Rivière,387,381,6
76,65,216502419,65241,Laborde,89,86,3
76,65,216502427,65242,Lacassagne,241,238,3
76,65,216502435,65243,Lafitole,466,448,18
76,65,216502443,65244,Lagarde,537,530,7
76,65,216502450,65245,Lagrange,245,241,4
76,65,216502476,65247,Arrayou-Lahitte,103,102,1
76,65,216502484,65248,Lahitte-Toupière,274,257,17
76,65,216502492,65249,Lalanne,106,101,5
76,65,216502500,65250,Lalanne-Trie,120,119,1
76,65,216502518,65251,Laloubère,1938,1874,64
76,65,216502526,65252,Lamarque-Pontacq,883,869,14
76,65,216502534,65253,Lamarque-Rustaing,53,53,0
76,65,216502542,65254,Laméac,148,144,4
76,65,216502559,65255,Lançon,30,30,0
76,65,216502567,65256,Lanespède,147,145,2
76,65,216502575,65257,Lanne,614,605,9
76,65,216502583,65258,Lannemezan,5964,5803,161
76,65,216502591,65259,Lansac,191,181,10
76,65,216502609,65260,Lapeyre,93,92,1
76,65,216502617,65261,Laran,48,47,1
76,65,216502625,65262,Larreule,399,389,10
76,65,216502633,65263,Larroque,97,94,3
76,65,216502641,65264,Lascazères,334,309,25
76,65,216502658,65265,Laslades,339,329,10
76,65,216502666,65266,Lassales,38,37,1
76,65,216502674,65267,Lau-Balagnas,539,522,17
76,65,216502682,65268,Layrisse,228,225,3
76,65,216502690,65269,Lescurry,169,166,3
76,65,216502708,65270,Lespouey,209,201,8
76,65,216502716,65271,Lézignan,361,357,4
76,65,216502724,65272,Lhez,78,77,1
76,65,216502732,65273,Liac,199,199,0
76,65,216502740,65274,Libaros,140,139,1
76,65,216502757,65275,Lies,77,76,1
76,65,216502765,65276,Lizos,120,119,1
76,65,216502773,65277,Lombrès,93,91,2
76,65,216502781,65278,Lomné,31,31,0
76,65,216502799,65279,Lortet,221,215,6
76,65,216502807,65280,Loubajac,437,434,3
76,65,216502815,65281,Loucrup,254,250,4
76,65,200060325,65282,Loudenvielle,301,295,6
76,65,216502831,65283,Loudervielle,51,48,3
76,65,216502849,65284,Louey,1080,1052,28
76,65,216502856,65285,Louit,194,191,3
76,65,216502864,65286,Lourdes,13546,13247,299
76,65,216502872,65287,Loures-Barousse,638,626,12
76,65,216502880,65288,Lubret-Saint-Luc,56,55,1
76,65,216502898,65289,Luby-Betmont,111,109,2
76,65,216502906,65290,Luc,184,183,1
76,65,216502914,65291,Lugagnan,147,143,4
76,65,216502922,65292,Luquet,407,404,3
76,65,216502930,65293,Lustar,99,97,2
76,65,216502948,65294,Lutilhous,219,216,3
76,65,216502955,65295,Luz-Saint-Sauveur,944,929,15
76,65,216502963,65296,Madiran,438,425,13
76,65,216502971,65297,Mansan,46,41,5
76,65,216502989,65298,Marquerie,85,85,0
76,65,216502997,65299,Marsac,224,220,4
76,65,216503003,65300,Marsas,69,66,3
76,65,216503011,65301,Marseillan,268,264,4
76,65,216503037,65303,Mascaras,373,369,4
76,65,216503045,65304,Maubourguet,2284,2254,30
76,65,216503052,65305,Mauléon-Barousse,98,98,0
76,65,216503060,65306,Mauvezin,237,233,4
76,65,216503078,65307,Mazères-de-Neste,343,338,5
76,65,216503086,65308,Mazerolles,108,105,3
76,65,216503094,65309,Mazouau,15,15,0
76,65,216503102,65310,Mérilheu,240,235,5
76,65,216503110,65311,Mingot,99,99,0
76,65,216503136,65313,Momères,760,737,23
76,65,216503144,65314,Monfaucon,215,208,7
76,65,216503151,65315,Monléon-Magnoac,621,414,207
76,65,216503169,65316,Monlong,108,105,3
76,65,216503177,65317,Mont,37,35,2
76,65,216503185,65318,Montastruc,234,231,3
76,65,216503193,65319,Montégut,137,134,3
76,65,216503201,65320,Montgaillard,855,838,17
76,65,216503219,65321,Montignac,144,141,3
76,65,216503227,65322,Montoussé,258,251,7
76,65,216503235,65323,Montsérié,84,84,0
76,65,216503243,65324,Moulédous,221,214,7
76,65,216503250,65325,Moumoulous,44,44,0
76,65,216503268,65326,Mun,86,83,3
76,65,216503276,65327,Nestier,173,170,3
76,65,216503284,65328,Neuilh,99,95,4
76,65,216503292,65329,Nistos,215,208,7
76,65,216503300,65330,Nouilhan,227,224,3
76,65,216503318,65331,Odos,3390,3290,100
76,65,216503326,65332,Oléac-Debat,172,171,1
76,65,216503334,65333,Oléac-Dessus,114,113,1
76,65,216503342,65334,Omex,228,224,4
76,65,216503359,65335,Ordizan,539,523,16
76,65,216503367,65336,Organ,32,32,0
76,65,216503375,65337,Orieux,109,106,3
76,65,216503383,65338,Orignac,250,247,3
76,65,216503391,65339,Orincles,345,338,7
76,65,216503409,65340,Orleix,1995,1953,42
76,65,216503417,65341,Oroix,108,106,2
76,65,216503425,65342,Osmets,95,93,2
76,65,216503433,65343,Ossen,247,242,5
76,65,216503441,65344,Ossun,2421,2369,52
76,65,216503458,65345,Ossun-ez-Angles,56,56,0
76,65,216503466,65346,Oueilloux,156,150,6
76,65,216503474,65347,Ourde,45,45,0
76,65,216503482,65348,Ourdis-Cotdoussan,47,45,2
76,65,216503490,65349,Ourdon,12,12,0
76,65,216503508,65350,Oursbelille,1241,1200,41
76,65,216503516,65351,Ousté,35,35,0
76,65,216503524,65352,Ouzous,229,221,8
76,65,216503532,65353,Ozon,259,249,10
76,65,216503540,65354,Pailhac,78,75,3
76,65,216503557,65355,Paréac,73,73,0
76,65,216503565,65356,Péré,62,60,2
76,65,216503573,65357,Peyraube,166,163,3
76,65,216503581,65358,Peyret-Saint-André,53,51,2
76,65,216503599,65359,Peyriguère,27,27,0
76,65,216503607,65360,Peyrouse,283,275,8
76,65,216503615,65361,Peyrun,98,98,0
76,65,216503623,65362,Pierrefitte-Nestalas,1144,1119,25
76,65,216503631,65363,Pinas,463,454,9
76,65,216503649,65364,Pintac,24,22,2
76,65,216503664,65366,Poueyferré,871,846,25
76,65,216503672,65367,Poumarous,169,166,3
76,65,216503680,65368,Pouy,43,41,2
76,65,216503698,65369,Pouyastruc,666,643,23
76,65,216503706,65370,Pouzac,1148,1110,38
76,65,216503714,65371,Préchac,249,239,10
76,65,216503722,65372,Pujo,663,649,14
76,65,216503730,65373,Puntous,167,163,4
76,65,216503748,65374,Puydarrieux,234,233,1
76,65,216503755,65375,Rabastens-de-Bigorre,1468,1443,25
76,65,216503763,65376,Recurt,221,217,4
76,65,216503771,65377,Réjaumont,163,155,8
76,65,216503789,65378,Ricaud,68,66,2
76,65,216503797,65379,Ris,15,14,1
76,65,216503805,65380,Sabalos,148,147,1
76,65,216503813,65381,Sabarros,34,34,0
76,65,216503821,65382,Sacoué,83,80,3
76,65,216503839,65383,Sadournin,198,196,2
76,65,216503847,65384,Sailhan,175,173,2
76,65,216503854,65385,Saint-Arroman,97,96,1
76,65,216503862,65386,Saint-Créac,98,98,0
76,65,216503870,65387,Saint-Lanne,125,122,3
76,65,216503888,65388,Saint-Lary-Soulan,855,838,17
76,65,216503896,65389,Saint-Laurent-de-Neste,990,955,35
76,65,216503904,65390,Saint-Lézer,437,429,8
76,65,216503912,65391,Sainte-Marie,59,59,0
76,65,216503920,65392,Saint-Martin,450,442,8
76,65,216503938,65393,Saint-Pastous,148,143,5
76,65,216503946,65394,Saint-Paul,322,319,3
76,65,216503953,65395,Saint-Pé-de-Bigorre,1177,1157,20
76,65,216503961,65396,Saint-Savin,372,364,8
76,65,216503979,65397,Saint-Sever-de-Rustan,165,161,4
76,65,216503987,65398,Saléchan,247,245,2
76,65,200065266,65399,Saligos,100,98,2
76,65,216504001,65400,Salles,235,228,7
76,65,216504019,65401,Salles-Adour,597,573,24
76,65,216504027,65402,Samuran,25,25,0
76,65,216504035,65403,Sanous,103,101,2
76,65,216504043,65404,Sariac-Magnoac,156,153,3
76,65,216504050,65405,Sarlabous,79,78,1
76,65,216504068,65406,Sarniguet,263,258,5
76,65,216504076,65407,Sarp,110,108,2
76,65,216504084,65408,Sarrancolin,579,560,19
76,65,216504092,65409,Sarriac-Bigorre,295,292,3
76,65,216504100,65410,Sarrouilles,539,525,14
76,65,216504118,65411,Sassis,82,76,6
76,65,216504126,65412,Sauveterre,168,165,3
76,65,216504134,65413,Sazos,146,142,4
76,65,216504142,65414,Ségalas,84,80,4
76,65,216504159,65415,Ségus,240,239,1
76,65,216504167,65416,Seich,88,86,2
76,65,216504175,65417,Séméac,5260,5165,95
76,65,216504183,65418,Sénac,299,292,7
76,65,216504191,65419,Sentous,68,68,0
76,65,216504209,65420,Sère-en-Lavedan,78,76,2
76,65,216504217,65421,Sère-Lanso,52,50,2
76,65,216504225,65422,Séron,341,338,3
76,65,216504233,65423,Sère-Rustaing,134,133,1
76,65,216504241,65424,Sers,120,118,2
76,65,216504258,65425,Siarrouy,456,449,7
76,65,216504266,65426,Sinzos,137,131,6
76,65,216504274,65427,Siradan,291,285,6
76,65,216504282,65428,Sireix,63,62,1
76,65,216504290,65429,Sombrun,215,205,10
76,65,216504308,65430,Soréac,45,44,1
76,65,216504316,65431,Sost,99,96,3
76,65,216504324,65432,Soublecause,183,177,6
76,65,216504332,65433,Soues,3087,3047,40
76,65,216504357,65435,Soulom,287,283,4
76,65,216504365,65436,Souyeaux,314,303,11
76,65,216504373,65437,Tajan,136,131,5
76,65,216504381,65438,Talazac,78,76,2
76,65,216504399,65439,Tarasteix,272,269,3
76,65,216504407,65440,Tarbes,43944,42925,1019
76,65,216504415,65441,Thèbe,81,79,2
76,65,216504423,65442,Thermes-Magnoac,210,209,1
76,65,216504431,65443,Thuy,16,16,0
76,65,216504449,65444,Tibiran-Jaunac,325,323,2
76,65,216504456,65445,Tilhouse,235,230,5
76,65,216504464,65446,Tostat,553,549,4
76,65,216504472,65447,Tournay,1185,1164,21
76,65,216504480,65448,Tournous-Darré,91,87,4
76,65,216504498,65449,Tournous-Devant,92,87,5
76,65,216504506,65450,Tramezaïgues,40,39,1
76,65,216504514,65451,Trébons,763,749,14
76,65,216504522,65452,Trie-sur-Baïse,1027,1001,26
76,65,216504530,65453,Troubat,75,75,0
76,65,216504548,65454,Trouley-Labarthe,106,105,1
76,65,216504555,65455,Tuzaguet,444,436,8
76,65,216504563,65456,Uglas,292,285,7
76,65,216504571,65457,Ugnouas,84,83,1
76,65,216504589,65458,Uz,34,33,1
76,65,216504597,65459,Uzer,103,103,0
76,65,216504605,65460,Vic-en-Bigorre,5101,4831,270
76,65,216504613,65461,Vidou,103,101,2
76,65,216504621,65462,Vidouze,247,242,5
76,65,216504639,65463,Viella,85,84,1
76,65,216504647,65464,Vielle-Adour,510,500,10
76,65,216504654,65465,Vielle-Aure,326,317,9
76,65,216504662,65466,Vielle-Louron,83,82,1
76,65,216504670,65467,Vier-Bordes,103,97,6
76,65,216504688,65468,Vieuzos,44,43,1
76,65,216504696,65469,Viey,22,21,1
76,65,216504704,65470,Viger,150,146,4
76,65,216504712,65471,Vignec,221,213,8
76,65,216504720,65472,Villefranque,79,74,5
76,65,216504738,65473,Villelongue,393,382,11
76,65,216504746,65474,Villembits,114,113,1
76,65,216504753,65475,Villemur,61,60,1
76,65,216504761,65476,Villenave-près-Béarn,70,66,4
76,65,216504779,65477,Villenave-près-Marsac,108,106,2
76,65,216504787,65478,Viscos,34,33,1
76,65,216504795,65479,Visker,362,352,10
76,65,216504811,65481,Barèges,162,157,5
76,65,216504829,65482,Cantaous,451,440,11
76,66,216600015,66001,L'Albère,71,70,1
76,66,216600023,66002,Alénya,3717,3654,63
76,66,216600031,66003,Amélie-les-Bains-Palalda,3632,3581,51
76,66,216600049,66004,Les Angles,554,546,8
76,66,216600056,66005,Angoustrine-Villeneuve-des-Escaldes,592,557,35
76,66,216600064,66006,Ansignan,171,166,5
76,66,216600072,66007,Arboussols,128,127,1
76,66,216600080,66008,Argelès-sur-Mer,10844,10593,251
76,66,216600098,66009,Arles-sur-Tech,2823,2784,39
76,66,216600106,66010,Ayguatébia-Talau,35,35,0
76,66,216600114,66011,Bages,4507,4453,54
76,66,216600122,66012,Baho,3457,3388,69
76,66,216600130,66013,Baillestavy,121,118,3
76,66,216600148,66014,Baixas,2717,2669,48
76,66,216600155,66015,Banyuls-dels-Aspres,1311,1289,22
76,66,216600163,66016,Banyuls-sur-Mer,4839,4761,78
76,66,216600171,66017,Le Barcarès,5933,5894,39
76,66,216600189,66018,La Bastide,68,68,0
76,66,216600197,66019,Bélesta,217,213,4
76,66,216600205,66020,Bolquère,845,816,29
76,66,216600213,66021,Bompas,7734,7625,109
76,66,216600221,66022,Boule-d'Amont,59,58,1
76,66,216600239,66023,Bouleternère,966,957,9
76,66,216600247,66024,Le Boulou,5370,5313,57
76,66,216600254,66025,Bourg-Madame,1279,1203,76
76,66,216600262,66026,Brouilla,1613,1580,33
76,66,216600270,66027,La Cabanasse,709,695,14
76,66,216600288,66028,Cabestany,10580,10368,212
76,66,216600296,66029,Caixas,135,134,1
76,66,216600304,66030,Calce,220,216,4
76,66,216600320,66032,Calmeilles,62,59,3
76,66,216600338,66033,Camélas,472,459,13
76,66,216600346,66034,Campôme,116,111,5
76,66,216600353,66035,Campoussy,41,41,0
76,66,216600361,66036,Canaveilles,22,22,0
76,66,216600379,66037,Canet-en-Roussillon,12916,12653,263
76,66,216600387,66038,Canohès,6611,6490,121
76,66,216600395,66039,Caramany,132,131,1
76,66,216600403,66040,Casefabre,42,41,1
76,66,216600411,66041,Cases-de-Pène,980,958,22
76,66,216600429,66042,Cassagnes,277,276,1
76,66,216600437,66043,Casteil,141,139,2
76,66,216600445,66044,Castelnou,295,289,6
76,66,216600452,66045,Catllar,776,761,15
76,66,216600460,66046,Caudiès-de-Fenouillèdes,602,593,9
76,66,216600478,66047,Caudiès-de-Conflent,20,18,2
76,66,216600486,66048,Cerbère,1316,1301,15
76,66,216600494,66049,Céret,7968,7753,215
76,66,216600502,66050,Claira,4606,4550,56
76,66,216600510,66051,Clara-Villerach,278,270,8
76,66,216600528,66052,Codalet,366,359,7
76,66,216600536,66053,Collioure,2429,2400,29
76,66,216600544,66054,Conat,63,60,3
76,66,216600551,66055,Corbère,794,777,17
76,66,216600569,66056,Corbère-les-Cabanes,1054,1040,14
76,66,216600577,66057,Corneilla-de-Conflent,534,530,4
76,66,216600585,66058,Corneilla-la-Rivière,2047,2012,35
76,66,216600593,66059,Corneilla-del-Vercol,2479,2444,35
76,66,216600601,66060,Corsavy,261,240,21
76,66,216600619,66061,Coustouges,91,91,0
76,66,216600627,66062,Dorres,178,171,7
76,66,216600635,66063,Les Cluses,235,232,3
76,66,216600643,66064,Égat,435,422,13
76,66,216600650,66065,Elne,9518,9402,116
76,66,216600668,66066,Enveitg,659,637,22
76,66,216600676,66067,Err,696,683,13
76,66,216600684,66068,Escaro,113,111,2
76,66,216600692,66069,Espira-de-l'Agly,3603,3489,114
76,66,216600700,66070,Espira-de-Conflent,188,183,5
76,66,216600718,66071,Estagel,2064,2046,18
76,66,216600726,66072,Estavar,490,479,11
76,66,216600734,66073,Estoher,137,135,2
76,66,216600742,66074,Eus,391,377,14
76,66,216600759,66075,Eyne,152,144,8
76,66,216600767,66076,Feilluns,63,63,0
76,66,216600775,66077,Fenouillet,89,88,1
76,66,216600783,66078,Fillols,201,197,4
76,66,216600791,66079,Finestret,204,200,4
76,66,216600809,66080,Fontpédrouse,120,119,1
76,66,216600817,66081,Fontrabiouse,127,124,3
76,66,216600825,66082,Formiguères,515,500,15
76,66,216600833,66083,Fosse,41,41,0
76,66,216600841,66084,Fourques,1332,1313,19
76,66,216600858,66085,Fuilla,451,442,9
76,66,216600866,66086,Glorianes,22,22,0
76,66,216600882,66088,Ille-sur-Têt,5588,5519,69
76,66,216600890,66089,Joch,355,349,6
76,66,216600908,66090,Jujols,45,43,2
76,66,216600916,66091,Lamanère,57,56,1
76,66,216600924,66092,Lansac,93,91,2
76,66,216600932,66093,Laroque-des-Albères,2221,2192,29
76,66,216600940,66094,Latour-Bas-Elne,3257,3210,47
76,66,216600957,66095,Latour-de-Carol,462,450,12
76,66,216600965,66096,Latour-de-France,1056,1043,13
76,66,216600973,66097,Lesquerde,143,139,4
76,66,216600981,66098,La Llagonne,228,218,10
76,66,216600999,66099,Llauro,322,320,2
76,66,216601005,66100,Llo,170,166,4
76,66,216601013,66101,Llupia,2186,2141,45
76,66,216601021,66102,Mantet,33,31,2
76,66,216601039,66103,Marquixanes,582,574,8
76,66,216601047,66104,Los Masos,991,979,12
76,66,216601054,66105,Matemale,283,277,6
76,66,216601062,66106,Maureillas-las-Illas,2710,2665,45
76,66,216601070,66107,Maury,801,789,12
76,66,216601088,66108,Millas,4324,4261,63
76,66,216601096,66109,Molitg-les-Bains,250,246,4
76,66,216601112,66111,Montalba-le-Château,155,153,2
76,66,216601120,66112,Montauriol,255,251,4
76,66,216601138,66113,Montbolo,179,177,2
76,66,216601146,66114,Montescot,1666,1630,36
76,66,216601153,66115,Montesquieu-des-Albères,1273,1250,23
76,66,216601161,66116,Montferrer,200,197,3
76,66,216601179,66117,Mont-Louis,152,144,8
76,66,216601187,66118,Montner,340,333,7
76,66,216601195,66119,Mosset,321,316,5
76,66,216601203,66120,Nahuja,77,76,1
76,66,216601211,66121,Néfiach,1350,1314,36
76,66,216601229,66122,Nohèdes,61,59,2
76,66,216601237,66123,Nyer,153,153,0
76,66,216601245,66124,Font-Romeu-Odeillo-Via,1964,1791,173
76,66,216601252,66125,Olette,352,347,5
76,66,216601260,66126,Oms,339,334,5
76,66,216601278,66127,Opoul-Périllos,1206,1189,17
76,66,216601286,66128,Oreilla,25,25,0
76,66,216601294,66129,Ortaffa,1722,1700,22
76,66,216601302,66130,Osséja,1441,1366,75
76,66,216601328,66132,Palau-de-Cerdagne,426,415,11
76,66,216601336,66133,Palau-del-Vidre,3137,3092,45
76,66,216601344,66134,Passa,1008,998,10
76,66,216601369,66136,Perpignan,119447,118032,1415
76,66,216601377,66137,Le Perthus,554,551,3
76,66,216601385,66138,Peyrestortes,1611,1585,26
76,66,216601393,66139,Pézilla-de-Conflent,39,39,0
76,66,216601401,66140,Pézilla-la-Rivière,3962,3906,56
76,66,216601419,66141,Pia,10436,10334,102
76,66,216601427,66142,Planès,56,54,2
76,66,216601435,66143,Planèzes,92,90,2
76,66,216601443,66144,Pollestres,5400,5316,84
76,66,216601450,66145,Ponteilla,2875,2833,42
76,66,216601468,66146,Porta,121,115,6
76,66,216601476,66147,Porté-Puymorens,107,106,1
76,66,216601484,66148,Port-Vendres,4070,3995,75
76,66,216601492,66149,Prades,6375,6081,294
76,66,216601500,66150,Prats-de-Mollo-la-Preste,1169,1155,14
76,66,216601518,66151,Prats-de-Sournia,82,78,4
76,66,216601526,66152,Prugnanes,105,105,0
76,66,216601534,66153,Prunet-et-Belpuig,47,47,0
76,66,216601542,66154,Puyvalador,62,61,1
76,66,216601559,66155,Py,81,80,1
76,66,216601567,66156,Rabouillet,91,91,0
76,66,216601575,66157,Railleu,24,23,1
76,66,216601583,66158,Rasiguères,158,156,2
76,66,216601591,66159,Réal,62,62,0
76,66,216601609,66160,Reynès,1273,1252,21
76,66,216601617,66161,Ria-Sirach,1379,1354,25
76,66,216601625,66162,Rigarda,680,678,2
76,66,216601641,66164,Rivesaltes,9160,9020,140
76,66,216601658,66165,Rodès,643,636,7
76,66,216601666,66166,Sahorre,401,397,4
76,66,216601674,66167,Saillagouse,1205,1175,30
76,66,216601682,66168,Saint-André,3462,3411,51
76,66,216601690,66169,Saint-Arnac,110,109,1
76,66,216601708,66170,Sainte-Colombe-de-la-Commanderie,164,162,2
76,66,216601716,66171,Saint-Cyprien,11188,11048,140
76,66,216601724,66172,Saint-Estève,11805,11642,163
76,66,216601732,66173,Saint-Féliu-d'Amont,1224,1205,19
76,66,216601740,66174,Saint-Féliu-d'Avall,2952,2907,45
76,66,216601757,66175,Saint-Génis-des-Fontaines,2864,2837,27
76,66,216601765,66176,Saint-Hippolyte,3241,3209,32
76,66,216601773,66177,Saint-Jean-Lasseille,1575,1558,17
76,66,216601781,66178,Saint-Jean-Pla-de-Corts,2313,2264,49
76,66,216601799,66179,Saint-Laurent-de-Cerdans,1050,1036,14
76,66,216601807,66180,Saint-Laurent-de-la-Salanque,10173,10053,120
76,66,216601815,66181,Sainte-Léocadie,124,122,2
76,66,216601823,66182,Sainte-Marie-la-Mer,4867,4800,67
76,66,216601831,66183,Saint-Marsal,64,64,0
76,66,216601849,66184,Saint-Martin-de-Fenouillet,54,51,3
76,66,216601856,66185,Saint-Michel-de-Llotes,364,353,11
76,66,216601864,66186,Saint-Nazaire,2823,2784,39
76,66,216601872,66187,Saint-Paul-de-Fenouillet,1796,1779,17
76,66,216601880,66188,Saint-Pierre-dels-Forcats,272,262,10
76,66,216601898,66189,Saleilles,5700,5617,83
76,66,216601906,66190,Salses-le-Château,3648,3616,32
76,66,216601914,66191,Sansa,24,23,1
76,66,216601922,66192,Sauto,97,94,3
76,66,216601930,66193,Serdinya,230,225,5
76,66,216601948,66194,Serralongue,230,227,3
76,66,216601955,66195,Le Soler,7985,7868,117
76,66,216601963,66196,Sorède,3446,3395,51
76,66,216601971,66197,Souanyas,36,36,0
76,66,216601989,66198,Sournia,495,492,3
76,66,216601997,66199,Taillet,107,103,4
76,66,216602011,66201,Tarerach,46,45,1
76,66,216602029,66202,Targasonne,198,193,5
76,66,216602037,66203,Taulis,58,58,0
76,66,216602045,66204,Taurinya,338,328,10
76,66,216602052,66205,Tautavel,876,854,22
76,66,216602060,66206,Le Tech,96,96,0
76,66,216602078,66207,Terrats,771,760,11
76,66,216602086,66208,Théza,2270,2170,100
76,66,216602094,66209,Thuès-Entre-Valls,35,35,0
76,66,216602102,66210,Thuir,8197,8057,140
76,66,216602110,66211,Tordères,187,180,7
76,66,216602128,66212,Torreilles,3924,3854,70
76,66,216602136,66213,Toulouges,7385,7255,130
76,66,216602144,66214,Tresserre,1138,1125,13
76,66,216602151,66215,Trévillach,161,161,0
76,66,216602169,66216,Trilla,77,76,1
76,66,216602177,66217,Trouillas,2247,2222,25
76,66,216602185,66218,Ur,364,353,11
76,66,216602193,66219,Urbanya,47,47,0
76,66,216602201,66220,Valcebollère,37,36,1
76,66,216602219,66221,Valmanya,34,34,0
76,66,216602227,66222,Vernet-les-Bains,1488,1447,41
76,66,216602235,66223,Villefranche-de-Conflent,215,209,6
76,66,216602243,66224,Villelongue-de-la-Salanque,3325,3285,40
76,66,216602250,66225,Villelongue-dels-Monts,1877,1815,62
76,66,216602268,66226,Villemolaque,1372,1356,16
76,66,216602276,66227,Villeneuve-de-la-Raho,4178,4124,54
76,66,216602284,66228,Villeneuve-la-Rivière,1396,1373,23
76,66,216602300,66230,Vinça,2171,2146,25
76,66,216602318,66231,Vingrau,564,558,6
76,66,216602326,66232,Vira,25,25,0
76,66,216602334,66233,Vivès,178,173,5
76,66,216602342,66234,Le Vivier,68,68,0
44,67,216700013,67001,Achenheim,2471,2437,34
44,67,216700021,67002,Adamswiller,398,396,2
44,67,216700039,67003,Albé,461,451,10
44,67,200057479,67004,Sommerau,1558,1530,28
44,67,216700054,67005,Alteckendorf,871,851,20
44,67,216700062,67006,Altenheim,222,221,1
44,67,216700088,67008,Altorf,1421,1398,23
44,67,216700096,67009,Altwiller,390,377,13
44,67,216700104,67010,Andlau,1833,1763,70
44,67,216700112,67011,Artolsheim,1000,989,11
44,67,216700120,67012,Aschbach,667,649,18
44,67,216700138,67013,Asswiller,275,272,3
44,67,216700161,67016,Avolsheim,799,788,11
44,67,216700179,67017,Baerendorf,301,296,5
44,67,216700187,67018,Balbronn,684,675,9
44,67,216700195,67019,Baldenheim,1211,1193,18
44,67,216700203,67020,Barembach,834,827,7
44,67,216700211,67021,Barr,7365,7174,191
44,67,216700229,67022,Bassemberg,229,225,4
44,67,216700237,67023,Batzendorf,1006,984,22
44,67,216700252,67025,Beinheim,1945,1924,21
44,67,216700260,67026,Bellefosse,173,170,3
44,67,216700278,67027,Belmont,170,170,0
44,67,216700286,67028,Benfeld,5914,5820,94
44,67,216700294,67029,Berg,356,352,4
44,67,216700302,67030,Bergbieten,732,725,7
44,67,216700310,67031,Bernardswiller,1496,1451,45
44,67,216700328,67032,Bernardvillé,210,203,7
44,67,216700336,67033,Bernolsheim,614,606,8
44,67,216700344,67034,Berstett,2502,2462,40
44,67,216700351,67035,Berstheim,473,467,6
44,67,216700369,67036,Bettwiller,315,308,7
44,67,216700377,67037,Biblisheim,367,361,6
44,67,216700385,67038,Bietlenheim,303,301,2
44,67,216700393,67039,Bilwisheim,550,539,11
44,67,216700401,67040,Bindernheim,1054,1044,10
44,67,216700435,67043,Bischheim,17735,17520,215
44,67,216700443,67044,Bischholtz,256,256,0
44,67,216700450,67045,Bischoffsheim,3397,3338,59
44,67,216700468,67046,Bischwiller,12759,12606,153
44,67,216700476,67047,Bissert,160,157,3
44,67,216700484,67048,Bitschhoffen,474,459,15
44,67,216700492,67049,Blaesheim,1323,1303,20
44,67,216700500,67050,Blancherupt,32,32,0
44,67,216700518,67051,Blienschwiller,321,310,11
44,67,216700526,67052,Boersch,2495,2430,65
44,67,216700534,67053,Boesenbiesen,333,323,10
44,67,216700542,67054,Bolsenheim,558,552,6
44,67,216700559,67055,Boofzheim,1401,1381,20
44,67,216700567,67056,Bootzheim,791,780,11
44,67,216700575,67057,Bosselshausen,178,172,6
44,67,216700583,67058,Bossendorf,391,387,4
44,67,216700591,67059,Bourg-Bruche,389,382,7
44,67,216700609,67060,Bourgheim,638,628,10
44,67,216700617,67061,Bouxwiller,3814,3736,78
44,67,216700625,67062,Breitenau,339,333,6
44,67,216700633,67063,Breitenbach,666,650,16
44,67,216700658,67065,Breuschwickersheim,1357,1343,14
44,67,216700666,67066,La Broque,2696,2609,87
44,67,216700674,67067,Brumath,10165,10061,104
44,67,216700682,67068,Buswiller,285,282,3
44,67,216700690,67069,Buhl,512,505,7
44,67,216700708,67070,Burbach,281,277,4
44,67,216700716,67071,Bust,481,470,11
44,67,216700724,67072,Butten,682,660,22
44,67,216700732,67073,Châtenois,4293,4206,87
44,67,216700740,67074,Cleebourg,658,640,18
44,67,216700757,67075,Climbach,448,444,4
44,67,216700765,67076,Colroy-la-Roche,482,473,9
44,67,216700773,67077,Cosswiller,592,578,14
44,67,216700781,67078,Crastatt,281,278,3
44,67,216700799,67079,Croettwiller,182,179,3
44,67,216700807,67080,Dachstein,1832,1811,21
44,67,216700815,67081,Dahlenheim,800,788,12
44,67,216700823,67082,Dalhunden,1234,1224,10
44,67,216700831,67083,Dambach,775,763,12
44,67,216700849,67084,Dambach-la-Ville,2269,2228,41
44,67,216700856,67085,Dangolsheim,716,705,11
44,67,216700864,67086,Daubensand,458,448,10
44,67,216700872,67087,Dauendorf,1456,1441,15
44,67,216700880,67088,Dehlingen,356,349,7
44,67,216700898,67089,Dettwiller,2628,2595,33
44,67,216700906,67090,Diebolsheim,715,672,43
44,67,216700914,67091,Diedendorf,353,340,13
44,67,216700922,67092,Dieffenbach-au-Val,659,633,26
44,67,216700930,67093,Dieffenbach-lès-Woerth,353,347,6
44,67,216700948,67094,Dieffenthal,253,251,2
44,67,216700955,67095,Diemeringen,1632,1598,34
44,67,216700963,67096,Dimbsthal,333,322,11
44,67,216700971,67097,Dingsheim,1228,1210,18
44,67,216700989,67098,Dinsheim-sur-Bruche,1534,1515,19
44,67,216700997,67099,Domfessel,286,280,6
44,67,216701003,67100,Donnenheim,355,354,1
44,67,216701011,67101,Dorlisheim,2637,2605,32
44,67,216701029,67102,Dossenheim-Kochersberg,312,308,4
44,67,216701037,67103,Dossenheim-sur-Zinsel,1064,1039,25
44,67,216701045,67104,Drachenbronn-Birlenbach,616,602,14
44,67,216701052,67105,Drulingen,1456,1429,27
44,67,216701060,67106,Drusenheim,5301,5254,47
44,67,216701078,67107,Duntzenheim,664,656,8
44,67,216701086,67108,Duppigheim,1742,1723,19
44,67,216701094,67109,Durningen,675,666,9
44,67,216701102,67110,Durrenbach,1113,1097,16
44,67,216701110,67111,Durstel,433,422,11
44,67,216701128,67112,Duttlenheim,2877,2848,29
44,67,216701136,67113,Eberbach-Seltz,435,426,9
44,67,216701151,67115,Ebersheim,2307,2287,20
44,67,216701169,67116,Ebersmunster,573,542,31
44,67,216701177,67117,Eckartswiller,433,430,3
44,67,216701185,67118,Eckbolsheim,7208,7143,65
44,67,216701193,67119,Eckwersheim,1395,1378,17
44,67,216701201,67120,Eichhoffen,537,526,11
44,67,216701219,67121,Elsenheim,813,802,11
44,67,216701227,67122,Wangenbourg-Engenthal,1353,1335,18
44,67,216701235,67123,Engwiller,490,486,4
44,67,216701243,67124,Entzheim,2510,2485,25
44,67,216701250,67125,Epfig,2331,2255,76
44,67,216701268,67126,Erckartswiller,305,299,6
44,67,216701276,67127,Ergersheim,1457,1443,14
44,67,216701284,67128,Ernolsheim-Bruche,1904,1887,17
44,67,216701292,67129,Ernolsheim-lès-Saverne,601,595,6
44,67,216701300,67130,Erstein,10850,10739,111
44,67,216701318,67131,Eschau,5708,5645,63
44,67,216701326,67132,Eschbach,974,963,11
44,67,216701334,67133,Eschbourg,478,466,12
44,67,216701342,67134,Eschwiller,188,185,3
44,67,216701359,67135,Ettendorf,764,759,5
44,67,216701367,67136,Eywiller,280,275,5
44,67,216701375,67137,Fegersheim,5845,5777,68
44,67,216701383,67138,Fessenheim-le-Bas,588,580,8
44,67,216701391,67139,Flexbourg,492,483,9
44,67,216701409,67140,Forstfeld,776,772,4
44,67,216701417,67141,Forstheim,598,594,4
44,67,216701425,67142,Fort-Louis,290,288,2
44,67,216701433,67143,Fouchy,655,636,19
44,67,216701441,67144,Fouday,345,342,3
44,67,216701458,67145,Friedolsheim,276,270,6
44,67,216701466,67146,Friesenheim,621,613,8
44,67,216701474,67147,Froeschwiller,500,495,5
44,67,216701482,67148,Frohmuhl,165,161,4
44,67,216701490,67149,Furchhausen,428,421,7
44,67,216701508,67150,Furdenheim,1482,1458,24
44,67,216701516,67151,Gambsheim,5216,5164,52
44,67,216701524,67152,Geispolsheim,7682,7603,79
44,67,200077923,67153,Geiswiller-Zoebersdorf,395,392,3
44,67,216701540,67154,Gerstheim,3508,3452,56
44,67,216701557,67155,Gertwiller,1279,1266,13
44,67,216701565,67156,Geudertheim,2655,2631,24
44,67,216701599,67159,Goerlingen,210,204,6
44,67,216701607,67160,Goersdorf,1085,1057,28
44,67,216701615,67161,Gottenhouse,387,376,11
44,67,216701623,67162,Gottesheim,364,356,8
44,67,216701631,67163,Gougenheim,556,543,13
44,67,216701649,67164,Goxwiller,854,834,20
44,67,216701656,67165,Grandfontaine,384,376,8
44,67,216701664,67166,Grassendorf,261,253,8
44,67,216701672,67167,Grendelbruch,1242,1226,16
44,67,216701680,67168,Gresswiller,1676,1650,26
44,67,216701698,67169,Gries,2914,2879,35
44,67,216701722,67172,Griesheim-près-Molsheim,2297,2266,31
44,67,216701730,67173,Griesheim-sur-Souffel,1255,1238,17
44,67,216701748,67174,Gumbrechtshoffen,1169,1148,21
44,67,216701763,67176,Gundershoffen,3821,3758,63
44,67,216701771,67177,Gunstett,645,635,10
44,67,216701789,67178,Gungwiller,287,283,4
44,67,216701797,67179,Haegen,661,653,8
44,67,216701805,67180,Haguenau,36009,35448,561
44,67,216701813,67181,Handschuheim,280,274,6
44,67,216701821,67182,Hangenbieten,1721,1696,25
44,67,216701839,67183,Harskirchen,897,882,15
44,67,216701847,67184,Hatten,1925,1901,24
44,67,216701854,67185,Hattmatt,687,678,9
44,67,216701862,67186,Hegeney,443,437,6
44,67,216701870,67187,Heidolsheim,565,557,8
44,67,216701888,67188,Heiligenberg,714,703,11
44,67,216701896,67189,Heiligenstein,978,949,29
44,67,216701904,67190,Hengwiller,199,197,2
44,67,216701912,67191,Herbitzheim,1866,1840,26
44,67,216701920,67192,Herbsheim,957,946,11
44,67,216701946,67194,Herrlisheim,4737,4666,71
44,67,216701953,67195,Hessenheim,626,616,10
44,67,216701961,67196,Hilsenheim,2674,2638,36
44,67,216701979,67197,Hindisheim,1547,1527,20
44,67,216701987,67198,Hinsbourg,116,113,3
44,67,216701995,67199,Hinsingen,81,80,1
44,67,216702001,67200,Hipsheim,1007,1000,7
44,67,216702019,67201,Hirschland,306,302,4
44,67,200063170,67202,Hochfelden,4101,4045,56
44,67,216702035,67203,Hochstett,399,396,3
44,67,216702043,67204,Hoenheim,11531,11446,85
44,67,216702050,67205,Hoerdt,4637,4586,51
44,67,216702068,67206,Hoffen,1155,1137,18
44,67,216702084,67208,Hohengoeft,550,543,7
44,67,216702092,67209,Hohfrankenheim,275,273,2
44,67,216702100,67210,Le Hohwald,516,504,12
44,67,216702126,67212,Holtzheim,3850,3821,29
44,67,216702134,67213,Hunspach,640,624,16
44,67,216702142,67214,Hurtigheim,1004,997,7
44,67,216702159,67215,Huttendorf,502,499,3
44,67,216702167,67216,Huttenheim,2696,2658,38
44,67,216702175,67217,Ichtratzheim,381,376,5
44,67,216702183,67218,Illkirch-Graffenstaden,27671,27087,584
44,67,216702209,67220,Ingenheim,345,343,2
44,67,216702217,67221,Ingolsheim,353,348,5
44,67,216702225,67222,Ingwiller,4067,4029,38
44,67,216702233,67223,Innenheim,1215,1202,13
44,67,216702258,67225,Issenhausen,115,113,2
44,67,216702266,67226,Ittenheim,2121,2098,23
44,67,216702274,67227,Itterswiller,237,231,6
44,67,216702282,67228,Neugartheim-Ittlenheim,804,787,17
44,67,216702290,67229,Jetterswiller,199,197,2
44,67,216702308,67230,Kaltenhouse,2482,2463,19
44,67,216702316,67231,Kauffenheim,214,212,2
44,67,216702324,67232,Keffenach,210,204,6
44,67,216702332,67233,Kertzfeld,1217,1197,20
44,67,216702340,67234,Keskastel,1530,1501,29
44,67,216702357,67235,Kesseldorf,440,438,2
44,67,216702365,67236,Kienheim,555,545,10
44,67,216702373,67237,Kilstett,2539,2503,36
44,67,216702381,67238,Kindwiller,647,641,6
44,67,216702399,67239,Kintzheim,1697,1670,27
44,67,216702407,67240,Kirchheim,724,712,12
44,67,216702415,67241,Kirrberg,151,147,4
44,67,216702423,67242,Kirrwiller,540,535,5
44,67,216702449,67244,Kleingoeft,157,154,3
44,67,216702456,67245,Knoersheim,202,199,3
44,67,216702464,67246,Kogenheim,1292,1274,18
44,67,216702472,67247,Kolbsheim,1007,986,21
44,67,216702480,67248,Krautergersheim,1754,1728,26
44,67,216702498,67249,Krautwiller,238,231,7
44,67,216702506,67250,Kriegsheim,803,787,16
44,67,216702522,67252,Kurtzenhouse,1089,1076,13
44,67,216702530,67253,Kuttolsheim,653,644,9
44,67,216702548,67254,Kutzenhausen,933,917,16
44,67,216702555,67255,Lalaye,491,482,9
44,67,216702563,67256,Lampertheim,3513,3459,54
44,67,216702571,67257,Lampertsloch,718,703,15
44,67,216702589,67258,Landersheim,194,191,3
44,67,216702597,67259,Langensoultzbach,923,912,11
44,67,216702605,67260,Laubach,324,319,5
44,67,216702613,67261,Lauterbourg,2368,2341,27
44,67,216702639,67263,Lembach,1593,1551,42
44,67,216702647,67264,Leutenheim,840,828,12
44,67,216702654,67265,Lichtenberg,556,547,9
44,67,216702662,67266,Limersheim,696,688,8
44,67,216702670,67267,Lingolsheim,19943,19797,146
44,67,216702688,67268,Lipsheim,2696,2666,30
44,67,216702696,67269,Littenheim,306,303,3
44,67,216702704,67270,Lixhausen,385,381,4
44,67,216702712,67271,Lobsann,660,652,8
44,67,216702720,67272,Lochwiller,399,393,6
44,67,216702738,67273,Lohr,523,516,7
44,67,216702746,67274,Lorentzen,244,240,4
44,67,216702753,67275,Lupstein,826,812,14
44,67,216702761,67276,Lutzelhouse,1928,1893,35
44,67,216702779,67277,Mackenheim,768,757,11
44,67,216702787,67278,Mackwiller,555,543,12
44,67,216702795,67279,Maennolsheim,239,234,5
44,67,216702803,67280,Maisonsgoutte,813,795,18
44,67,216702811,67281,Marckolsheim,4276,4234,42
44,67,216702829,67282,Marlenheim,4294,4230,64
44,67,216702837,67283,Marmoutier,2756,2712,44
44,67,216702852,67285,Matzenheim,1585,1475,110
44,67,216702860,67286,Meistratzheim,1513,1494,19
44,67,216702878,67287,Melsheim,586,575,11
44,67,216702886,67288,Memmelshoffen,333,329,4
44,67,216702894,67289,Menchhoffen,645,634,11
44,67,216702902,67290,Merkwiller-Pechelbronn,942,925,17
44,67,216702910,67291,Mertzwiller,3415,3376,39
44,67,216702928,67292,Mietesheim,683,672,11
44,67,216702936,67293,Minversheim,693,681,12
44,67,216702951,67295,Mittelbergheim,628,605,23
44,67,216702969,67296,Mittelhausbergen,2131,2107,24
44,67,216702985,67298,Mittelschaeffolsheim,574,566,8
44,67,216702993,67299,Mollkirch,921,896,25
44,67,216703009,67300,Molsheim,9478,9352,126
44,67,216703017,67301,Mommenheim,2263,2241,22
44,67,216703025,67302,Monswiller,2049,2013,36
44,67,216703033,67303,Morsbronn-les-Bains,692,680,12
44,67,216703041,67304,Morschwiller,598,588,10
44,67,216703058,67305,Mothern,1966,1945,21
44,67,216703066,67306,Muhlbach-sur-Bruche,695,641,54
44,67,216703074,67307,Mulhausen,455,450,5
44,67,216703082,67308,Munchhausen,820,811,9
44,67,216703090,67309,Mundolsheim,4981,4911,70
44,67,216703108,67310,Mussig,1174,1154,20
44,67,216703116,67311,Muttersholtz,2227,2198,29
44,67,216703124,67312,Mutzenhouse,471,469,2
44,67,216703132,67313,Mutzig,6136,6083,53
44,67,216703140,67314,Natzwiller,538,530,8
44,67,216703157,67315,Neewiller-près-Lauterbourg,684,670,14
44,67,216703173,67317,Neubois,675,658,17
44,67,216703199,67319,Neuhaeusel,398,395,3
44,67,216703207,67320,Neuve-Église,631,619,12
44,67,216703215,67321,Neuviller-la-Roche,334,326,8
44,67,216703223,67322,Neuwiller-lès-Saverne,1120,1107,13
44,67,216703249,67324,Niederbronn-les-Bains,4438,4369,69
44,67,216703256,67325,Niederhaslach,1412,1395,17
44,67,216703264,67326,Niederhausbergen,1682,1669,13
44,67,216703272,67327,Niederlauterbach,977,955,22
44,67,216703280,67328,Niedermodern,890,883,7
44,67,216703298,67329,Niedernai,1289,1267,22
44,67,216703306,67330,Niederroedern,930,916,14
44,67,216703314,67331,Niederschaeffolsheim,1383,1365,18
44,67,216703330,67333,Niedersoultzbach,297,292,5
44,67,216703348,67334,Niedersteinbach,116,115,1
44,67,216703355,67335,Nordheim,946,932,14
44,67,216703363,67336,Nordhouse,1769,1739,30
44,67,216703371,67337,Nothalten,471,455,16
44,67,216703389,67338,Obenheim,1394,1371,23
44,67,216703397,67339,Betschdorf,4235,4192,43
44,67,216703405,67340,Oberbronn,1528,1508,20
44,67,216703413,67341,Oberdorf-Spachbach,406,404,2
44,67,216703421,67342,Oberhaslach,1792,1763,29
44,67,216703439,67343,Oberhausbergen,5516,5459,57
44,67,216703447,67344,Oberhoffen-lès-Wissembourg,319,315,4
44,67,216703454,67345,Oberhoffen-sur-Moder,3678,3650,28
44,67,216703462,67346,Oberlauterbach,563,552,11
44,67,216703470,67347,Obermodern-Zutzendorf,1734,1713,21
44,67,216703488,67348,Obernai,12471,12015,456
44,67,216703496,67349,Oberroedern,530,524,6
44,67,216703504,67350,Oberschaeffolsheim,2465,2438,27
44,67,216703512,67351,Seebach,1715,1673,42
44,67,216703520,67352,Obersoultzbach,405,397,8
44,67,216703538,67353,Obersteinbach,235,232,3
44,67,216703546,67354,Odratzheim,532,523,9
44,67,216703553,67355,Oermingen,1153,1125,28
44,67,216703561,67356,Offendorf,2538,2506,32
44,67,216703587,67358,Offwiller,818,805,13
44,67,216703595,67359,Ohlungen,1332,1309,23
44,67,216703603,67360,Ohnenheim,1100,1086,14
44,67,216703611,67361,Olwisheim,508,501,7
44,67,216703629,67362,Orschwiller,615,603,12
44,67,216703637,67363,Osthoffen,828,811,17
44,67,216703645,67364,Osthouse,940,924,16
44,67,216703652,67365,Ostwald,13118,12985,133
44,67,216703660,67366,Ottersthal,814,795,19
44,67,216703678,67367,Otterswiller,1343,1311,32
44,67,216703686,67368,Ottrott,1584,1552,32
44,67,216703694,67369,Ottwiller,256,255,1
44,67,216703702,67370,Petersbach,677,665,12
44,67,216703710,67371,La Petite-Pierre,626,623,3
44,67,200086940,67372,Val-de-Moder,5075,5012,63
44,67,216703736,67373,Pfalzweyer,326,322,4
44,67,216703751,67375,Pfulgriesheim,1321,1304,17
44,67,216703777,67377,Plaine,1010,999,11
44,67,216703785,67378,Plobsheim,4523,4475,48
44,67,216703793,67379,Preuschdorf,914,898,16
44,67,216703801,67380,Printzheim,208,204,4
44,67,216703819,67381,Puberg,366,361,5
44,67,216703827,67382,Quatzenheim,789,772,17
44,67,216703835,67383,Rangen,202,197,5
44,67,216703843,67384,Ranrupt,316,309,7
44,67,216703850,67385,Ratzwiller,243,241,2
44,67,216703868,67386,Rauwiller,210,208,2
44,67,216703876,67387,Reichsfeld,309,300,9
44,67,216703884,67388,Reichshoffen,5494,5416,78
44,67,216703892,67389,Reichstett,4431,4389,42
44,67,216703918,67391,Reinhardsmunster,456,450,6
44,67,216703926,67392,Reipertswiller,859,846,13
44,67,216703942,67394,Retschwiller,282,276,6
44,67,216703959,67395,Reutenbourg,408,398,10
44,67,216703967,67396,Rexingen,203,202,1
44,67,216703975,67397,Rhinau,2682,2651,31
44,67,216703983,67398,Richtolsheim,366,364,2
44,67,216704007,67400,Riedseltz,1138,1119,19
44,67,216704015,67401,Rimsdorf,318,309,9
44,67,216704031,67403,Ringendorf,469,459,10
44,67,216704049,67404,Rittershoffen,926,910,16
44,67,216704056,67405,Roeschwoog,2334,2283,51
44,67,216705681,67406,Rohr,354,351,3
44,67,216704072,67407,Rohrwiller,1611,1598,13
44,67,216704080,67408,Romanswiller,1209,1192,17
44,67,216704098,67409,Roppenheim,1022,1014,8
44,67,216704106,67410,Rosenwiller,666,652,14
44,67,216704114,67411,Rosheim,5427,5312,115
44,67,216704122,67412,Rossfeld,1028,1019,9
44,67,216704130,67413,Rosteig,518,505,13
44,67,216704148,67414,Rothau,1551,1529,22
44,67,216704155,67415,Rothbach,473,471,2
44,67,216704163,67416,Rott,478,468,10
44,67,216704171,67417,Rottelsheim,305,296,9
44,67,200082303,67418,Rountzenheim-Auenheim,1984,1953,31
44,67,216704205,67420,Russ,1256,1241,15
44,67,216704213,67421,Saales,835,824,11
44,67,216704221,67422,Saasenheim,598,588,10
44,67,216704239,67423,Saessolsheim,604,597,7
44,67,216704247,67424,Saint-Blaise-la-Roche,250,250,0
44,67,216704254,67425,Saint-Jean-Saverne,548,535,13
44,67,216704262,67426,Saint-Martin,365,364,1
44,67,216704270,67427,Saint-Maurice,352,338,14
44,67,216704288,67428,Saint-Nabor,505,498,7
44,67,216704296,67429,Saint-Pierre,627,617,10
44,67,216704304,67430,Saint-Pierre-Bois,777,752,25
44,67,216704320,67432,Salmbach,596,586,10
44,67,216704338,67433,Sand,1399,1389,10
44,67,216704346,67434,Sarre-Union,2836,2791,45
44,67,216704353,67435,Sarrewerden,852,831,21
44,67,216704361,67436,Saulxures,509,497,12
44,67,216704379,67437,Saverne,11602,11303,299
44,67,216704387,67438,Schaeffersheim,823,810,13
44,67,216704403,67440,Schaffhouse-près-Seltz,569,557,12
44,67,216704411,67441,Schalkendorf,340,335,5
44,67,216704429,67442,Scharrachbergheim-Irmstett,1304,1243,61
44,67,216704437,67443,Scheibenhard,873,853,20
44,67,216704445,67444,Scherlenheim,121,118,3
44,67,216704452,67445,Scherwiller,3244,3185,59
44,67,216704460,67446,Schillersdorf,435,424,11
44,67,216704478,67447,Schiltigheim,34206,33993,213
44,67,216704486,67448,Schirmeck,2180,2132,48
44,67,216704494,67449,Schirrhein,2293,2271,22
44,67,216704502,67450,Schirrhoffen,731,715,16
44,67,216704510,67451,Schleithal,1415,1383,32
44,67,216704528,67452,Schnersheim,1816,1783,33
44,67,216704536,67453,Schoenau,628,620,8
44,67,216704544,67454,Schoenbourg,393,386,7
44,67,216704551,67455,Schoenenbourg,705,694,11
44,67,216704569,67456,Schopperten,454,438,16
44,67,216704585,67458,Schweighouse-sur-Moder,5045,4983,62
44,67,216704593,67459,Schwenheim,764,747,17
44,67,216704601,67460,Schwindratzheim,1775,1754,21
44,67,216704619,67461,Schwobsheim,343,329,14
44,67,216704627,67462,Sélestat,19530,19279,251
44,67,216704635,67463,Seltz,3185,3150,35
44,67,216704643,67464,Sermersheim,958,945,13
44,67,216704650,67465,Sessenheim,2345,2319,26
44,67,216704668,67466,Siegen,516,507,9
44,67,216704676,67467,Siewiller,388,381,7
44,67,216704684,67468,Siltzheim,635,619,16
44,67,216704700,67470,Solbach,98,97,1
44,67,216704718,67471,Souffelweyersheim,8120,8057,63
44,67,216704726,67472,Soufflenheim,4850,4796,54
44,67,216704734,67473,Soultz-les-Bains,974,956,18
44,67,216704742,67474,Soultz-sous-Forêts,3206,3169,37
44,67,216704759,67475,Sparsbach,238,234,4
44,67,216704767,67476,Stattmatten,754,749,5
44,67,216704775,67477,Steige,625,614,11
44,67,216704783,67478,Steinbourg,1963,1934,29
44,67,216704791,67479,Steinseltz,613,602,11
44,67,216704809,67480,Still,1832,1806,26
44,67,216704817,67481,Stotzheim,1095,1081,14
44,67,216704825,67482,Strasbourg,293538,290576,2962
44,67,216704833,67483,Struth,228,224,4
44,67,216704841,67484,Stundwiller,494,484,10
44,67,216704858,67485,Stutzheim-Offenheim,1689,1662,27
44,67,216704866,67486,Sundhouse,1857,1837,20
44,67,216704874,67487,Surbourg,1741,1715,26
44,67,216704882,67488,Thal-Drulingen,188,184,4
44,67,216704890,67489,Thal-Marmoutier,845,828,17
44,67,216704908,67490,Thanvillé,615,598,17
44,67,216704916,67491,Tieffenbach,251,250,1
44,67,216704924,67492,Traenheim,668,651,17
44,67,216704932,67493,Triembach-au-Val,446,436,10
44,67,216704940,67494,Trimbach,594,583,11
44,67,200057321,67495,Truchtersheim,4487,4386,101
44,67,216704973,67497,Uhlwiller,698,684,14
44,67,216704981,67498,Uhrwiller,714,707,7
44,67,216704999,67499,Urbeis,330,316,14
44,67,216705004,67500,Urmatt,1489,1452,37
44,67,216705012,67501,Uttenheim,565,561,4
44,67,216705020,67502,Uttenhoffen,210,209,1
44,67,216705038,67503,Uttwiller,162,160,2
44,67,216705046,67504,Valff,1393,1383,10
44,67,216705053,67505,La Vancelle,414,401,13
44,67,216705061,67506,Vendenheim,6080,6010,70
44,67,216705079,67507,Villé,1818,1786,32
44,67,216705087,67508,Voellerdingen,438,420,18
44,67,216705095,67509,Volksberg,353,350,3
44,67,216705103,67510,Wahlenheim,607,603,4
44,67,216705111,67511,Walbourg,1186,935,251
44,67,216705137,67513,Waldersbach,127,126,1
44,67,216705145,67514,Waldhambach,647,638,9
44,67,216705152,67515,Waldolwisheim,571,562,9
44,67,216705160,67516,Waltenheim-sur-Zorn,677,670,7
44,67,216705178,67517,Wangen,665,654,11
44,67,216705194,67519,La Wantzenau,6022,5909,113
44,67,216705202,67520,Wasselonne,5821,5755,66
44,67,216705210,67521,Weinbourg,462,459,3
44,67,216705228,67522,Weislingen,556,548,8
44,67,216705236,67523,Weitbruch,2774,2738,36
44,67,216705244,67524,Weiterswiller,529,521,8
44,67,216705251,67525,Westhoffen,1677,1653,24
44,67,216705269,67526,Westhouse,1616,1599,17
44,67,216705277,67527,Westhouse-Marmoutier,356,349,7
44,67,216705285,67528,Weyer,561,548,13
44,67,216705293,67529,Weyersheim,3453,3419,34
44,67,216705301,67530,Wickersheim-Wilshausen,389,383,6
44,67,216705319,67531,Wildersbach,290,284,6
44,67,216705327,67532,Willgottheim,1098,1081,17
44,67,216705343,67534,Wilwisheim,738,735,3
44,67,216705350,67535,Wimmenau,1076,1055,21
44,67,216705368,67536,Windstein,164,163,1
44,67,216705376,67537,Wingen,455,449,6
44,67,216705384,67538,Wingen-sur-Moder,1605,1581,24
44,67,200058303,67539,Wingersheim les Quatre Bans,2378,2339,39
44,67,216705400,67540,Wintershouse,876,864,12
44,67,216705418,67541,Wintzenbach,534,532,2
44,67,216705426,67542,Wintzenheim-Kochersberg,520,516,4
44,67,216705434,67543,Wisches,2106,2077,29
44,67,216705442,67544,Wissembourg,7709,7492,217
44,67,216705459,67545,Witternheim,507,501,6
44,67,216705467,67546,Wittersheim,696,691,5
44,67,216705475,67547,Wittisheim,2097,2067,30
44,67,216705483,67548,Wiwersheim,887,873,14
44,67,216705509,67550,Woerth,1740,1716,24
44,67,216705517,67551,Wolfisheim,4226,4171,55
44,67,216705525,67552,Wolfskirchen,360,350,10
44,67,216705533,67553,Wolschheim,321,317,4
44,67,216705541,67554,Wolxheim,980,967,13
44,67,216705558,67555,Zehnacker,251,248,3
44,67,216705566,67556,Zeinheim,213,210,3
44,67,216705574,67557,Zellwiller,819,807,12
44,67,216705582,67558,Zinswiller,750,737,13
44,67,216705590,67559,Zittersheim,255,253,2
44,68,216800011,68001,Algolsheim,1136,1125,11
44,68,216800029,68002,Altenach,394,390,4
44,68,216800045,68004,Altkirch,5787,5658,129
44,68,216800052,68005,Ammerschwihr,1738,1705,33
44,68,200055580,68006,Bernwiller,1237,1208,29
44,68,216800078,68007,Andolsheim,2265,2192,73
44,68,216800086,68008,Appenwihr,592,580,12
44,68,216800094,68009,Artzenheim,875,864,11
44,68,216800102,68010,Aspach,1149,1127,22
44,68,216800110,68011,Aspach-le-Bas,1328,1302,26
44,68,200053478,68012,Aspach-Michelbach,1811,1767,44
44,68,216800136,68013,Attenschwiller,1012,989,23
44,68,216800144,68014,Aubure,373,363,10
44,68,216800151,68015,Baldersheim,2685,2636,49
44,68,216800169,68016,Balgau,984,970,14
44,68,216800177,68017,Ballersdorf,829,812,17
44,68,216800185,68018,Balschwiller,766,749,17
44,68,216800193,68019,Baltzenheim,571,562,9
44,68,216800201,68020,Bantzenheim,1637,1605,32
44,68,216800219,68021,Bartenheim,4149,4062,87
44,68,216800227,68022,Battenheim,1601,1580,21
44,68,216800235,68023,Beblenheim,960,938,22
44,68,216800243,68024,Bellemagny,153,148,5
44,68,216800250,68025,Bendorf,248,245,3
44,68,216800268,68026,Bennwihr,1396,1373,23
44,68,216800276,68027,Berentzwiller,352,341,11
44,68,216800284,68028,Bergheim,2120,2072,48
44,68,216800292,68029,Bergholtz,1135,1103,32
44,68,216800300,68030,Bergholtzzell,425,413,12
44,68,216800326,68032,Berrwiller,1241,1204,37
44,68,216800334,68033,Bettendorf,456,448,8
44,68,216800342,68034,Bettlach,325,310,15
44,68,216800359,68035,Biederthal,332,325,7
44,68,216800367,68036,Biesheim,2565,2510,55
44,68,216800375,68037,Biltzheim,487,478,9
44,68,216800383,68038,Bischwihr,1159,1134,25
44,68,216800391,68039,Bisel,557,543,14
44,68,216800409,68040,Bitschwiller-lès-Thann,2039,2002,37
44,68,216800417,68041,Blodelsheim,2012,1986,26
44,68,216800425,68042,Blotzheim,4898,4777,121
44,68,216800433,68043,Bollwiller,4174,4119,55
44,68,216800441,68044,Le Bonhomme,765,745,20
44,68,216800458,68045,Bourbach-le-Bas,568,552,16
44,68,216800466,68046,Bourbach-le-Haut,424,415,9
44,68,216800490,68049,Bouxwiller,444,429,15
44,68,216800508,68050,Bréchaumont,419,405,14
44,68,216800516,68051,Breitenbach-Haut-Rhin,833,819,14
44,68,216800524,68052,Bretten,189,186,3
44,68,216800540,68054,Brinckheim,429,421,8
44,68,216800557,68055,Bruebach,1082,1048,34
44,68,200057909,68056,Brunstatt-Didenheim,8297,8168,129
44,68,216800573,68057,Buethwiller,276,267,9
44,68,216800581,68058,Buhl,3326,3277,49
44,68,216800599,68059,Burnhaupt-le-Bas,1971,1928,43
44,68,216800607,68060,Burnhaupt-le-Haut,1790,1744,46
44,68,216800615,68061,Buschwiller,1083,1066,17
44,68,216800623,68062,Carspach,2172,2082,90
44,68,216800631,68063,Cernay,11769,11559,210
44,68,216800649,68064,Chalampé,987,978,9
44,68,216800656,68065,Chavannes-sur-l'Étang,702,690,12
44,68,216800664,68066,Colmar,69398,68294,1104
44,68,216800672,68067,Courtavon,352,350,2
44,68,216800680,68068,Dannemarie,2305,2266,39
44,68,216800698,68069,Dessenheim,1497,1477,20
44,68,216800714,68071,Diefmatten,290,284,6
44,68,216800722,68072,Dietwiller,1475,1422,53
44,68,216800730,68073,Dolleren,486,475,11
44,68,216800748,68074,Durlinsdorf,559,552,7
44,68,216800755,68075,Durmenach,845,829,16
44,68,216800763,68076,Durrenentzen,1021,1009,12
44,68,216800771,68077,Eglingen,388,378,10
44,68,216800789,68078,Eguisheim,1763,1722,41
44,68,216800797,68079,Elbach,256,256,0
44,68,216800805,68080,Emlingen,310,307,3
44,68,216800813,68081,Saint-Bernard,589,579,10
44,68,216800821,68082,Ensisheim,7545,7475,70
44,68,216800839,68083,Eschbach-au-Val,376,368,8
44,68,216800847,68084,Eschentzwiller,1522,1476,46
44,68,216800854,68085,Eteimbes,387,381,6
44,68,216800862,68086,Falkwiller,211,208,3
44,68,216800870,68087,Feldbach,471,460,11
44,68,216800888,68088,Feldkirch,1015,999,16
44,68,216800896,68089,Fellering,1625,1599,26
44,68,216800904,68090,Ferrette,833,820,13
44,68,216800912,68091,Fessenheim,2328,2282,46
44,68,216800920,68092,Fislis,405,399,6
44,68,216800938,68093,Flaxlanden,1450,1415,35
44,68,216800946,68094,Folgensbourg,947,928,19
44,68,216800953,68095,Fortschwihr,1202,1162,40
44,68,216800961,68096,Franken,375,370,5
44,68,216800979,68097,Fréland,1343,1310,33
44,68,216800987,68098,Friesen,663,656,7
44,68,216800995,68099,Froeningen,849,831,18
44,68,216801001,68100,Fulleren,354,340,14
44,68,216801019,68101,Galfingue,839,816,23
44,68,216801027,68102,Geishouse,448,438,10
44,68,216801035,68103,Geispitzen,517,505,12
44,68,216801043,68104,Geiswasser,314,309,5
44,68,216801050,68105,Gildwiller,275,261,14
44,68,216801068,68106,Goldbach-Altenbach,282,276,6
44,68,216801076,68107,Gommersdorf,390,382,8
44,68,216801092,68109,Griesbach-au-Val,705,691,14
44,68,216801100,68110,Grussenheim,812,794,18
44,68,216801118,68111,Gueberschwihr,885,859,26
44,68,216801126,68112,Guebwiller,11281,10988,293
44,68,216801134,68113,Guémar,1460,1432,28
44,68,216801142,68114,Guevenatten,145,144,1
44,68,216801159,68115,Guewenheim,1341,1312,29
44,68,216801167,68116,Gundolsheim,747,725,22
44,68,216801175,68117,Gunsbach,896,880,16
44,68,216801183,68118,Habsheim,5142,5052,90
44,68,216801191,68119,Hagenbach,769,753,16
44,68,216801209,68120,Hagenthal-le-Bas,1303,1275,28
44,68,216801217,68121,Hagenthal-le-Haut,734,719,15
44,68,216801225,68122,Hartmannswiller,656,646,10
44,68,216801233,68123,Hattstatt,821,809,12
44,68,216801241,68124,Hausgauen,388,378,10
44,68,216801258,68125,Hecken,538,529,9
44,68,216801266,68126,Hégenheim,3435,3362,73
44,68,216801274,68127,Heidwiller,680,666,14
44,68,216801282,68128,Heimersdorf,668,659,9
44,68,216801290,68129,Heimsbrunn,1383,1333,50
44,68,216801308,68130,Heiteren,1069,1047,22
44,68,216801316,68131,Heiwiller,165,164,1
44,68,216801324,68132,Helfrantzkirch,745,728,17
44,68,216801340,68134,Herrlisheim-près-Colmar,1898,1870,28
44,68,216801357,68135,Hésingue,2861,2804,57
44,68,216801365,68136,Hettenschlag,344,332,12
44,68,216801373,68137,Hindlingen,627,616,11
44,68,216801381,68138,Hirsingue,2170,2120,50
44,68,216801399,68139,Hirtzbach,1499,1477,22
44,68,216801407,68140,Hirtzfelden,1328,1313,15
44,68,216801415,68141,Hochstatt,2234,2179,55
44,68,216801423,68142,Hohrod,388,375,13
44,68,200058683,68143,Porte du Ried,1903,1843,60
44,68,216801449,68144,Hombourg,1374,1348,26
44,68,216801456,68145,Horbourg-Wihr,6365,6244,121
44,68,216801464,68146,Houssen,2428,2405,23
44,68,216801472,68147,Hunawihr,602,587,15
44,68,216801480,68148,Hundsbach,377,359,18
44,68,216801498,68149,Huningue,7379,7283,96
44,68,216801506,68150,Husseren-les-Châteaux,524,509,15
44,68,216801514,68151,Husseren-Wesserling,1060,1049,11
44,68,216801522,68152,Illfurth,2529,2464,65
44,68,216801530,68153,Illhaeusern,740,727,13
44,68,216801548,68154,Illzach,14585,14380,205
44,68,216801555,68155,Ingersheim,4755,4680,75
44,68,216801563,68156,Issenheim,3506,3449,57
44,68,216801571,68157,Jebsheim,1388,1349,39
44,68,216801589,68158,Jettingen,515,500,15
44,68,216801597,68159,Jungholtz,942,917,25
44,68,216801605,68160,Kappelen,608,584,24
44,68,216801613,68161,Katzenthal,561,538,23
44,68,200052603,68162,Kaysersberg Vignoble,4505,4412,93
44,68,216801639,68163,Kembs,5721,5617,104
44,68,216801654,68165,Kiffis,249,239,10
44,68,216801662,68166,Kingersheim,13391,13230,161
44,68,216801670,68167,Kirchberg,749,728,21
44,68,216801688,68168,Knoeringue,380,373,7
44,68,216801696,68169,Koestlach,514,504,10
44,68,216801704,68170,Koetzingue,604,580,24
44,68,216801712,68171,Kruth,949,937,12
44,68,216801720,68172,Kunheim,1850,1820,30
44,68,216801738,68173,Labaroche,2187,2111,76
44,68,216801746,68174,Landser,1673,1646,27
44,68,216801753,68175,Lapoutroie,1890,1851,39
44,68,216801761,68176,Largitzen,334,327,7
44,68,216801779,68177,Lautenbach,1517,1479,38
44,68,216801787,68178,Lautenbachzell,965,951,14
44,68,216801795,68179,Lauw,930,915,15
44,68,216801803,68180,Leimbach,947,918,29
44,68,216801811,68181,Levoncourt,254,250,4
44,68,216801829,68182,Leymen,1274,1246,28
44,68,216801837,68183,Liebenswiller,183,179,4
44,68,216801845,68184,Liebsdorf,304,299,5
44,68,216801852,68185,Lièpvre,1694,1664,30
44,68,216801860,68186,Ligsdorf,318,310,8
44,68,216801878,68187,Linsdorf,348,339,9
44,68,216801886,68188,Linthal,600,584,16
44,68,216801894,68189,Logelheim,901,874,27
44,68,216801902,68190,Lucelle,33,33,0
44,68,216801910,68191,Luemschwiller,773,751,22
44,68,216801928,68192,Valdieu-Lutran,438,431,7
44,68,216801936,68193,Luttenbach-près-Munster,767,758,9
44,68,216801944,68194,Lutter,291,286,5
44,68,216801951,68195,Lutterbach,6339,6237,102
44,68,216801969,68196,Magny,303,295,8
44,68,216801977,68197,Magstatt-le-Bas,505,495,10
44,68,216801985,68198,Magstatt-le-Haut,298,290,8
44,68,216801993,68199,Malmerspach,503,501,2
44,68,216802009,68200,Manspach,548,536,12
44,68,200059434,68201,Masevaux-Niederbruck,3759,3682,77
44,68,216802025,68202,Mertzen,200,196,4
44,68,216802033,68203,Merxheim,1302,1275,27
44,68,216802041,68204,Metzeral,1057,1042,15
44,68,216802058,68205,Meyenheim,2026,2005,21
44,68,216802074,68207,Michelbach-le-Bas,715,701,14
44,68,216802082,68208,Michelbach-le-Haut,602,590,12
44,68,216802090,68209,Mittelwihr,858,842,16
44,68,216802108,68210,Mittlach,336,332,4
44,68,216802116,68211,Mitzach,392,384,8
44,68,216802124,68212,Moernach,528,516,12
44,68,216802132,68213,Mollau,348,339,9
44,68,216802140,68214,Montreux-Jeune,383,375,8
44,68,216802157,68215,Montreux-Vieux,918,911,7
44,68,216802165,68216,Mooslargue,417,411,6
44,68,216802173,68217,Moosch,1643,1622,21
44,68,216802181,68218,Morschwiller-le-Bas,3720,3648,72
44,68,200054930,68219,Le Haut Soultzbach,902,878,24
44,68,216802215,68221,Muespach,949,929,20
44,68,216802223,68222,Muespach-le-Haut,1096,1076,20
44,68,216802231,68223,Muhlbach-sur-Munster,812,795,17
44,68,216802249,68224,Mulhouse,109285,108038,1247
44,68,216802256,68225,Munchhouse,1605,1577,28
44,68,216802264,68226,Munster,4794,4711,83
44,68,216802272,68227,Muntzenheim,1312,1284,28
44,68,216802280,68228,Munwiller,471,459,12
44,68,216802298,68229,Murbach,167,164,3
44,68,216802306,68230,Nambsheim,590,583,7
44,68,216802314,68231,Neuf-Brisach,1970,1955,15
44,68,216802322,68232,Neuwiller,502,495,7
44,68,216802348,68234,Niederentzen,749,738,11
44,68,216802355,68235,Niederhergheim,1164,1148,16
44,68,216802371,68237,Niedermorschwihr,572,557,15
44,68,216802389,68238,Niffer,979,953,26
44,68,216802397,68239,Oberbruck,404,391,13
44,68,200058717,68240,Illtal,1287,1269,18
44,68,216802413,68241,Oberentzen,696,686,10
44,68,216802421,68242,Oberhergheim,1291,1266,25
44,68,216802439,68243,Oberlarg,140,139,1
44,68,216802447,68244,Obermorschwihr,384,378,6
44,68,216802454,68245,Obermorschwiller,420,405,15
44,68,216802462,68246,Obersaasheim,1038,1025,13
44,68,216802470,68247,Oderen,1270,1256,14
44,68,216802488,68248,Oltingue,694,674,20
44,68,216802496,68249,Orbey,3527,3461,66
44,68,216802504,68250,Orschwihr,1060,1042,18
44,68,216802512,68251,Osenbach,864,842,22
44,68,216802520,68252,Ostheim,1689,1660,29
44,68,216802538,68253,Ottmarsheim,2018,1985,33
44,68,216802546,68254,Petit-Landau,844,826,18
44,68,216802553,68255,Pfaffenheim,1392,1350,42
44,68,216802561,68256,Pfastatt,10185,10054,131
44,68,216802579,68257,Pfetterhouse,981,957,24
44,68,216802587,68258,Pulversheim,3176,3097,79
44,68,216802595,68259,Raedersdorf,515,504,11
44,68,216802603,68260,Raedersheim,1146,1121,25
44,68,216802611,68261,Rammersmatt,234,228,6
44,68,216802629,68262,Ranspach,813,796,17
44,68,216802637,68263,Ranspach-le-Bas,643,630,13
44,68,216802645,68264,Ranspach-le-Haut,646,627,19
44,68,216802652,68265,Rantzwiller,824,800,24
44,68,216802660,68266,Réguisheim,2035,2006,29
44,68,216802678,68267,Reiningue,2011,1986,25
44,68,216802686,68268,Retzwiller,711,701,10
44,68,216802694,68269,Ribeauvillé,4847,4670,177
44,68,216802702,68270,Richwiller,3739,3680,59
44,68,216802710,68271,Riedisheim,12562,12258,304
44,68,216802736,68273,Riespach,667,626,41
44,68,216802744,68274,Rimbach-près-Guebwiller,197,195,2
44,68,216802751,68275,Rimbach-près-Masevaux,448,437,11
44,68,216802769,68276,Rimbachzell,198,194,4
44,68,216802777,68277,Riquewihr,1083,1061,22
44,68,216802785,68278,Rixheim,14245,14020,225
44,68,216802793,68279,Roderen,940,910,30
44,68,216802801,68280,Rodern,387,381,6
44,68,216802819,68281,Roggenhouse,478,465,13
44,68,216802827,68282,Romagny,285,280,5
44,68,216802835,68283,Rombach-le-Franc,790,776,14
44,68,216802843,68284,Roppentzwiller,697,686,11
44,68,216802850,68285,Rorschwihr,375,367,8
44,68,216802868,68286,Rosenau,2420,2371,49
44,68,216802876,68287,Rouffach,4416,4187,229
44,68,216802884,68288,Ruederbach,410,406,4
44,68,216802892,68289,Ruelisheim,2421,2384,37
44,68,216802900,68290,Rustenhart,921,902,19
44,68,216802918,68291,Rumersheim-le-Haut,1075,1049,26
44,68,216802926,68292,Saint-Amarin,2255,2217,38
44,68,216802934,68293,Saint-Cosme,82,81,1
44,68,216802942,68294,Sainte-Croix-aux-Mines,1887,1857,30
44,68,216802959,68295,Sainte-Croix-en-Plaine,3091,3024,67
44,68,216802967,68296,Saint-Hippolyte,994,980,14
44,68,216802975,68297,Saint-Louis,23122,22835,287
44,68,216802983,68298,Sainte-Marie-aux-Mines,5182,5054,128
44,68,216802991,68299,Saint-Ulrich,310,310,0
44,68,216803007,68300,Sausheim,5611,5487,124
44,68,216803015,68301,Schlierbach,1295,1271,24
44,68,216803023,68302,Schweighouse-Thann,774,744,30
44,68,216803031,68303,Schwoben,233,226,7
44,68,216803049,68304,Sentheim,1603,1564,39
44,68,216803056,68305,Seppois-le-Bas,1419,1391,28
44,68,216803064,68306,Seppois-le-Haut,510,503,7
44,68,216803072,68307,Sewen,508,498,10
44,68,216803080,68308,Sickert,331,327,4
44,68,216803098,68309,Sierentz,4057,3994,63
44,68,216803114,68311,Sondernach,612,600,12
44,68,216803122,68312,Sondersdorf,323,317,6
44,68,216803130,68313,Soppe-le-Bas,785,774,11
44,68,216803155,68315,Soultz-Haut-Rhin,7176,7033,143
44,68,216803163,68316,Soultzbach-les-Bains,749,728,21
44,68,216803171,68317,Soultzeren,1116,1096,20
44,68,216803189,68318,Soultzmatt,2432,2379,53
44,68,200055713,68320,Spechbach,1445,1398,47
44,68,216803213,68321,Staffelfelden,4088,4053,35
44,68,216803221,68322,Steinbach,1379,1350,29
44,68,216803239,68323,Steinbrunn-le-Bas,854,830,24
44,68,216803247,68324,Steinbrunn-le-Haut,650,631,19
44,68,216803254,68325,Steinsoultz,770,761,9
44,68,216803262,68326,Sternenberg,156,151,5
44,68,216803270,68327,Stetten,353,345,8
44,68,216803288,68328,Storckensohn,202,196,6
44,68,216803296,68329,Stosswihr,1372,1341,31
44,68,216803304,68330,Strueth,347,341,6
44,68,216803312,68331,Sundhoffen,2013,1955,58
44,68,216803320,68332,Tagolsheim,966,953,13
44,68,216803338,68333,Tagsdorf,299,293,6
44,68,216803346,68334,Thann,7932,7784,148
44,68,216803353,68335,Thannenkirch,475,469,6
44,68,216803361,68336,Traubach-le-Bas,463,455,8
44,68,216803379,68337,Traubach-le-Haut,630,619,11
44,68,216803387,68338,Turckheim,3902,3820,82
44,68,216803403,68340,Ueberstrass,385,369,16
44,68,216803411,68341,Uffheim,1019,989,30
44,68,216803429,68342,Uffholtz,1692,1650,42
44,68,216803437,68343,Ungersheim,2455,2422,33
44,68,216803445,68344,Urbès,449,439,10
44,68,216803452,68345,Urschenheim,805,778,27
44,68,216803478,68347,Vieux-Ferrette,689,676,13
44,68,216803486,68348,Vieux-Thann,2873,2836,37
44,68,216803494,68349,Village-Neuf,4581,4486,95
44,68,216803502,68350,Voegtlinshoffen,488,473,15
44,68,216803510,68351,Vogelgrun,647,634,13
44,68,216803528,68352,Volgelsheim,2720,2691,29
44,68,216803536,68353,Wahlbach,504,487,17
44,68,216803544,68354,Walbach,954,918,36
44,68,216803551,68355,Waldighofen,1572,1544,28
44,68,216803569,68356,Walheim,903,883,20
44,68,216803577,68357,Waltenheim,529,513,16
44,68,216803585,68358,Wasserbourg,486,475,11
44,68,216803593,68359,Wattwiller,1737,1678,59
44,68,216803601,68360,Weckolsheim,677,673,4
44,68,216803619,68361,Wegscheid,323,319,4
44,68,216803627,68362,Wentzwiller,789,774,15
44,68,216803635,68363,Werentzhouse,621,609,12
44,68,216803643,68364,Westhalten,1021,998,23
44,68,216803650,68365,Wettolsheim,1840,1775,65
44,68,216803668,68366,Wickerschwihr,727,697,30
44,68,216803676,68367,Widensolen,1216,1195,21
44,68,216803684,68368,Wihr-au-Val,1267,1231,36
44,68,216803700,68370,Wildenstein,165,163,2
44,68,216803718,68371,Willer,316,307,9
44,68,216803726,68372,Willer-sur-Thur,1816,1777,39
44,68,216803734,68373,Winkel,308,296,12
44,68,216803742,68374,Wintzenheim,8257,7933,324
44,68,216803759,68375,Wittelsheim,10500,10358,142
44,68,216803767,68376,Wittenheim,15166,15065,101
44,68,216803775,68377,Wittersdorf,815,796,19
44,68,216803783,68378,Wolfersdorf,377,373,4
44,68,216803791,68379,Wolfgantzen,1120,1099,21
44,68,216803809,68380,Wolschwiller,450,440,10
44,68,216803817,68381,Wuenheim,798,789,9
44,68,216803825,68382,Zaessingue,395,391,4
44,68,216803833,68383,Zellenberg,327,319,8
44,68,216803841,68384,Zillisheim,2585,2524,61
44,68,216803858,68385,Zimmerbach,856,832,24
44,68,216803866,68386,Zimmersheim,1075,1053,22
84,69,216900019,69001,Affoux,397,393,4
84,69,216900027,69002,Aigueperse,245,244,1
84,69,216900035,69003,Albigny-sur-Saône,3025,2982,43
84,69,216900043,69004,Alix,789,766,23
84,69,216900050,69005,Ambérieux,599,589,10
84,69,216900068,69006,Amplepuis,5018,4906,112
84,69,216900076,69007,Ampuis,2787,2743,44
84,69,216900084,69008,Ancy,690,675,15
84,69,216900092,69009,Anse,7907,7754,153
84,69,216900100,69010,L'Arbresle,6591,6437,154
84,69,216900126,69012,Les Ardillats,621,606,15
84,69,216900134,69013,Arnas,4148,4063,85
84,69,216900142,69014,Aveize,1141,1122,19
84,69,216900167,69016,Azolette,125,121,4
84,69,216900175,69017,Bagnols,765,745,20
84,69,216900183,69018,Beaujeu,2176,2144,32
84,69,200084416,69019,Belleville-en-Beaujolais,13616,13336,280
84,69,216900209,69020,Belmont-d'Azergues,703,693,10
84,69,216900217,69021,Bessenay,2424,2346,78
84,69,216900225,69022,Bibost,564,549,15
84,69,216900233,69023,Blacé,1672,1646,26
84,69,200065274,69024,Val d'Oingt,4258,4157,101
84,69,216900266,69026,Le Breuil,549,542,7
84,69,216900274,69027,Brignais,12572,12403,169
84,69,216900282,69028,Brindas,6702,6589,113
84,69,216900290,69029,Bron,42819,42442,377
84,69,216900308,69030,Brullioles,833,819,14
84,69,216900316,69031,Brussieu,1478,1374,104
84,69,216900324,69032,Bully,2042,2005,37
84,69,216900332,69033,Cailloux-sur-Fontaines,2952,2879,73
84,69,216900340,69034,Caluire-et-Cuire,43929,43355,574
84,69,216900357,69035,Cenves,386,379,7
84,69,216900365,69036,Cercié,1158,1135,23
84,69,216900373,69037,Chambost-Allières,842,830,12
84,69,216900381,69038,Chambost-Longessaigne,947,924,23
84,69,216900399,69039,Chamelet,706,697,9
84,69,216900407,69040,Champagne-au-Mont-d'Or,5793,5749,44
84,69,216900423,69042,La Chapelle-sur-Coise,585,570,15
84,69,216900431,69043,Chaponost,9065,8887,178
84,69,216900449,69044,Charbonnières-les-Bains,5385,5237,148
84,69,216900456,69045,Charentay,1320,1253,67
84,69,216900464,69046,Charly,4723,4585,138
84,69,216900472,69047,Charnay,1068,1047,21
84,69,216900498,69049,Chasselay,2898,2833,65
84,69,216900506,69050,Châtillon,2156,2114,42
84,69,216900514,69051,Chaussan,1234,1200,34
84,69,216900522,69052,Chazay-d'Azergues,4270,4153,117
84,69,216900530,69053,Chénas,555,542,13
84,69,216900548,69054,Chénelette,356,354,2
84,69,216900555,69055,Les Chères,1533,1505,28
84,69,216900563,69056,Chessy,2169,2080,89
84,69,216900571,69057,Chevinay,596,583,13
84,69,216900589,69058,Chiroubles,391,380,11
84,69,216900597,69059,Civrieux-d'Azergues,1579,1550,29
84,69,216900605,69060,Claveisolles,652,570,82
84,69,216900613,69061,Cogny,1233,1199,34
84,69,216900621,69062,Coise,806,782,24
84,69,216900639,69063,Collonges-au-Mont-d'Or,4539,4448,91
84,69,216900647,69064,Condrieu,4031,3949,82
84,69,216900654,69065,Corcelles-en-Beaujolais,992,977,15
84,69,200056133,69066,Cours,4457,4366,91
84,69,216900670,69067,Courzieu,1192,1169,23
84,69,216900688,69068,Couzon-au-Mont-d'Or,2499,2455,44
84,69,216900696,69069,Craponne,11657,11453,204
84,69,216900704,69070,Cublize,1320,1296,24
84,69,216900712,69071,Curis-au-Mont-d'Or,1208,1182,26
84,69,216900720,69072,Dardilly,9459,8829,630
84,69,216900746,69074,Denicé,1607,1568,39
84,69,216900753,69075,Dième,193,191,2
84,69,216900761,69076,Dommartin,2650,2551,99
84,69,216900779,69077,Dracé,1051,1035,16
84,69,216900787,69078,Duerne,855,839,16
84,69,216900803,69080,Échalas,1929,1914,15
84,69,216900811,69081,Écully,19142,18789,353
84,69,216900829,69082,Émeringes,285,277,8
84,69,216900837,69083,Éveux,1199,1159,40
84,69,216900845,69084,Fleurie,1324,1300,24
84,69,216900852,69085,Fleurieu-sur-Saône,1533,1491,42
84,69,216900860,69086,Fleurieux-sur-l'Arbresle,2335,2272,63
84,69,216900878,69087,Fontaines-Saint-Martin,3088,3015,73
84,69,216900886,69088,Fontaines-sur-Saône,7159,7065,94
84,69,216900894,69089,Francheville,15046,14821,225
84,69,216900902,69090,Frontenas,863,841,22
84,69,216900910,69091,Givors,20798,20672,126
84,69,216900928,69092,Gleizé,7843,7495,348
84,69,216900936,69093,Grandris,1205,1185,20
84,69,216900944,69094,Grézieu-la-Varenne,6144,6029,115
84,69,216900951,69095,Grézieu-le-Marché,840,824,16
84,69,216900969,69096,Grigny,9814,9739,75
84,69,216900977,69097,Les Haies,792,773,19
84,69,216900985,69098,Les Halles,505,496,9
84,69,216900993,69099,Haute-Rivoire,1460,1436,24
84,69,216901009,69100,Irigny,8924,8805,119
84,69,216901025,69102,Joux,766,756,10
84,69,216901033,69103,Juliénas,904,886,18
84,69,216901041,69104,Jullié,459,454,5
84,69,216901058,69105,Lacenas,1043,1007,36
84,69,216901066,69106,Lachassagne,1233,1209,24
84,69,216901074,69107,Lamure-sur-Azergues,1113,1049,64
84,69,216901082,69108,Lancié,1064,1043,21
84,69,216901090,69109,Lantignié,877,851,26
84,69,216901108,69110,Larajasse,1882,1848,34
84,69,216901116,69111,Légny,699,681,18
84,69,216901124,69112,Lentilly,6667,6510,157
84,69,216901132,69113,Létra,927,900,27
84,69,216901157,69115,Limas,4923,4830,93
84,69,216901165,69116,Limonest,3850,3742,108
84,69,216901173,69117,Lissieu,3230,3157,73
84,69,216901181,69118,Loire-sur-Rhône,2694,2660,34
84,69,216901199,69119,Longes,985,977,8
84,69,216901207,69120,Longessaigne,612,596,16
84,69,216901215,69121,Lozanne,2924,2880,44
84,69,216901223,69122,Lucenay,2023,1969,54
84,69,216901231,69123,Lyon,528633,522228,6405
84,69,216901249,69124,Marchampt,467,457,10
84,69,216901256,69125,Marcilly-d'Azergues,896,880,16
84,69,216901264,69126,Marcy,826,805,21
84,69,216901272,69127,Marcy-l'Étoile,3558,3495,63
84,69,216901306,69130,Meaux-la-Montagne,234,232,2
84,69,216901314,69131,Messimy,3611,3523,88
84,69,216901322,69132,Meys,857,843,14
84,69,216901330,69133,Millery,4392,4313,79
84,69,216901348,69134,Moiré,240,230,10
84,69,200084424,69135,Deux-Grosnes,1967,1914,53
84,69,216901363,69136,Montagny,3236,3180,56
84,69,216901371,69137,Montmelas-Saint-Sorlin,540,534,6
84,69,216901389,69138,Montromant,453,445,8
84,69,216901397,69139,Montrottier,1444,1379,65
84,69,216901405,69140,Morancé,2140,2086,54
84,69,216901413,69141,Mornant,6413,6238,175
84,69,216901421,69142,La Mulatière,6690,6617,73
84,69,216901439,69143,Neuville-sur-Saône,7700,7635,65
84,69,216901454,69145,Odenas,958,932,26
84,69,216901488,69148,Orliénas,2620,2549,71
84,69,216901496,69149,Oullins,27263,26994,269
84,69,216901512,69151,Le Perréon,1523,1492,31
84,69,216901520,69152,Pierre-Bénite,10555,10508,47
84,69,216901538,69153,Poleymieux-au-Mont-d'Or,1428,1400,28
84,69,216901546,69154,Pollionnay,2921,2868,53
84,69,216901553,69155,Pomeys,1160,1131,29
84,69,216901561,69156,Pommiers,2766,2685,81
84,69,200087070,69157,Vindry-sur-Turdine,5404,5280,124
84,69,200083616,69159,Porte des Pierres Dorées,4044,3951,93
84,69,216901603,69160,Poule-les-Écharmeaux,1067,1047,20
84,69,216901611,69161,Propières,496,485,11
84,69,216901629,69162,Quincié-en-Beaujolais,1389,1354,35
84,69,216901637,69163,Quincieux,3553,3502,51
84,69,216901645,69164,Ranchal,333,323,10
84,69,216901652,69165,Régnié-Durette,1156,1137,19
84,69,216901660,69166,Riverie,335,334,1
84,69,216901678,69167,Rivolet,598,588,10
84,69,216901686,69168,Rochetaillée-sur-Saône,1580,1540,40
84,69,216901694,69169,Ronno,669,645,24
84,69,216901702,69170,Rontalon,1179,1160,19
84,69,216901710,69171,Sain-Bel,2465,2434,31
84,69,216901728,69172,Salles-Arbuissonnas-en-Beaujolais,793,766,27
84,69,216901736,69173,Sarcey,1026,1002,24
84,69,216901744,69174,Les Sauvages,623,612,11
84,69,216901751,69175,Savigny,2042,1988,54
84,69,216901769,69176,Soucieu-en-Jarrest,4696,4613,83
84,69,216901777,69177,Sourcieux-les-Mines,2127,2083,44
84,69,216901785,69178,Souzy,824,806,18
84,69,200077410,69179,Beauvallon,4150,4074,76
84,69,216901801,69180,Saint-André-la-Côte,292,283,9
84,69,216901819,69181,Saint-Appolinaire,230,229,1
84,69,216901827,69182,Saint-Bonnet-des-Bruyères,365,361,4
84,69,216901835,69183,Saint-Bonnet-le-Troncy,318,316,2
84,69,216901843,69184,Sainte-Catherine,1018,997,21
84,69,216901868,69186,Saint-Clément-de-Vers,211,207,4
84,69,216901876,69187,Saint-Clément-les-Places,673,653,20
84,69,216901884,69188,Saint-Clément-sur-Valsonne,916,907,9
84,69,216901892,69189,Sainte-Colombe,2017,1986,31
84,69,216901900,69190,Sainte-Consorce,2153,2065,88
84,69,216901918,69191,Saint-Cyr-au-Mont-d'Or,5831,5686,145
84,69,216901926,69192,Saint-Cyr-le-Chatoux,160,153,7
84,69,216901934,69193,Saint-Cyr-sur-le-Rhône,1305,1272,33
84,69,216901942,69194,Saint-Didier-au-Mont-d'Or,7305,7124,181
84,69,216901967,69196,Saint-Didier-sur-Beaujeu,622,609,13
84,69,216901975,69197,Saint-Étienne-des-Oullières,2260,2212,48
84,69,216901983,69198,Saint-Étienne-la-Varenne,775,764,11
84,69,216901991,69199,Saint-Fons,19556,19500,56
84,69,216902007,69200,Saint-Forgeux,1514,1494,20
84,69,216902015,69201,Sainte-Foy-l'Argentière,1309,1287,22
84,69,216902023,69202,Sainte-Foy-lès-Lyon,22452,22077,375
84,69,216902031,69203,Saint-Genis-l'Argentière,1017,1000,17
84,69,216902049,69204,Saint-Genis-Laval,21439,20971,468
84,69,216902056,69205,Saint-Genis-les-Ollières,5324,5229,95
84,69,216902064,69206,Saint-Georges-de-Reneins,4497,4403,94
84,69,216902072,69207,Saint-Germain-au-Mont-d'Or,3030,2981,49
84,69,200034346,69208,Saint-Germain-Nuelles,2309,2247,62
84,69,216902098,69209,Saint-Igny-de-Vers,569,556,13
84,69,216902122,69212,Saint-Jean-des-Vignes,487,476,11
84,69,216902148,69214,Saint-Jean-la-Bussière,1220,1196,24
84,69,216902155,69215,Saint-Julien,918,897,21
84,69,216902163,69216,Saint-Julien-sur-Bibost,579,570,9
84,69,216902171,69217,Saint-Just-d'Avray,769,748,21
84,69,216902189,69218,Saint-Lager,1059,1042,17
84,69,216902197,69219,Saint-Laurent-d'Agny,2190,2129,61
84,69,216902205,69220,Saint-Laurent-de-Chamousset,1910,1798,112
84,69,216902254,69225,Saint-Marcel-l'Éclairé,553,539,14
84,69,216902270,69227,Saint-Martin-en-Haut,4042,3860,182
84,69,200065852,69228,Chabanière,4294,4223,71
84,69,216902296,69229,Saint-Nizier-d'Azergues,808,792,16
84,69,216902304,69230,Sainte-Paule,320,314,6
84,69,216902312,69231,Saint-Pierre-la-Palud,2636,2576,60
84,69,216902338,69233,Saint-Romain-au-Mont-d'Or,1281,1235,46
84,69,216902346,69234,Saint-Romain-de-Popey,1688,1619,69
84,69,216902353,69235,Saint-Romain-en-Gal,2078,1972,106
84,69,216902361,69236,Saint-Romain-en-Gier,602,596,6
84,69,216902387,69238,Saint-Symphorien-sur-Coise,3797,3704,93
84,69,216902395,69239,Saint-Vérand,1222,1190,32
84,69,216902403,69240,Saint-Vincent-de-Reins,617,612,5
84,69,216902411,69241,Taluyers,2699,2637,62
84,69,216902429,69242,Taponas,915,903,12
84,69,216902437,69243,Tarare,10833,10572,261
84,69,216902445,69244,Tassin-la-Demi-Lune,22795,22475,320
84,69,216902452,69245,Ternand,737,712,25
84,69,216902460,69246,Theizé,1361,1324,37
84,69,200033652,69248,Thizy-les-Bourgs,6061,5944,117
84,69,216902494,69249,Thurins,3175,3111,64
84,69,216902502,69250,La Tour-de-Salvagny,4350,4249,101
84,69,216902528,69252,Trèves,755,746,9
84,69,216902536,69253,Tupin-et-Semons,656,646,10
84,69,216902544,69254,Valsonne,985,973,12
84,69,200047785,69255,Vaugneray,6193,6082,111
84,69,216902569,69256,Vaulx-en-Velin,51990,51761,229
84,69,216902577,69257,Vaux-en-Beaujolais,1134,1108,26
84,69,216902585,69258,Vauxrenard,325,320,5
84,69,216902593,69259,Vénissieux,67017,66765,252
84,69,216902601,69260,Vernaison,5162,5105,57
84,69,216902619,69261,Vernay,104,103,1
84,69,216902635,69263,Villechenève,897,880,17
84,69,216902643,69264,Villefranche-sur-Saône,36419,36009,410
84,69,216902650,69265,Ville-sur-Jarnioux,835,803,32
84,69,216902668,69266,Villeurbanne,155858,154781,1077
84,69,216902676,69267,Villié-Morgon,2243,2129,114
84,69,216902684,69268,Vourles,3495,3402,93
84,69,216902692,69269,Yzeron,1004,980,24
84,69,216902700,69270,Chaponnay,4482,4411,71
84,69,216902718,69271,Chassieu,10984,10844,140
84,69,216902726,69272,Communay,4544,4455,89
84,69,216902734,69273,Corbas,11241,11161,80
84,69,216902759,69275,Décines-Charpieu,29063,28913,150
84,69,216902767,69276,Feyzin,9976,9926,50
84,69,216902775,69277,Genas,13445,13195,250
84,69,216902783,69278,Genay,5626,5519,107
84,69,216902791,69279,Jonage,6158,6083,75
84,69,216902809,69280,Jons,1550,1537,13
84,69,216902817,69281,Marennes,1976,1947,29
84,69,216902825,69282,Meyzieu,35468,35134,334
84,69,216902833,69283,Mions,13836,13684,152
84,69,216902841,69284,Montanay,3321,3205,116
84,69,216902858,69285,Pusignan,4228,4190,38
84,69,216902866,69286,Rillieux-la-Pape,31210,30887,323
84,69,216902874,69287,Saint-Bonnet-de-Mure,6983,6876,107
84,69,216902882,69288,Saint-Laurent-de-Mure,5677,5609,68
84,69,216902890,69289,Saint-Pierre-de-Chandieu,4698,4616,82
84,69,216902908,69290,Saint-Priest,48612,48318,294
84,69,216902916,69291,Saint-Symphorien-d'Ozon,5906,5850,56
84,69,216902924,69292,Sathonay-Camp,6738,6678,60
84,69,216902932,69293,Sathonay-Village,2456,2409,47
84,69,216902940,69294,Sérézin-du-Rhône,2945,2906,39
84,69,216902957,69295,Simandres,1832,1823,9
84,69,216902965,69296,Solaize,3079,3034,45
84,69,216902973,69297,Ternay,5584,5511,73
84,69,216902981,69298,Toussieu,3232,3204,28
84,69,216902999,69299,Colombier-Saugnieu,2787,2744,43
27,70,217000017,70001,Abelcourt,357,350,7
27,70,217000025,70002,Aboncourt-Gesincourt,214,212,2
27,70,217000033,70003,Achey,71,69,2
27,70,217000041,70004,Adelans-et-le-Val-de-Bithaine,311,310,1
27,70,217000058,70005,Aillevans,132,130,2
27,70,217000066,70006,Aillevillers-et-Lyaumont,1589,1488,101
27,70,217000074,70007,Ailloncourt,311,305,6
27,70,217000082,70008,Ainvelle,150,148,2
27,70,217000090,70009,Aisey-et-Richecourt,100,99,1
27,70,217000108,70010,Alaincourt,101,101,0
27,70,217000116,70011,Amage,316,313,3
27,70,217000124,70012,Amance,666,660,6
27,70,217000132,70013,Ambiévillers,66,66,0
27,70,217000140,70014,Amblans-et-Velotte,420,415,5
27,70,217000157,70015,Amoncourt,276,271,5
27,70,217000165,70016,Amont-et-Effreney,165,163,2
27,70,217000173,70017,Anchenoncourt-et-Chazel,244,240,4
27,70,217000181,70018,Ancier,520,516,4
27,70,217000199,70019,Andelarre,146,142,4
27,70,217000207,70020,Andelarrot,246,244,2
27,70,217000215,70021,Andornay,191,187,4
27,70,217000223,70022,Angirey,151,148,3
27,70,217000231,70023,Anjeux,144,142,2
27,70,217000249,70024,Apremont,454,439,15
27,70,217000256,70025,Arbecey,244,241,3
27,70,217000264,70026,Arc-lès-Gray,2537,2492,45
27,70,217000272,70027,Argillières,72,71,1
27,70,217000280,70028,Aroz,145,142,3
27,70,217000298,70029,Arpenans,237,235,2
27,70,217000306,70030,Arsans,48,47,1
27,70,217000314,70031,Athesans-Étroitefontaine,654,639,15
27,70,217000322,70032,Attricourt,45,45,0
27,70,217000355,70035,Augicourt,179,175,4
27,70,217000363,70036,Aulx-lès-Cromary,157,155,2
27,70,217000371,70037,Autet,279,259,20
27,70,217000389,70038,Authoison,320,312,8
27,70,217000397,70039,Autoreille,369,365,4
27,70,217000405,70040,Autrey-lès-Cerre,244,241,3
27,70,217000413,70041,Autrey-lès-Gray,393,385,8
27,70,217000421,70042,Autrey-le-Vay,100,99,1
27,70,217000439,70043,Auvet-et-la-Chapelotte,239,236,3
27,70,217000447,70044,Auxon,415,403,12
27,70,217000454,70045,Avrigney-Virey,426,420,6
27,70,217000462,70046,Les Aynans,376,365,11
27,70,217000470,70047,Baignes,111,109,2
27,70,217000488,70048,Bard-lès-Pesmes,138,136,2
27,70,217000496,70049,Barges,100,98,2
27,70,217000504,70050,La Barre,98,98,0
27,70,217000512,70051,La Basse-Vaivre,33,33,0
27,70,217000520,70052,Bassigney,122,119,3
27,70,217000538,70053,Les Bâties,77,76,1
27,70,217000546,70054,Battrans,243,239,4
27,70,217000553,70055,Baudoncourt,501,494,7
27,70,217000561,70056,Baulay,318,317,1
27,70,217000579,70057,Bay,155,152,3
27,70,217000587,70058,Beaujeu-Saint-Vallier-Pierrejux-et-Quitteur,943,929,14
27,70,217000595,70059,Beaumotte-Aubertans,480,472,8
27,70,217000603,70060,Beaumotte-lès-Pin,291,288,3
27,70,217000611,70061,Belfahy,86,86,0
27,70,217000629,70062,Belmont,149,144,5
27,70,217000637,70063,Belonchamp,212,209,3
27,70,217000645,70064,Belverne,146,145,1
27,70,217000652,70065,Besnans,75,74,1
27,70,217000660,70066,Betaucourt,185,181,4
27,70,217000678,70067,Betoncourt-lès-Brotte,122,122,0
27,70,217000694,70069,Betoncourt-Saint-Pancras,44,44,0
27,70,217000702,70070,Betoncourt-sur-Mance,27,27,0
27,70,217000710,70071,Beulotte-Saint-Laurent,59,58,1
27,70,217000728,70072,Beveuge,86,84,2
27,70,217000744,70074,Blondefontaine,243,241,2
27,70,217000751,70075,Bonboillon,201,198,3
27,70,217000769,70076,Bonnevent-Velloreille,381,373,8
27,70,217000777,70077,Borey,224,220,4
27,70,217000785,70078,Bougey,95,93,2
27,70,217000793,70079,Bougnon,527,514,13
27,70,217000801,70080,Bouhans-et-Feurg,241,237,4
27,70,217000819,70081,Bouhans-lès-Lure,313,307,6
27,70,217000827,70082,Bouhans-lès-Montbozon,126,124,2
27,70,217000835,70083,Bouligney,411,404,7
27,70,217000843,70084,Boulot,660,649,11
27,70,217000850,70085,Boult,705,692,13
27,70,217000868,70086,Bourbévelle,75,75,0
27,70,217000876,70087,Bourguignon-lès-Conflans,152,150,2
27,70,217000884,70088,Bourguignon-lès-la-Charité,116,114,2
27,70,217000892,70089,Bourguignon-lès-Morey,46,46,0
27,70,217000900,70090,Boursières,64,62,2
27,70,217000918,70091,Bousseraucourt,47,46,1
27,70,217000926,70092,Bresilley,182,179,3
27,70,217000934,70093,Breuches,660,652,8
27,70,217000942,70094,Breuchotte,308,304,4
27,70,217000959,70095,Breurey-lès-Faverney,651,635,16
27,70,217000967,70096,Brevilliers,650,633,17
27,70,217000975,70097,Briaucourt,243,237,6
27,70,217000983,70098,Brotte-lès-Luxeuil,210,207,3
27,70,217000991,70099,Brotte-lès-Ray,78,77,1
27,70,217001007,70100,Broye-les-Loups-et-Verfontaine,127,127,0
27,70,217001015,70101,Broye-Aubigney-Montseugny,510,505,5
27,70,217001023,70102,Brussey,287,278,9
27,70,217001031,70103,La Bruyère,211,204,7
27,70,217001049,70104,Bucey-lès-Gy,601,586,15
27,70,217001056,70105,Bucey-lès-Traves,139,138,1
27,70,217001064,70106,Buffignécourt,111,109,2
27,70,217001072,70107,Bussières,447,443,4
27,70,217001098,70109,Buthiers,309,307,2
27,70,217001114,70111,Calmoutier,280,277,3
27,70,217001122,70112,Cemboing,178,172,6
27,70,217001130,70113,Cenans,135,132,3
27,70,217001148,70114,Cendrecourt,206,204,2
27,70,217001155,70115,Cerre-lès-Noroy,241,237,4
27,70,217001163,70116,Chagey,627,615,12
27,70,217001171,70117,Châlonvillars,1274,1243,31
27,70,217001189,70118,Chambornay-lès-Bellevaux,198,196,2
27,70,217001197,70119,Chambornay-lès-Pin,365,354,11
27,70,217001205,70120,Champagney,3790,3717,73
27,70,217001213,70121,Champey,880,851,29
27,70,217001221,70122,Champlitte,1666,1634,32
27,70,217001247,70124,Champtonnay,88,87,1
27,70,217001254,70125,Champvans,182,176,6
27,70,217001262,70126,Chancey,201,195,6
27,70,217001270,70127,Chantes,111,106,5
27,70,217001288,70128,La Chapelle-lès-Luxeuil,393,390,3
27,70,217001296,70129,La Chapelle-Saint-Quillain,161,157,4
27,70,217001304,70130,Charcenne,317,309,8
27,70,217001320,70132,Chargey-lès-Gray,771,704,67
27,70,217001338,70133,Chargey-lès-Port,241,234,7
27,70,217001346,70134,Chariez,207,205,2
27,70,217001353,70135,Charmes-Saint-Valbert,34,33,1
27,70,217001361,70136,Charmoille,502,493,9
27,70,217001379,70137,Chassey-lès-Montbozon,223,220,3
27,70,217001387,70138,Chassey-lès-Scey,127,124,3
27,70,217001403,70140,Châteney,70,69,1
27,70,217001411,70141,Châtenois,123,118,5
27,70,217001429,70142,Chaumercenne,193,191,2
27,70,217001437,70143,Chauvirey-le-Châtel,131,125,6
27,70,217001445,70144,Chauvirey-le-Vieil,34,33,1
27,70,217001452,70145,Chaux-la-Lotière,502,491,11
27,70,217001460,70146,Chaux-lès-Port,171,167,4
27,70,217001478,70147,Chavanne,226,222,4
27,70,217001486,70148,Chemilly,87,86,1
27,70,217001494,70149,Chenebier,713,695,18
27,70,217001502,70150,Chenevrey-et-Morogne,326,324,2
27,70,217001510,70151,Chevigney,35,35,0
27,70,217001528,70152,Choye,514,475,39
27,70,217001536,70153,Cintrey,98,97,1
27,70,217001544,70154,Cirey,373,367,6
27,70,217001551,70155,Citers,807,792,15
27,70,217001569,70156,Citey,112,111,1
27,70,217001577,70157,Clairegoutte,362,352,10
27,70,217001585,70158,Clans,106,105,1
27,70,217001593,70159,Cognières,90,90,0
27,70,217001601,70160,Coisevaux,331,312,19
27,70,217001627,70162,Colombe-lès-Vesoul,477,464,13
27,70,217001635,70163,Colombier,447,439,8
27,70,217001643,70164,Colombotte,83,82,1
27,70,217001650,70165,Combeaufontaine,586,544,42
27,70,217001668,70166,Comberjon,155,150,5
27,70,217001676,70167,Conflandey,363,350,13
27,70,217001684,70168,Conflans-sur-Lanterne,612,603,9
27,70,217001692,70169,Confracourt,226,221,5
27,70,217001700,70170,Contréglise,120,119,1
27,70,217001718,70171,Corbenay,1285,1257,28
27,70,217001726,70172,La Corbière,111,109,2
27,70,217001742,70174,Cordonnet,145,143,2
27,70,217001759,70175,Cornot,138,135,3
27,70,217001767,70176,Corravillers,183,183,0
27,70,217001775,70177,Corre,611,596,15
27,70,217001783,70178,La Côte,535,526,9
27,70,217001791,70179,Coulevon,170,166,4
27,70,217001809,70180,Courchaton,450,442,8
27,70,217001817,70181,Courcuire,134,134,0
27,70,217001825,70182,Courmont,136,135,1
27,70,217001833,70183,Courtesoult-et-Gatey,60,60,0
27,70,217001841,70184,Couthenans,740,719,21
27,70,217001858,70185,Cresancey,186,186,0
27,70,217001866,70186,La Creuse,73,72,1
27,70,217001874,70187,Crevans-et-la-Chapelle-lès-Granges,259,258,1
27,70,217001882,70188,Creveney,53,52,1
27,70,217001890,70189,Cromary,255,251,4
27,70,217001908,70190,Cubry-lès-Faverney,188,185,3
27,70,217001924,70192,Cugney,210,206,4
27,70,217001932,70193,Cult,233,231,2
27,70,217001940,70194,Cuve,136,132,4
27,70,217001957,70195,Dambenoît-lès-Colombe,277,273,4
27,70,217001965,70196,Dampierre-lès-Conflans,254,246,8
27,70,217001973,70197,Dampierre-sur-Linotte,809,792,17
27,70,217001981,70198,Dampierre-sur-Salon,1258,1234,24
27,70,217001999,70199,Dampvalley-lès-Colombe,120,120,0
27,70,217002005,70200,Dampvalley-Saint-Pancras,43,42,1
27,70,217002013,70201,Delain,208,203,5
27,70,217002021,70202,Demangevelle,278,271,7
27,70,217002039,70203,La Demie,155,153,2
27,70,217002047,70204,Denèvre,155,151,4
27,70,217002054,70205,Échavanne,203,201,2
27,70,217002062,70206,Échenans-sous-Mont-Vaudois,571,564,7
27,70,217002070,70207,Échenoz-la-Méline,3303,3235,68
27,70,217002088,70208,Échenoz-le-Sec,295,290,5
27,70,217002104,70210,Écromagny,157,152,5
27,70,217002112,70211,Écuelle,66,64,2
27,70,217002138,70213,Éhuns,226,220,6
27,70,217002146,70214,Équevilley,125,122,3
27,70,217002153,70215,Errevet,253,242,11
27,70,217002161,70216,Esboz-Brest,469,445,24
27,70,217002179,70217,Esmoulières,98,97,1
27,70,217002187,70218,Esmoulins,137,132,5
27,70,217002195,70219,Esprels,749,734,15
27,70,217002203,70220,Essertenne-et-Cecey,411,404,7
27,70,217002211,70221,Étobon,292,288,4
27,70,217002229,70222,Étrelles-et-la-Montbleuse,85,85,0
27,70,217002245,70224,Étuz,698,684,14
27,70,217002252,70225,Fahy-lès-Autrey,102,100,2
27,70,217002260,70226,Fallon,314,311,3
27,70,217002278,70227,Faucogney-et-la-Mer,480,467,13
27,70,217002286,70228,Faverney,996,980,16
27,70,217002294,70229,Faymont,265,259,6
27,70,217002302,70230,Fédry,101,96,5
27,70,217002310,70231,Ferrières-lès-Ray,36,36,0
27,70,217002328,70232,Ferrières-lès-Scey,135,130,5
27,70,217002336,70233,Les Fessey,136,134,2
27,70,217002344,70234,Filain,232,222,10
27,70,217002351,70235,Flagy,143,139,4
27,70,217002369,70236,Fleurey-lès-Faverney,471,463,8
27,70,217002377,70237,Fleurey-lès-Lavoncourt,102,101,1
27,70,217002385,70238,Fleurey-lès-Saint-Loup,140,134,6
27,70,217002393,70239,Fondremand,205,200,5
27,70,217002401,70240,Fontaine-lès-Luxeuil,1351,1328,23
27,70,217002427,70242,Fontenois-la-Ville,131,131,0
27,70,217002435,70243,Fontenois-lès-Montbozon,351,340,11
27,70,217002443,70244,Fouchécourt,117,115,2
27,70,200082634,70245,Fougerolles-Saint-Valbert,3915,3784,131
27,70,217002476,70247,Fouvent-Saint-Andoche,213,210,3
27,70,217002484,70248,Frahier-et-Chatebier,1414,1379,35
27,70,217002492,70249,Francalmont,121,118,3
27,70,217002500,70250,Franchevelle,478,473,5
27,70,217002518,70251,Francourt,101,100,1
27,70,217002526,70252,Framont,184,181,3
27,70,217002534,70253,Frasne-le-Château,324,296,28
27,70,217002542,70254,Frédéric-Fontaine,267,259,8
27,70,217002559,70255,Fresne-Saint-Mamès,506,495,11
27,70,217002567,70256,Fresse,721,709,12
27,70,217002575,70257,Fretigney-et-Velloreille,760,747,13
27,70,217002583,70258,Froideconche,2032,1987,45
27,70,217002591,70259,Froideterre,374,368,6
27,70,217002609,70260,Frotey-lès-Lure,704,684,20
27,70,217002617,70261,Frotey-lès-Vesoul,1390,1358,32
27,70,217002625,70262,Genevreuille,162,158,4
27,70,217002633,70263,Genevrey,249,247,2
27,70,217002641,70264,Georfans,45,45,0
27,70,217002658,70265,Germigney,153,148,5
27,70,217002674,70267,Gevigney-et-Mercey,495,488,7
27,70,217002682,70268,Gézier-et-Fontenelay,218,214,4
27,70,217002690,70269,Girefontaine,35,34,1
27,70,217002716,70271,Gouhenans,376,367,9
27,70,217002724,70272,Gourgeon,191,180,11
27,70,217002732,70273,Grammont,69,68,1
27,70,217002740,70274,Grandecourt,49,49,0
27,70,217002757,70275,Grandvelle-et-le-Perrenot,395,388,7
27,70,217002765,70276,Granges-la-Ville,189,184,5
27,70,217002773,70277,Granges-le-Bourg,387,381,6
27,70,217002781,70278,Grattery,217,213,4
27,70,217002799,70279,Gray,5980,5560,420
27,70,217002807,70280,Gray-la-Ville,963,928,35
27,70,217002823,70282,Gy,1026,1006,20
27,70,217002831,70283,Haut-du-Them-Château-Lambert,452,446,6
27,70,217002849,70284,Hautevelle,264,263,1
27,70,200083608,70285,Héricourt,10862,10592,270
27,70,217002864,70286,Hugier,129,125,4
27,70,217002872,70287,Hurecourt,46,46,0
27,70,217002880,70288,Hyet,119,118,1
27,70,217002898,70289,Igny,213,211,2
27,70,217002906,70290,Jasney,203,197,6
27,70,217002914,70291,Jonvelle,120,117,3
27,70,217002922,70292,Jussey,1575,1543,32
27,70,217002930,70293,Lambrey,76,74,2
27,70,217002948,70294,Lantenot,361,357,4
27,70,217002955,70295,La Lanterne-et-les-Armonts,226,221,5
27,70,217002963,70296,Larians-et-Munans,272,270,2
27,70,217002971,70297,Larret,60,60,0
27,70,217002989,70298,Lavigney,119,119,0
27,70,217002997,70299,Lavoncourt,323,318,5
27,70,217003011,70301,Lieffrans,53,53,0
27,70,217003029,70302,Lieucourt,77,76,1
27,70,217003037,70303,Liévans,157,156,1
27,70,217003045,70304,Linexert,119,118,1
27,70,217003052,70305,Loeuilley,103,101,2
27,70,217003060,70306,Lomont,482,469,13
27,70,217003078,70307,Longevelle,127,121,6
27,70,217003086,70308,La Longine,218,213,5
27,70,217003094,70309,Loulans-Verchamp,463,453,10
27,70,217003102,70310,Lure,8143,7960,183
27,70,217003110,70311,Luxeuil-les-Bains,6903,6644,259
27,70,217003128,70312,Luze,807,785,22
27,70,217003136,70313,Lyoffans,419,411,8
27,70,217003144,70314,Magnivray,173,167,6
27,70,217003151,70315,Magnoncourt,419,408,11
27,70,217003169,70316,Le Magnoray,89,85,4
27,70,217003177,70317,Les Magny,147,143,4
27,70,217003185,70318,Magny-Danigon,448,438,10
27,70,217003193,70319,Magny-Jobert,134,131,3
27,70,217003201,70320,Magny-lès-Jussey,99,96,3
27,70,217003219,70321,Magny-Vernois,1402,1375,27
27,70,217003227,70322,Mailleroncourt-Charette,290,284,6
27,70,217003235,70323,Mailleroncourt-Saint-Pancras,197,196,1
27,70,217003243,70324,Mailley-et-Chazelot,650,634,16
27,70,217003250,70325,Maizières,363,356,7
27,70,217003268,70326,La Malachère,310,307,3
27,70,217003276,70327,Malans,137,134,3
27,70,217003284,70328,Malbouhans,331,326,5
27,70,217003292,70329,Malvillers,64,63,1
27,70,217003300,70330,Mandrevillars,317,309,8
27,70,217003318,70331,Mantoche,451,444,7
27,70,217003326,70332,Marast,59,58,1
27,70,217003342,70334,Marnay,1547,1522,25
27,70,217003359,70335,Maussans,61,59,2
27,70,217003367,70336,Mélecey,138,135,3
27,70,217003375,70337,Melin,59,58,1
27,70,217003383,70338,Melincourt,230,223,7
27,70,217003391,70339,Mélisey,1711,1678,33
27,70,217003409,70340,Membrey,241,214,27
27,70,217003417,70341,Menoux,303,300,3
27,70,217003425,70342,Mercey-sur-Saône,137,134,3
27,70,217003433,70343,Mersuay,287,282,5
27,70,217003441,70344,Meurcourt,349,340,9
27,70,217003474,70347,Mignavillers,373,365,8
27,70,217003482,70348,Moffans-et-Vacheresse,630,618,12
27,70,217003490,70349,Moimay,237,234,3
27,70,217003508,70350,Molay,65,65,0
27,70,217003516,70351,Mollans,230,227,3
27,70,217003524,70352,La Montagne,38,38,0
27,70,217003532,70353,Montagney,512,503,9
27,70,217003557,70355,Montarlot-lès-Rioz,315,311,4
27,70,217003565,70356,Montboillon,287,281,6
27,70,217003573,70357,Montbozon,630,544,86
27,70,217003581,70358,Montcey,273,269,4
27,70,217003599,70359,Montcourt,56,54,2
27,70,217003607,70360,Montdoré,76,75,1
27,70,217003615,70361,Montessaux,160,155,5
27,70,217003623,70362,Montigny-lès-Cherlieu,132,128,4
27,70,217003631,70363,Montigny-lès-Vesoul,652,637,15
27,70,217003649,70364,Montjustin-et-Velotte,120,119,1
27,70,217003664,70366,Villers-Chemin-et-Mont-lès-Étrelles,122,122,0
27,70,217003672,70367,Mont-le-Vernois,190,186,4
27,70,217003680,70368,Montot,134,131,3
27,70,217003698,70369,Mont-Saint-Léger,49,48,1
27,70,217003714,70371,Montureux-et-Prantigny,201,200,1
27,70,217003722,70372,Montureux-lès-Baulay,154,150,4
27,70,217003730,70373,La Roche-Morey,291,287,4
27,70,217003748,70374,Motey-Besuche,94,92,2
27,70,217003763,70376,Nantilly,462,452,10
27,70,217003789,70378,Navenne,1653,1605,48
27,70,217003805,70380,Neurey-en-Vaux,167,163,4
27,70,217003813,70381,Neurey-lès-la-Demie,358,348,10
27,70,217003839,70383,Neuvelle-lès-Cromary,429,425,4
27,70,217003847,70384,Neuvelle-lès-la-Charité,227,224,3
27,70,217003854,70385,La Neuvelle-lès-Lure,330,323,7
27,70,217003862,70386,La Neuvelle-lès-Scey,175,172,3
27,70,217003870,70387,Noidans-le-Ferroux,663,653,10
27,70,217003888,70388,Noidans-lès-Vesoul,2046,1973,73
27,70,217003896,70389,Noiron,59,58,1
27,70,217003904,70390,Noroy-le-Bourg,509,498,11
27,70,217003920,70392,Oigney,36,34,2
27,70,217003938,70393,Oiselay-et-Grachaux,433,431,2
27,70,217003946,70394,Onay,62,60,2
27,70,217003953,70395,Oppenans,51,51,0
27,70,217003961,70396,Oricourt,43,41,2
27,70,217003979,70397,Ormenans,82,82,0
27,70,217003987,70398,Ormoiche,67,67,0
27,70,217003995,70399,Ormoy,214,207,7
27,70,217004001,70400,Ouge,113,111,2
27,70,217004019,70401,Ovanches,139,138,1
27,70,217004027,70402,Oyrières,379,368,11
27,70,217004035,70403,Palante,246,243,3
27,70,217004043,70404,Passavant-la-Rochère,578,563,15
27,70,217004050,70405,Pennesières,200,196,4
27,70,217004068,70406,Percey-le-Grand,75,74,1
27,70,217004076,70407,Perrouse,279,275,4
27,70,217004084,70408,Pesmes,1092,1072,20
27,70,217004092,70409,Pierrecourt,116,114,2
27,70,217004100,70410,Pin,719,710,9
27,70,217004118,70411,La Pisseure,38,38,0
27,70,217004126,70412,Plainemont,72,72,0
27,70,217004134,70413,Plancher-Bas,1907,1872,35
27,70,217004142,70414,Plancher-les-Mines,969,955,14
27,70,217004159,70415,Polaincourt-et-Clairefontaine,630,620,10
27,70,217004167,70416,Pomoy,204,200,4
27,70,217004175,70417,Pontcey,300,297,3
27,70,200053056,70418,La Romaine,524,519,5
27,70,217004191,70419,Pont-du-Bois,112,110,2
27,70,217004209,70420,Pont-sur-l'Ognon,62,62,0
27,70,217004217,70421,Port-sur-Saône,3006,2952,54
27,70,217004225,70422,Poyans,146,145,1
27,70,217004233,70423,Preigney,119,116,3
27,70,217004258,70425,La Proiselière-et-Langle,153,147,6
27,70,217004266,70426,Provenchère,253,246,7
27,70,217004274,70427,Purgerot,340,331,9
27,70,217004282,70428,Pusey,1501,1452,49
27,70,217004290,70429,Pusy-et-Épenoux,558,544,14
27,70,217004308,70430,La Quarte,67,67,0
27,70,217004316,70431,Quenoche,255,252,3
27,70,217004324,70432,Quers,332,325,7
27,70,217004332,70433,Quincey,1440,1401,39
27,70,217004357,70435,Raddon-et-Chapendu,863,837,26
27,70,217004365,70436,Raincourt,113,113,0
27,70,217004373,70437,Ranzevelle,16,16,0
27,70,217004381,70438,Ray-sur-Saône,218,215,3
27,70,217004399,70439,Raze,370,363,7
27,70,217004407,70440,Recologne,36,34,2
27,70,217004415,70441,Recologne-lès-Rioz,254,251,3
27,70,217004423,70442,Renaucourt,112,111,1
27,70,217004431,70443,La Grande-Résie,91,90,1
27,70,217004449,70444,La Résie-Saint-Martin,168,167,1
27,70,217004456,70445,Rignovelle,118,117,1
27,70,217004464,70446,Rigny,625,617,8
27,70,217004472,70447,Rioz,2471,2395,76
27,70,217004480,70448,Roche-et-Raucourt,154,152,2
27,70,217004498,70449,Roche-sur-Linotte-et-Sorans-les-Cordiers,62,62,0
27,70,217004506,70450,La Rochelle,41,41,0
27,70,217004514,70451,Ronchamp,2786,2747,39
27,70,217004522,70452,Rosey,258,255,3
27,70,217004530,70453,La Rosière,80,80,0
27,70,217004548,70454,Rosières-sur-Mance,52,50,2
27,70,217004555,70455,Roye,1505,1480,25
27,70,217004563,70456,Ruhans,153,148,5
27,70,217004571,70457,Rupt-sur-Saône,109,106,3
27,70,217004597,70459,Saint-Barthélemy,1122,1100,22
27,70,217004605,70460,Saint-Bresson,438,427,11
27,70,217004613,70461,Saint-Broing,115,113,2
27,70,217004621,70462,Saint-Ferjeux,82,80,2
27,70,217004639,70463,Saint-Gand,147,146,1
27,70,217004647,70464,Saint-Germain,1378,1355,23
27,70,217004662,70466,Saint-Loup-Nantouard,130,127,3
27,70,217004670,70467,Saint-Loup-sur-Semouse,3092,3046,46
27,70,217004688,70468,Saint-Marcel,91,90,1
27,70,217004696,70469,Sainte-Marie-en-Chanois,214,211,3
27,70,217004704,70470,Sainte-Marie-en-Chaux,160,158,2
27,70,217004712,70471,Sainte-Reine,25,24,1
27,70,217004720,70472,Saint-Rémy-en-Comté,446,442,4
27,70,217004738,70473,Saint-Sauveur,1967,1936,31
27,70,217004746,70474,Saint-Sulpice,127,125,2
27,70,217004761,70476,Saponcourt,69,69,0
27,70,217004779,70477,Saulnot,792,779,13
27,70,217004787,70478,Saulx,895,880,15
27,70,217004795,70479,Sauvigney-lès-Gray,100,96,4
27,70,217004803,70480,Sauvigney-lès-Pesmes,146,142,4
27,70,217004811,70481,Savoyeux,206,202,4
27,70,217004829,70482,Scey-sur-Saône-et-Saint-Albin,1556,1533,23
27,70,217004837,70483,Scye,142,138,4
27,70,217004845,70484,Secenans,185,182,3
27,70,217004852,70485,Selles,206,202,4
27,70,217004860,70486,Semmadon,113,110,3
27,70,217004878,70487,Senargent-Mignafans,294,291,3
27,70,217004886,70488,Senoncourt,193,192,1
27,70,200065381,70489,Servance-Miellin,781,773,8
27,70,217004902,70490,Servigney,125,124,1
27,70,200086460,70491,Seveux-Motey,491,476,15
27,70,217004928,70492,Soing-Cubry-Charentenay,593,583,10
27,70,217004936,70493,Sorans-lès-Breurey,472,462,10
27,70,217004944,70494,Sornay,355,349,6
27,70,217004969,70496,Tartécourt,25,24,1
27,70,217004985,70498,Ternuay-Melay-et-Saint-Hilaire,468,453,15
27,70,217004993,70499,Theuley,104,102,2
27,70,217005008,70500,Thieffrans,175,166,9
27,70,217005016,70501,Thiénans,104,103,1
27,70,217005024,70502,Tincey-et-Pontrebeau,84,84,0
27,70,217005032,70503,Traitiéfontaine,163,161,2
27,70,217005040,70504,Traves,370,358,12
27,70,217005057,70505,Le Tremblois,166,159,7
27,70,217005065,70506,Trémoins,403,390,13
27,70,217005073,70507,Trésilley,265,259,6
27,70,217005099,70509,Tromarey,115,115,0
27,70,217005107,70510,Vadans,130,127,3
27,70,217005115,70511,Vaite,232,229,3
27,70,217005123,70512,La Vaivre,222,219,3
27,70,217005131,70513,Vaivre-et-Montoille,2474,2420,54
27,70,217005149,70514,Valay,669,658,11
27,70,217005156,70515,Le Val-de-Gouhenans,67,66,1
27,70,217005164,70516,Vallerois-le-Bois,243,240,3
27,70,217005172,70517,Vallerois-Lorioz,413,395,18
27,70,217005180,70518,Le Val-Saint-Éloi,99,97,2
27,70,217005198,70519,Vandelans,108,108,0
27,70,217005206,70520,Vanne,122,119,3
27,70,217005214,70521,Vantoux-et-Longevelle,191,186,5
27,70,217005222,70522,Varogne,161,158,3
27,70,217005230,70523,Vars,202,199,3
27,70,217005248,70524,Vauchoux,116,113,3
27,70,217005255,70525,Vauconcourt-Nervezain,216,213,3
27,70,217005263,70526,Vauvillers,632,620,12
27,70,217005271,70527,Vaux-le-Moncelot,78,77,1
27,70,217005289,70528,Velesmes-Échevanne,495,486,9
27,70,217005297,70529,Velet,399,381,18
27,70,217005305,70530,Vellechevreux-et-Courbenans,117,117,0
27,70,217005313,70531,Velleclaire,103,102,1
27,70,217005321,70532,Vellefaux,530,524,6
27,70,217005339,70533,Vellefrey-et-Vellefrange,119,118,1
27,70,217005347,70534,Vellefrie,125,124,1
27,70,217005354,70535,Velleguindry-et-Levrecey,151,151,0
27,70,217005362,70536,Velle-le-Châtel,134,132,2
27,70,217005370,70537,Velleminfroy,302,296,6
27,70,217005388,70538,Vellemoz,85,84,1
27,70,217005396,70539,Vellexon-Queutrey-et-Vaudey,466,454,12
27,70,217005404,70540,Velloreille-lès-Choye,84,80,4
27,70,217005412,70541,Velorcey,204,201,3
27,70,217005420,70542,Venère,212,207,5
27,70,217005446,70544,La Vergenne,118,113,5
27,70,217005453,70545,Venisey,131,130,1
27,70,217005461,70546,Vereux,236,214,22
27,70,217005479,70547,Verlans,170,167,3
27,70,217005487,70548,Vernois-sur-Mance,139,138,1
27,70,217005495,70549,La Vernotte,79,78,1
27,70,217005503,70550,Vesoul,15626,14866,760
27,70,217005529,70552,Villafans,217,210,7
27,70,217005537,70553,Villargent,117,115,2
27,70,217005545,70554,Villars-le-Pautel,191,190,1
27,70,217005552,70555,La Villedieu-en-Fontenette,169,168,1
27,70,217005578,70557,Villefrancon,133,129,4
27,70,217005586,70558,La Villeneuve-Bellenoye-et-la-Maize,148,146,2
27,70,217005594,70559,Villeparois,198,194,4
27,70,217005602,70560,Villers-Bouton,168,166,2
27,70,217005610,70561,Villersexel,1514,1409,105
27,70,217005628,70562,Villers-la-Ville,158,155,3
27,70,217005636,70563,Villers-le-Sec,542,529,13
27,70,217005644,70564,Villers-lès-Luxeuil,330,314,16
27,70,217005651,70565,Villers-Pater,54,52,2
27,70,217005669,70566,Villers-sur-Port,205,200,5
27,70,217005677,70567,Villers-sur-Saulnot,141,132,9
27,70,217005685,70568,Villers-Vaudey,60,56,4
27,70,217005693,70569,Vilory,63,63,0
27,70,217005719,70571,Visoncourt,42,39,3
27,70,217005727,70572,Vitrey-sur-Mance,295,291,4
27,70,217005735,70573,La Voivre,116,115,1
27,70,217005743,70574,Volon,56,56,0
27,70,217005750,70575,Voray-sur-l'Ognon,865,849,16
27,70,217005768,70576,Vougécourt,155,154,1
27,70,217005776,70577,Vouhenans,390,381,9
27,70,217005784,70578,Vregille,179,177,2
27,70,217005792,70579,Vyans-le-Val,441,425,16
27,70,217005800,70580,Vy-le-Ferroux,160,155,5
27,70,217005818,70581,Vy-lès-Lure,724,709,15
27,70,217005826,70582,Vy-lès-Rupt,78,78,0
27,70,217005834,70583,Vy-lès-Filain,132,131,1
27,71,217100015,71001,L'Abergement-de-Cuisery,822,808,14
27,71,217100023,71002,L'Abergement-Sainte-Colombe,1261,1241,20
27,71,217100031,71003,Allerey-sur-Saône,819,800,19
27,71,217100049,71004,Allériot,1187,1163,24
27,71,217100056,71005,Aluze,259,249,10
27,71,217100064,71006,Amanzé,195,190,5
27,71,217100072,71007,Ameugny,171,167,4
27,71,217100080,71008,Anglure-sous-Dun,155,150,5
27,71,217100098,71009,Anost,727,714,13
27,71,217100106,71010,Antully,879,869,10
27,71,217100114,71011,Anzy-le-Duc,514,432,82
27,71,217100122,71012,Artaix,349,335,14
27,71,217100130,71013,Authumes,287,282,5
27,71,217100148,71014,Autun,14215,13205,1010
27,71,217100155,71015,Auxy,927,901,26
27,71,217100163,71016,Azé,1110,1083,27
27,71,217100171,71017,Ballore,99,95,4
27,71,217100189,71018,Bantanges,556,546,10
27,71,217100197,71019,Barizey,147,140,7
27,71,217100205,71020,Barnay,100,98,2
27,71,217100213,71021,Baron,309,289,20
27,71,217100221,71022,Baudemont,633,624,9
27,71,217100239,71023,Baudrières,991,965,26
27,71,217100247,71024,Baugy,517,504,13
27,71,217100254,71025,Beaubery,366,359,7
27,71,217100262,71026,Beaumont-sur-Grosne,345,332,13
27,71,217100270,71027,Beaurepaire-en-Bresse,737,730,7
27,71,217100288,71028,Beauvernois,107,104,3
27,71,217100296,71029,Bellevesvre,297,294,3
27,71,217100304,71030,Bergesserin,205,201,4
27,71,217100312,71031,Berzé-le-Châtel,60,59,1
27,71,217100320,71032,Berzé-la-Ville,711,697,14
27,71,217100338,71033,Bey,888,869,19
27,71,217100346,71034,Bissey-sous-Cruchaud,340,334,6
27,71,217100353,71035,Bissy-la-Mâconnaise,207,204,3
27,71,217100361,71036,Bissy-sous-Uxelles,70,70,0
27,71,217100379,71037,Bissy-sur-Fley,89,83,6
27,71,217100387,71038,Les Bizots,482,469,13
27,71,217100395,71039,Blanot,182,181,1
27,71,217100403,71040,Blanzy,6177,6044,133
27,71,217100411,71041,Bois-Sainte-Marie,191,189,2
27,71,200098622,71042,Bonnay-Saint-Ythaire,447,439,8
27,71,217100437,71043,Les Bordes,87,84,3
27,71,217100445,71044,Bosjean,296,290,6
27,71,217100452,71045,Bouhans,183,178,5
27,71,217100460,71046,La Boulaye,93,93,0
27,71,217100478,71047,Bourbon-Lancy,4756,4684,72
27,71,217100486,71048,Bourg-le-Comte,177,175,2
27,71,217100502,71050,Bourgvilain,356,349,7
27,71,217100510,71051,Bouzeron,134,127,7
27,71,217100528,71052,Boyer,738,729,9
27,71,217100544,71054,Bragny-sur-Saône,710,696,14
27,71,217100569,71056,Branges,2385,2350,35
27,71,217100577,71057,Bray,128,125,3
27,71,217100585,71058,Bresse-sur-Grosne,197,186,11
27,71,217100593,71059,Le Breuil,3596,3535,61
27,71,217100601,71060,Briant,230,228,2
27,71,217100619,71061,Brienne,480,466,14
27,71,217100627,71062,Brion,299,291,8
27,71,217100635,71063,Broye,762,749,13
27,71,217100643,71064,Bruailles,1005,980,25
27,71,217100650,71065,Buffières,278,274,4
27,71,217100668,71066,Burgy,120,117,3
27,71,217100676,71067,Burnand,124,122,2
27,71,217100684,71068,Burzy,58,56,2
27,71,217100692,71069,Bussières,611,584,27
27,71,217100700,71070,Buxy,2213,2147,66
27,71,217100718,71071,Céron,271,264,7
27,71,217100726,71072,Cersot,147,145,2
27,71,217100734,71073,Chagny,5596,5516,80
27,71,217100742,71074,Chaintré,575,557,18
27,71,217100759,71075,Chalmoux,648,631,17
27,71,217100767,71076,Chalon-sur-Saône,46567,45094,1473
27,71,217100775,71077,Chambilly,513,499,14
27,71,217100783,71078,Chamilly,150,147,3
27,71,217100791,71079,Champagnat,481,470,11
27,71,217100809,71080,Champagny-sous-Uxelles,92,92,0
27,71,217100817,71081,Champforgeuil,2647,2594,53
27,71,217100825,71082,Champlecy,228,224,4
27,71,217100841,71084,Chânes,543,529,14
27,71,217100858,71085,Change,225,223,2
27,71,217100866,71086,Changy,477,468,9
27,71,217100874,71087,Chapaize,165,164,1
27,71,217100882,71088,La Chapelle-au-Mans,235,225,10
27,71,217100890,71089,La Chapelle-de-Bragny,237,235,2
27,71,217100908,71090,La Chapelle-de-Guinchay,4209,4126,83
27,71,217100916,71091,La Chapelle-du-Mont-de-France,194,192,2
27,71,217100924,71092,La Chapelle-Naude,510,498,12
27,71,217100932,71093,La Chapelle-Saint-Sauveur,663,647,16
27,71,217100940,71094,La Chapelle-sous-Brancion,141,139,2
27,71,217100957,71095,La Chapelle-sous-Dun,441,432,9
27,71,217100965,71096,La Chapelle-sous-Uchon,192,191,1
27,71,217100973,71097,La Chapelle-Thècle,493,481,12
27,71,217100981,71098,Charbonnat,254,250,4
27,71,217100999,71099,Charbonnières,330,323,7
27,71,217101005,71100,Chardonnay,205,205,0
27,71,217105931,71101,Charette-Varennes,459,453,6
27,71,217101021,71102,La Charmée,708,684,24
27,71,217101039,71103,Charmoy,282,276,6
27,71,217101047,71104,Charnay-lès-Chalon,196,188,8
27,71,217101054,71105,Charnay-lès-Mâcon,8215,7925,290
27,71,217101062,71106,Charolles,3233,2849,384
27,71,217101070,71107,Charrecey,340,332,8
27,71,217101088,71108,Chasselas,174,170,4
27,71,217101096,71109,Chassey-le-Camp,363,357,6
27,71,217101104,71110,Chassigny-sous-Dun,566,556,10
27,71,217101112,71111,Chassy,308,299,9
27,71,217101120,71112,Château,240,233,7
27,71,217101138,71113,Châteauneuf,93,93,0
27,71,217101153,71115,Châtel-Moron,91,87,4
27,71,217101161,71116,Châtenay,173,171,2
27,71,217101179,71117,Châtenoy-en-Bresse,1125,1095,30
27,71,217101187,71118,Châtenoy-le-Royal,6290,6148,142
27,71,217101195,71119,Chaudenay,1148,1125,23
27,71,217101203,71120,Chauffailles,3759,3688,71
27,71,217101211,71121,La Chaux,326,323,3
27,71,217101229,71122,Cheilly-lès-Maranges,573,558,15
27,71,217101237,71123,Chenay-le-Châtel,374,370,4
27,71,217101245,71124,Chenôves,209,202,7
27,71,217101252,71125,Chérizet,20,20,0
27,71,217101260,71126,Chevagny-les-Chevrières,609,591,18
27,71,217101278,71127,Chevagny-sur-Guye,57,53,4
27,71,217101286,71128,Chiddes,91,86,5
27,71,217101294,71129,Chissey-en-Morvan,274,268,6
27,71,217101302,71130,Chissey-lès-Mâcon,235,229,6
27,71,217101310,71131,Ciel,878,866,12
27,71,217101328,71132,Ciry-le-Noble,2279,2252,27
27,71,217101336,71133,La Clayette,1699,1639,60
27,71,200084564,71134,Navour-sur-Grosne,668,657,11
27,71,217101351,71135,Clessé,894,873,21
27,71,217101369,71136,Clessy,283,275,8
27,71,217101377,71137,Cluny,5176,4931,245
27,71,217101393,71139,Collonge-en-Charollais,152,146,6
27,71,217101401,71140,Collonge-la-Madeleine,48,46,2
27,71,217101419,71141,Colombier-en-Brionnais,319,314,5
27,71,217101427,71142,La Comelle,251,247,4
27,71,217101435,71143,Condal,468,459,9
27,71,217101443,71144,Cordesse,196,192,4
27,71,217101450,71145,Cormatin,572,567,5
27,71,217101468,71146,Cortambert,249,245,4
27,71,217101476,71147,Cortevaix,257,251,6
27,71,217101484,71148,Coublanc,865,847,18
27,71,217101492,71149,Couches,1312,1285,27
27,71,217101500,71150,Crêches-sur-Saône,3227,3140,87
27,71,217101518,71151,Créot,83,79,4
27,71,217101526,71152,Cressy-sur-Somme,184,175,9
27,71,217101534,71153,Le Creusot,21319,21057,262
27,71,217101542,71154,Crissey,2520,2460,60
27,71,217101559,71155,Cronat,531,516,15
27,71,217101567,71156,Cruzille,327,261,66
27,71,217101575,71157,Cuiseaux,1855,1825,30
27,71,217101583,71158,Cuisery,1628,1588,40
27,71,217101591,71159,Culles-les-Roches,209,201,8
27,71,217101609,71160,Curbigny,314,306,8
27,71,217101617,71161,Curdin,331,325,6
27,71,217101625,71162,Curgy,1158,1135,23
27,71,217101633,71163,Curtil-sous-Buffières,91,90,1
27,71,217101641,71164,Curtil-sous-Burnand,135,133,2
27,71,217101658,71165,Cussy-en-Morvan,382,374,8
27,71,217101666,71166,Cuzy,113,109,4
27,71,217101674,71167,Damerey,568,549,19
27,71,217101682,71168,Dampierre-en-Bresse,175,174,1
27,71,217101690,71169,Davayé,812,705,107
27,71,217101708,71170,Demigny,1820,1782,38
27,71,217101716,71171,Dennevy,309,304,5
27,71,217101724,71172,Dettey,89,88,1
27,71,217101732,71173,Devrouze,322,317,5
27,71,217101740,71174,Dezize-lès-Maranges,174,170,4
27,71,217101757,71175,Diconne,360,354,6
27,71,217101765,71176,Digoin,7854,7616,238
27,71,217101773,71177,Dommartin-lès-Cuiseaux,815,806,9
27,71,217101781,71178,Dompierre-les-Ormes,912,883,29
27,71,217101799,71179,Dompierre-sous-Sanvignes,83,82,1
27,71,217101815,71181,Donzy-le-Pertuis,163,161,2
27,71,217101823,71182,Dracy-le-Fort,1510,1458,52
27,71,217101831,71183,Dracy-lès-Couches,157,153,4
27,71,217101849,71184,Dracy-Saint-Loup,636,628,8
27,71,217101856,71185,Dyo,342,328,14
27,71,217101864,71186,Écuelles,263,259,4
27,71,217101872,71187,Écuisses,1626,1595,31
27,71,217101880,71188,Épertully,62,61,1
27,71,217101898,71189,Épervans,1683,1634,49
27,71,217101906,71190,Épinac,2175,2145,30
27,71,217101914,71191,Essertenne,481,475,6
27,71,217101922,71192,Étang-sur-Arroux,1951,1803,148
27,71,217101930,71193,Étrigny,486,476,10
27,71,217101948,71194,Farges-lès-Chalon,818,801,17
27,71,217101955,71195,Farges-lès-Mâcon,221,220,1
27,71,217101963,71196,Le Fay,638,629,9
27,71,217101989,71198,Flacey-en-Bresse,418,411,7
27,71,217101997,71199,Flagy,182,174,8
27,71,217102003,71200,Fleury-la-Montagne,724,707,17
27,71,217102011,71201,Fley,202,194,8
27,71,217102029,71202,Fontaines,2215,1853,362
27,71,217102037,71203,Fontenay,54,53,1
27,71,200057917,71204,Fragnes-La Loyère,1519,1478,41
27,71,217102052,71205,Frangy-en-Bresse,675,666,9
27,71,217102060,71206,La Frette,241,237,4
27,71,217102078,71207,Fretterans,298,288,10
27,71,217102086,71208,Frontenard,212,208,4
27,71,217102094,71209,Frontenaud,740,726,14
27,71,217102102,71210,Fuissé,388,370,18
27,71,217102128,71212,Génelard,1425,1394,31
27,71,217102136,71213,La Genête,584,567,17
27,71,217102144,71214,Genouilly,432,421,11
27,71,217102151,71215,Gergy,2663,2590,73
27,71,217102169,71216,Germagny,200,195,5
27,71,217102177,71217,Germolles-sur-Grosne,130,125,5
27,71,217102185,71218,Gibles,597,577,20
27,71,217102193,71219,Gigny-sur-Saône,557,542,15
27,71,217102201,71220,Gilly-sur-Loire,475,472,3
27,71,217102219,71221,Givry,3838,3678,160
27,71,217102227,71222,Gourdon,923,897,26
27,71,217102235,71223,La Grande-Verrière,573,565,8
27,71,217102243,71224,Grandvaux,92,85,7
27,71,217102250,71225,Granges,563,548,15
27,71,217102268,71226,Grevilly,28,28,0
27,71,217102276,71227,Grury,510,502,8
27,71,217102284,71228,Guerfand,218,215,3
27,71,217102292,71229,Les Guerreaux,229,228,1
27,71,217102300,71230,Gueugnon,6862,6685,177
27,71,217102318,71231,La Guiche,627,619,8
27,71,217102326,71232,Hautefond,218,204,14
27,71,217102334,71233,L'Hôpital-le-Mercier,311,304,7
27,71,217102342,71234,Huilly-sur-Seille,352,347,5
27,71,217102359,71235,Hurigny,2042,1935,107
27,71,217102367,71236,Igé,898,877,21
27,71,217102375,71237,Igornay,534,529,5
27,71,217102383,71238,Iguerande,1008,990,18
27,71,217102391,71239,Issy-l'Évêque,699,688,11
27,71,217102409,71240,Jalogny,410,396,14
27,71,217102417,71241,Jambles,502,485,17
27,71,217102425,71242,Joncy,525,515,10
27,71,217102433,71243,Joudes,374,368,6
27,71,217102441,71244,Jouvençon,446,444,2
27,71,217102458,71245,Jugy,329,325,4
27,71,217102466,71246,Juif,248,245,3
27,71,217102474,71247,Jully-lès-Buxy,377,367,10
27,71,217102482,71248,Lacrost,716,701,15
27,71,217102490,71249,Laives,1018,981,37
27,71,217102508,71250,Laizé,1140,1091,49
27,71,217102516,71251,Laizy,609,596,13
27,71,217102524,71252,Lalheue,377,364,13
27,71,217102532,71253,Lans,958,933,25
27,71,217102540,71254,Lays-sur-le-Doubs,157,156,1
27,71,217102557,71255,Lesme,178,176,2
27,71,217102565,71256,Lessard-en-Bresse,560,547,13
27,71,217102573,71257,Lessard-le-National,670,658,12
27,71,217102581,71258,Leynes,516,500,16
27,71,217102599,71259,Ligny-en-Brionnais,375,369,6
27,71,217102615,71261,Loisy,687,671,16
27,71,217102623,71262,Longepierre,158,155,3
27,71,217102631,71263,Louhans,6675,6451,224
27,71,217102649,71264,Lournand,333,324,9
27,71,217102664,71266,Lucenay-l'Évêque,318,314,4
27,71,217102672,71267,Lugny,939,855,84
27,71,217102680,71268,Lugny-lès-Charolles,360,350,10
27,71,217102698,71269,Lux,2040,2012,28
27,71,217102706,71270,Mâcon,35137,34414,723
27,71,217102714,71271,Mailly,151,146,5
27,71,217102722,71272,Malay,206,197,9
27,71,217102730,71273,Maltat,290,284,6
27,71,217102748,71274,Mancey,397,387,10
27,71,217102755,71275,Marcigny,1754,1723,31
27,71,217102763,71276,Marcilly-la-Gueurce,134,129,5
27,71,217102771,71277,Marcilly-lès-Buxy,682,666,16
27,71,217102789,71278,Marigny,167,162,5
27,71,200059863,71279,Le Rousset-Marizy,641,619,22
27,71,217102805,71280,Marly-sous-Issy,87,85,2
27,71,217102813,71281,Marly-sur-Arroux,321,307,14
27,71,217102821,71282,Marmagne,1277,1256,21
27,71,217102839,71283,Marnay,534,527,7
27,71,217102847,71284,Martailly-lès-Brancion,142,137,5
27,71,217102854,71285,Martigny-le-Comte,414,407,7
27,71,217102862,71286,Mary,274,270,4
27,71,217102870,71287,Massilly,319,314,5
27,71,217102896,71289,Matour,1176,1156,20
27,71,217102904,71290,Mazille,449,374,75
27,71,217102912,71291,Melay,979,956,23
27,71,217102920,71292,Mellecey,1361,1316,45
27,71,217102938,71293,Ménetreuil,419,409,10
27,71,217102946,71294,Mercurey,1368,1231,137
27,71,217102953,71295,Mervans,1527,1502,25
27,71,217102961,71296,Messey-sur-Grosne,760,741,19
27,71,217102979,71297,Mesvres,773,751,22
27,71,217102995,71299,Milly-Lamartine,317,311,6
27,71,217103001,71300,Le Miroir,634,626,8
27,71,217103019,71301,Mont,168,166,2
27,71,217103027,71302,Montagny-lès-Buxy,224,215,9
27,71,217103035,71303,Montagny-près-Louhans,497,491,6
27,71,217103050,71305,Montbellet,856,841,15
27,71,217103068,71306,Montceau-les-Mines,17488,17239,249
27,71,217103076,71307,Montceaux-l'Étoile,296,289,7
27,71,217103084,71308,Montceaux-Ragny,32,31,1
27,71,217103092,71309,Montcenis,1965,1905,60
27,71,217103100,71310,Montchanin,5075,4992,83
27,71,217103118,71311,Montcony,256,250,6
27,71,217103126,71312,Montcoy,256,255,1
27,71,217103134,71313,Monthelon,399,384,15
27,71,217103142,71314,Montjay,204,204,0
27,71,217103159,71315,Mont-lès-Seurre,186,184,2
27,71,217103167,71316,Montmelard,386,379,7
27,71,217103175,71317,Montmort,189,186,3
27,71,217103183,71318,Montpont-en-Bresse,1122,1103,19
27,71,217103191,71319,Montret,784,768,16
27,71,217103209,71320,Mont-Saint-Vincent,318,315,3
27,71,217103217,71321,Morey,195,191,4
27,71,217103225,71322,Morlet,51,50,1
27,71,217103233,71323,Mornay,136,136,0
27,71,217103241,71324,Moroges,606,584,22
27,71,217103258,71325,La Motte-Saint-Jean,1241,1204,37
27,71,217103266,71326,Mouthier-en-Bresse,417,411,6
27,71,217103274,71327,Mussy-sous-Dun,346,339,7
27,71,217103282,71328,Nanton,643,631,12
27,71,217103290,71329,Navilly,415,406,9
27,71,217103308,71330,Neuvy-Grandchamp,762,750,12
27,71,217103316,71331,Nochize,115,111,4
27,71,217103324,71332,Ormes,469,464,5
27,71,217103332,71333,Oslon,1264,1226,38
27,71,217103340,71334,Oudry,387,378,9
27,71,217103357,71335,Ouroux-sous-le-Bois-Sainte-Marie,65,65,0
27,71,217103365,71336,Ouroux-sur-Saône,3180,3102,78
27,71,217103373,71337,Oyé,314,306,8
27,71,217103381,71338,Ozenay,220,218,2
27,71,217103399,71339,Ozolles,392,384,8
27,71,217103407,71340,Palinges,1497,1471,26
27,71,217103415,71341,Palleau,270,268,2
27,71,217103423,71342,Paray-le-Monial,9612,9218,394
27,71,217103431,71343,Paris-l'Hôpital,316,308,8
27,71,217103449,71344,Passy,69,67,2
27,71,217103456,71345,Péronne,689,670,19
27,71,217103464,71346,Perrecy-les-Forges,1581,1557,24
27,71,217103472,71347,Perreuil,570,556,14
27,71,217103480,71348,Perrigny-sur-Loire,137,134,3
27,71,217103498,71349,La Petite-Verrière,52,51,1
27,71,217103506,71350,Pierreclos,889,859,30
27,71,217103514,71351,Pierre-de-Bresse,1971,1942,29
27,71,217103522,71352,Le Planois,89,86,3
27,71,217103530,71353,Plottes,545,535,10
27,71,217103548,71354,Poisson,586,565,21
27,71,217103555,71355,Pontoux,285,278,7
27,71,217103563,71356,Pouilloux,986,969,17
27,71,217103571,71357,Pourlans,218,218,0
27,71,217103589,71358,Pressy-sous-Dondin,105,102,3
27,71,217103597,71359,Préty,587,577,10
27,71,217103605,71360,Prissé,1946,1900,46
27,71,217103613,71361,Prizy,61,56,5
27,71,217103621,71362,Pruzilly,352,347,5
27,71,217103639,71363,Le Puley,88,83,5
27,71,217103647,71364,La Racineuse,175,175,0
27,71,217103654,71365,Rancy,611,604,7
27,71,217103662,71366,Ratenelle,384,377,7
27,71,217103670,71367,Ratte,374,369,5
27,71,217103688,71368,Reclesne,314,298,16
27,71,217103696,71369,Remigny,437,423,14
27,71,217103704,71370,Rigny-sur-Arroux,636,623,13
27,71,217103712,71371,La Roche-Vineuse,1615,1573,42
27,71,217103720,71372,Romanèche-Thorins,2061,2017,44
27,71,217103738,71373,Romenay,1743,1721,22
27,71,217103746,71374,Rosey,162,160,2
27,71,217103761,71376,Roussillon-en-Morvan,286,278,8
27,71,217103779,71377,Royer,132,131,1
27,71,217103787,71378,Rully,1586,1551,35
27,71,217103795,71379,Sagy,1254,1231,23
27,71,217103803,71380,Saillenard,807,793,14
27,71,217103811,71381,Sailly,73,73,0
27,71,217103829,71382,Saint-Agnan,711,696,15
27,71,217103837,71383,Saint-Albain,549,543,6
27,71,217103845,71384,Saint-Ambreuil,525,512,13
27,71,217103852,71385,Saint-Amour-Bellevue,586,564,22
27,71,217103860,71386,Saint-André-en-Bresse,106,105,1
27,71,217103878,71387,Saint-André-le-Désert,256,248,8
27,71,217103886,71388,Saint-Aubin-en-Charollais,489,469,20
27,71,217103894,71389,Saint-Aubin-sur-Loire,281,275,6
27,71,217103902,71390,Saint-Berain-sous-Sanvignes,1115,1094,21
27,71,217103910,71391,Saint-Bérain-sur-Dheune,570,553,17
27,71,217103928,71392,Saint-Boil,499,490,9
27,71,217103936,71393,Saint-Bonnet-de-Cray,512,494,18
27,71,217103944,71394,Saint-Bonnet-de-Joux,782,762,20
27,71,217103951,71395,Saint-Bonnet-de-Vieille-Vigne,212,210,2
27,71,217103969,71396,Saint-Bonnet-en-Bresse,492,487,5
27,71,217103977,71397,Sainte-Cécile,289,281,8
27,71,217103985,71398,Saint-Christophe-en-Bresse,1071,1040,31
27,71,217103993,71399,Saint-Christophe-en-Brionnais,547,532,15
27,71,217104009,71400,Saint-Clément-sur-Guye,135,132,3
27,71,217104017,71401,Sainte-Croix-en-Bresse,651,638,13
27,71,217104025,71402,Saint-Cyr,785,760,25
27,71,217104033,71403,Saint-Denis-de-Vaux,276,265,11
27,71,217104041,71404,Saint-Désert,925,904,21
27,71,217104058,71405,Saint-Didier-en-Bresse,198,193,5
27,71,217104066,71406,Saint-Didier-en-Brionnais,133,124,9
27,71,217104074,71407,Saint-Didier-sur-Arroux,222,218,4
27,71,217104082,71408,Saint-Edmond,441,432,9
27,71,217104090,71409,Saint-Émiland,320,312,8
27,71,217104108,71410,Saint-Étienne-en-Bresse,805,791,14
27,71,217104116,71411,Saint-Eugène,161,153,8
27,71,217104124,71412,Saint-Eusèbe,1232,1207,25
27,71,217104132,71413,Saint-Firmin,814,805,9
27,71,217104140,71414,Saint-Forgeot,456,440,16
27,71,217104157,71415,Sainte-Foy,143,140,3
27,71,217104165,71416,Saint-Gengoux-de-Scissé,590,584,6
27,71,217104173,71417,Saint-Gengoux-le-National,1059,1053,6
27,71,217104199,71419,Saint-Germain-du-Bois,1931,1890,41
27,71,217104207,71420,Saint-Germain-du-Plain,2364,2313,51
27,71,217104215,71421,Saint-Germain-en-Brionnais,193,186,7
27,71,217104223,71422,Saint-Germain-lès-Buxy,284,272,12
27,71,217104231,71423,Saint-Gervais-en-Vallière,436,431,5
27,71,217104249,71424,Saint-Gervais-sur-Couches,219,216,3
27,71,217104256,71425,Saint-Gilles,288,278,10
27,71,217104264,71426,Sainte-Hélène,539,530,9
27,71,217104272,71427,Saint-Huruge,52,51,1
27,71,217104280,71428,Saint-Igny-de-Roche,789,763,26
27,71,217104306,71430,Saint-Jean-de-Vaux,405,389,16
27,71,217104314,71431,Saint-Jean-de-Trézy,392,379,13
27,71,217104330,71433,Saint-Julien-de-Civry,503,489,14
27,71,217104348,71434,Saint-Julien-de-Jonzy,353,343,10
27,71,217104355,71435,Saint-Julien-sur-Dheune,250,242,8
27,71,217104363,71436,Saint-Laurent-d'Andenay,1017,997,20
27,71,217104371,71437,Saint-Laurent-en-Brionnais,333,322,11
27,71,217104389,71438,Saint-Léger-du-Bois,544,525,19
27,71,217104397,71439,Saint-Léger-lès-Paray,781,760,21
27,71,217104405,71440,Saint-Léger-sous-Beuvray,382,373,9
27,71,217104413,71441,Saint-Léger-sous-la-Bussière,285,281,4
27,71,217104421,71442,Saint-Léger-sur-Dheune,1618,1600,18
27,71,217104439,71443,Saint-Loup-Géanges,1700,1644,56
27,71,217104447,71444,Saint-Loup-de-Varennes,1235,1207,28
27,71,217104454,71445,Saint-Marcel,6335,6188,147
27,71,217104462,71446,Saint-Marcelin-de-Cray,195,190,5
27,71,217104470,71447,Saint-Mard-de-Vaux,286,272,14
27,71,217104488,71448,Saint-Martin-Belle-Roche,1421,1387,34
27,71,217104496,71449,Saint-Martin-d'Auxy,142,135,7
27,71,217104504,71450,Saint-Martin-de-Commune,105,101,4
27,71,217104512,71451,Saint-Martin-de-Lixy,93,93,0
27,71,217104520,71452,Saint-Martin-de-Salencey,103,102,1
27,71,217104538,71453,Saint-Martin-du-Lac,256,245,11
27,71,217104546,71454,Saint-Martin-du-Mont,188,180,8
27,71,217104553,71455,Saint-Martin-du-Tartre,157,156,1
27,71,217104561,71456,Saint-Martin-en-Bresse,1980,1912,68
27,71,217104579,71457,Saint-Martin-en-Gâtinois,121,119,2
27,71,217104587,71458,Saint-Martin-la-Patrouille,61,61,0
27,71,217104595,71459,Saint-Martin-sous-Montaigu,358,340,18
27,71,217104603,71460,Saint-Maurice-de-Satonnay,505,482,23
27,71,217104611,71461,Saint-Maurice-des-Champs,63,62,1
27,71,217104629,71462,Saint-Maurice-en-Rivière,533,522,11
27,71,217104637,71463,Saint-Maurice-lès-Châteauneuf,581,570,11
27,71,217104645,71464,Saint-Maurice-lès-Couches,183,180,3
27,71,217104652,71465,Saint-Micaud,282,275,7
27,71,217104660,71466,Saint-Nizier-sur-Arroux,124,120,4
27,71,217104686,71468,Saint-Pierre-de-Varennes,862,848,14
27,71,217104694,71469,Saint-Pierre-le-Vieux,380,368,12
27,71,217104702,71470,Saint-Point,363,349,14
27,71,217104710,71471,Saint-Privé,97,95,2
27,71,217104728,71472,Saint-Prix,213,206,7
27,71,217104736,71473,Saint-Racho,150,149,1
27,71,217104744,71474,Sainte-Radegonde,151,147,4
27,71,217104751,71475,Saint-Rémy,6763,6605,158
27,71,217104777,71477,Saint-Romain-sous-Gourdon,498,489,9
27,71,217104785,71478,Saint-Romain-sous-Versigny,84,83,1
27,71,217104793,71479,Saint-Sernin-du-Bois,1771,1736,35
27,71,217104801,71480,Saint-Sernin-du-Plain,612,599,13
27,71,217104819,71481,Saint-Symphorien-d'Ancelles,1152,1132,20
27,71,217104827,71482,Saint-Symphorien-de-Marmagne,848,837,11
27,71,217104835,71483,Saint-Symphorien-des-Bois,430,418,12
27,71,217104843,71484,Saint-Usuge,1285,1256,29
27,71,217104850,71485,Saint-Vallerin,271,257,14
27,71,217104868,71486,Saint-Vallier,8704,8541,163
27,71,217104876,71487,Saint-Vérand,164,160,4
27,71,217104884,71488,Saint-Vincent-des-Prés,106,102,4
27,71,217104892,71489,Saint-Vincent-en-Bresse,585,576,9
27,71,217104900,71490,Saint-Vincent-Bragny,1030,1013,17
27,71,217104918,71491,Saint-Yan,1176,1153,23
27,71,217104934,71493,Saisy,353,345,8
27,71,217104942,71494,La Salle,530,516,14
27,71,217104959,71495,Salornay-sur-Guye,884,873,11
27,71,217104967,71496,Sampigny-lès-Maranges,145,140,5
27,71,217104975,71497,Sancé,2235,2181,54
27,71,217104983,71498,Santilly,138,132,6
27,71,217104991,71499,Sanvignes-les-Mines,4400,4325,75
27,71,217105006,71500,Sarry,93,90,3
27,71,217105014,71501,Sassangy,146,143,3
27,71,217105022,71502,Sassenay,1631,1586,45
27,71,217105030,71503,Saules,131,128,3
27,71,217105048,71504,Saunières,82,81,1
27,71,217105055,71505,Savianges,78,77,1
27,71,217105063,71506,Savigny-en-Revermont,1149,1132,17
27,71,217105071,71507,Savigny-sur-Grosne,172,171,1
27,71,217105089,71508,Savigny-sur-Seille,408,399,9
27,71,217105097,71509,La Celle-en-Morvan,480,474,6
27,71,217105105,71510,Semur-en-Brionnais,629,610,19
27,71,217105121,71512,Sennecey-le-Grand,3009,2943,66
27,71,217105139,71513,Senozan,1165,1128,37
27,71,217105147,71514,Sens-sur-Seille,429,424,5
27,71,217105154,71515,Sercy,105,102,3
27,71,217105162,71516,Serley,612,603,9
27,71,217105170,71517,Sermesse,242,237,5
27,71,217105188,71518,Serrières,280,271,9
27,71,217105196,71519,Serrigny-en-Bresse,192,188,4
27,71,217105204,71520,Sevrey,1284,1263,21
27,71,217105212,71521,Sigy-le-Châtel,110,106,4
27,71,217105220,71522,Simandre,1754,1737,17
27,71,217105238,71523,Simard,1195,1184,11
27,71,217105246,71524,Sivignon,183,176,7
27,71,217105253,71525,Sologny,587,577,10
27,71,217105261,71526,Solutré-Pouilly,371,364,7
27,71,217105279,71527,Sommant,206,201,5
27,71,217105287,71528,Sornay,2035,1990,45
27,71,217105295,71529,Suin,268,263,5
27,71,217105303,71530,Sully,493,490,3
27,71,217105311,71531,La Tagnière,213,212,1
27,71,217105329,71532,Taizé,197,194,3
27,71,217105337,71533,Tancon,543,525,18
27,71,217105345,71534,Le Tartre,116,111,5
27,71,217105352,71535,Tavernay,520,509,11
27,71,217105378,71537,Thil-sur-Arroux,128,128,0
27,71,217105386,71538,Thurey,442,430,12
27,71,217105394,71539,Tintry,80,79,1
27,71,217105402,71540,Torcy,2847,2810,37
27,71,217105410,71541,Torpes,379,375,4
27,71,217105428,71542,Toulon-sur-Arroux,1498,1472,26
27,71,217105436,71543,Tournus,5832,5552,280
27,71,217105444,71544,Toutenant,189,187,2
27,71,217105451,71545,Tramayes,1080,1062,18
27,71,217105469,71546,Trambly,414,407,7
27,71,217105477,71547,Trivy,259,252,7
27,71,217105485,71548,Tronchy,247,245,2
27,71,217105493,71549,La Truchère,214,208,6
27,71,217105501,71550,Uchizy,833,819,14
27,71,217105519,71551,Uchon,94,89,5
27,71,217105527,71552,Uxeau,531,519,12
27,71,217105535,71553,Vareilles,281,276,5
27,71,217105543,71554,Varenne-l'Arconce,115,112,3
27,71,217105550,71555,Varennes-le-Grand,2380,2331,49
27,71,217105568,71556,Varennes-lès-Mâcon,576,569,7
27,71,217105576,71557,Varenne-Saint-Germain,733,713,20
27,71,217105584,71558,Varennes-Saint-Sauveur,1156,1131,25
27,71,217105592,71559,Varennes-sous-Dun,546,533,13
27,71,217105618,71561,Vauban,237,227,10
27,71,217105626,71562,Vaudebarrier,242,209,33
27,71,217105634,71563,Vaux-en-Pré,73,72,1
27,71,217105642,71564,Vendenesse-lès-Charolles,764,745,19
27,71,217105659,71565,Vendenesse-sur-Arroux,575,563,12
27,71,217105667,71566,Verdun-sur-le-Doubs,986,977,9
27,71,217105675,71567,Vergisson,262,255,7
27,71,217105683,71568,Vérissey,58,58,0
27,71,217105709,71570,Verjux,521,510,11
27,71,217105717,71571,Verosvres,452,438,14
27,71,217105725,71572,Vers,234,234,0
27,71,217105733,71573,Versaugues,196,192,4
27,71,217105741,71574,Verzé,841,814,27
27,71,217105766,71576,Le Villars,284,279,5
27,71,217105774,71577,Villegaudin,227,223,4
27,71,200047520,71578,Clux-Villeneuve,319,309,10
27,71,217105790,71579,Villeneuve-en-Montagne,171,169,2
27,71,217105808,71580,Vincelles,443,429,14
27,71,217105816,71581,Vindecy,256,251,5
27,71,200065449,71582,La Vineuse sur Fregande,670,651,19
27,71,217105832,71583,Vinzelles,756,732,24
27,71,217105840,71584,Viré,1230,1201,29
27,71,217105857,71585,Virey-le-Grand,1442,1369,73
27,71,217105865,71586,Viry,263,259,4
27,71,217105881,71588,Vitry-en-Charollais,1137,1099,38
27,71,217105899,71589,Vitry-sur-Loire,426,418,8
27,71,217105907,71590,Volesvres,667,644,23
27,71,217105915,71591,Fleurville,520,512,8
52,72,217200013,72001,Aigné,1724,1692,32
52,72,217200021,72002,Aillières-Beauvoir,204,199,5
52,72,217200039,72003,Allonnes,11207,11108,99
52,72,217200047,72004,Amné,588,580,8
52,72,217200054,72005,Ancinnes,964,942,22
52,72,217200062,72006,Arçonnay,2114,1882,232
52,72,217200070,72007,Ardenay-sur-Mérize,511,500,11
52,72,217200088,72008,Arnage,5647,5520,127
52,72,217200096,72009,Arthezé,366,358,8
52,72,217200104,72010,Asnières-sur-Vègre,388,379,9
52,72,217200112,72011,Assé-le-Boisne,919,902,17
52,72,217200120,72012,Assé-le-Riboul,496,486,10
52,72,217200138,72013,Aubigné-Racan,2134,2108,26
52,72,217200153,72015,Les Aulneaux,112,112,0
52,72,217200161,72016,Auvers-le-Hamon,1520,1484,36
52,72,217200179,72017,Auvers-sous-Montfaucon,236,233,3
52,72,217200187,72018,Avesnes-en-Saosnois,86,85,1
52,72,217200195,72019,Avessé,372,363,9
52,72,217200203,72020,Avezé,711,694,17
52,72,217200211,72021,Avoise,586,579,7
52,72,217200229,72022,Le Bailleul,1241,1214,27
52,72,200053254,72023,Ballon-Saint Mars,2290,2260,30
52,72,217200245,72024,La Bazoge,3711,3651,60
52,72,200072254,72025,Bazouges Cré sur Loir,2022,1975,47
52,72,217200260,72026,Beaufay,1523,1507,16
52,72,217200278,72027,Beaumont-sur-Dême,330,328,2
52,72,217200286,72028,Beaumont-Pied-de-Boeuf,489,481,8
52,72,217200294,72029,Beaumont-sur-Sarthe,2007,1979,28
52,72,217200310,72031,Beillé,532,529,3
52,72,217200328,72032,Berfay,345,335,10
52,72,217200344,72034,Bérus,450,438,12
52,72,217200351,72035,Bessé-sur-Braye,2115,2069,46
52,72,217200369,72036,Béthon,311,307,4
52,72,217200377,72037,Blèves,124,123,1
52,72,217200385,72038,Boëssé-le-Sec,548,547,1
52,72,217200393,72039,Bonnétable,3806,3749,57
52,72,217200401,72040,La Bosse,146,144,2
52,72,217200419,72041,Bouër,354,349,5
52,72,217200427,72042,Bouloire,2141,2109,32
52,72,217200435,72043,Bourg-le-Roi,336,329,7
52,72,217200443,72044,Bousse,437,432,5
52,72,217200450,72045,Brains-sur-Gée,841,828,13
52,72,217200468,72046,Le Breil-sur-Mérize,1570,1544,26
52,72,217200476,72047,Brette-les-Pins,2268,2128,140
52,72,217200484,72048,Briosne-lès-Sables,527,523,4
52,72,217200492,72049,La Bruère-sur-Loir,249,248,1
52,72,217200500,72050,Brûlon,1562,1533,29
52,72,217200518,72051,Cérans-Foulletourte,3413,3377,36
52,72,217200526,72052,Chahaignes,681,671,10
52,72,217200534,72053,Challes,1226,1205,21
52,72,217200542,72054,Champagné,3757,3697,60
52,72,217200567,72056,Champfleur,1356,1332,24
52,72,217200575,72057,Champrond,73,70,3
52,72,217200583,72058,Changé,6743,6569,174
52,72,217200591,72059,Chantenay-Villedieu,848,829,19
52,72,217200609,72060,La Chapelle-aux-Choux,271,270,1
52,72,217200617,72061,La Chapelle-d'Aligné,1736,1711,25
52,72,217200625,72062,La Chapelle-du-Bois,851,832,19
52,72,217200641,72064,La Chapelle-Huon,529,519,10
52,72,217200658,72065,La Chapelle-Saint-Aubin,2344,2278,66
52,72,217200666,72066,La Chapelle-Saint-Fray,430,423,7
52,72,217200674,72067,La Chapelle-Saint-Rémy,1000,993,7
52,72,217200682,72068,La Chartre-sur-le-Loir,1383,1367,16
52,72,217200708,72070,Chassillé,256,250,6
52,72,200063196,72071,Montval-sur-Loir,6120,5903,217
52,72,217200724,72072,Château-l'Hermitage,255,253,2
52,72,217200732,72073,Chaufour-Notre-Dame,1147,1124,23
52,72,217200740,72074,Chemiré-en-Charnie,220,211,9
52,72,217200757,72075,Chemiré-le-Gaudin,1024,998,26
52,72,217200765,72076,Chenay,249,247,2
52,72,217200773,72077,Chenu,434,426,8
52,72,217200781,72078,Chérancé,357,354,3
52,72,217200799,72079,Chérisay,315,312,3
52,72,200082568,72080,Cherré-Au,2803,2723,80
52,72,217200831,72083,Chevillé,378,367,11
52,72,217200849,72084,Clermont-Créans,1303,1268,35
52,72,217200856,72085,Cogners,185,183,2
52,72,217200864,72086,Commerveil,142,138,4
52,72,217200872,72087,Conflans-sur-Anille,485,471,14
52,72,217200880,72088,Congé-sur-Orne,340,329,11
52,72,217200898,72089,Conlie,1881,1845,36
52,72,217200906,72090,Connerré,3011,2953,58
52,72,217200914,72091,Contilly,137,133,4
52,72,217200930,72093,Cormes,916,897,19
52,72,217200948,72094,Coudrecieux,636,623,13
52,72,217200955,72095,Coulaines,8076,7958,118
52,72,217200963,72096,Coulans-sur-Gée,1725,1647,78
52,72,217200989,72098,Coulongé,523,508,15
52,72,217200997,72099,Courceboeufs,649,642,7
52,72,217201003,72100,Courcelles-la-Forêt,413,409,4
52,72,217201011,72101,Courcemont,688,675,13
52,72,217201029,72102,Courcival,95,93,2
52,72,217201037,72103,Courdemanche,617,609,8
52,72,217201045,72104,Courgains,593,577,16
52,72,217201052,72105,Courgenard,491,482,9
52,72,217201060,72106,Courtillers,957,928,29
52,72,217201078,72107,Crannes-en-Champagne,352,345,7
52,72,217201094,72109,Crissé,556,550,6
52,72,217201102,72110,Crosmières,1059,1039,20
52,72,217201110,72111,Cures,494,477,17
52,72,217201128,72112,Dangeul,482,477,5
52,72,217201136,72113,Degré,768,756,12
52,72,217201144,72114,Dehault,274,267,7
52,72,217201151,72115,Dissay-sous-Courcillon,943,920,23
52,72,217201185,72118,Dollon,1469,1446,23
52,72,217201193,72119,Domfront-en-Champagne,1062,1043,19
52,72,217201201,72120,Doucelles,248,243,5
52,72,217201219,72121,Douillet,329,319,10
52,72,217201227,72122,Duneau,1082,1061,21
52,72,217201235,72123,Dureil,69,68,1
52,72,217201243,72124,Écommoy,4828,4752,76
52,72,217201250,72125,Écorpain,309,299,10
52,72,217201268,72126,Épineu-le-Chevreuil,301,292,9
52,72,217201276,72127,Étival-lès-le-Mans,1959,1921,38
52,72,200082790,72128,Val-d'Étangson,524,518,6
52,72,217201292,72129,Fatines,873,857,16
52,72,217201300,72130,Fay,728,716,12
52,72,217201318,72131,Fercé-sur-Sarthe,596,588,8
52,72,217201326,72132,La Ferté-Bernard,9198,8863,335
52,72,217201334,72133,Fillé,1535,1507,28
52,72,217201342,72134,Flée,543,528,15
52,72,217201359,72135,La Fontaine-Saint-Martin,607,601,6
52,72,217201367,72136,Fontenay-sur-Vègre,321,313,8
52,72,200047629,72137,Villeneuve-en-Perseigne,2257,2218,39
52,72,200085660,72138,Fresnay-sur-Sarthe,2916,2871,45
52,72,217201391,72139,Fyé,1022,981,41
52,72,217201417,72141,Gesnes-le-Gandelin,937,903,34
52,72,217201425,72142,Grandchamp,151,146,5
52,72,217201433,72143,Le Grand-Lucé,1952,1927,25
52,72,217201441,72144,Gréez-sur-Roc,334,330,4
52,72,217201458,72145,Le Grez,395,391,4
52,72,217201466,72146,Guécélard,3185,3144,41
52,72,217201474,72147,La Guierche,1202,1178,24
52,72,217201482,72148,Jauzé,82,81,1
52,72,217201490,72149,Joué-en-Charnie,624,614,10
52,72,217201508,72150,Joué-l'Abbé,1288,1266,22
52,72,217201516,72151,Juigné-sur-Sarthe,1162,1131,31
52,72,217201524,72152,Juillé,440,429,11
52,72,217201532,72153,Jupilles,565,551,14
52,72,217201540,72154,La Flèche,16165,15078,1087
52,72,217201557,72155,Laigné-en-Belin,2327,2297,30
52,72,217201565,72156,Lamnay,949,925,24
52,72,217201573,72157,Lavardin,716,703,13
52,72,217201581,72158,Lavaré,830,818,12
52,72,217201607,72160,Lavernat,598,586,12
52,72,217201615,72161,Lhomme,935,924,11
52,72,217201631,72163,Ligron,497,488,9
52,72,217201649,72164,Livet-en-Saosnois,70,70,0
52,72,217201656,72165,Lombron,1936,1912,24
52,72,217201664,72166,Longnes,324,314,10
52,72,217201672,72167,Louailles,725,714,11
52,72,217201680,72168,Loué,2102,2062,40
52,72,217201698,72169,Louplande,1483,1458,25
52,72,217201706,72170,Louvigny,176,169,7
52,72,217201714,72171,Louzes,106,103,3
52,72,217201722,72172,Le Luart,1458,1441,17
52,72,217201730,72173,Luceau,1261,1234,27
52,72,217201748,72174,Lucé-sous-Ballon,101,100,1
52,72,217201755,72175,Luché-Pringé,1542,1523,19
52,72,200077162,72176,Le Lude,4173,4100,73
52,72,217201771,72177,Maigné,361,357,4
52,72,217201789,72178,Maisoncelles,191,190,1
52,72,217201797,72179,Malicorne-sur-Sarthe,1916,1882,34
52,72,217201805,72180,Mamers,5252,5082,170
52,72,217201813,72181,Le Mans,147983,145155,2828
52,72,217201821,72182,Mansigné,1570,1541,29
52,72,217201839,72183,Marçon,1093,1076,17
52,72,217201847,72184,Mareil-en-Champagne,377,371,6
52,72,217201854,72185,Mareil-sur-Loir,665,660,5
52,72,217201862,72186,Maresché,896,885,11
52,72,217201870,72187,Marigné-Laillé,1630,1613,17
52,72,217201888,72188,Marollette,156,154,2
52,72,200082543,72189,Marolles-les-Braults,2087,2061,26
52,72,217201904,72190,Marolles-lès-Saint-Calais,290,280,10
52,72,217201912,72191,Mayet,3185,3142,43
52,72,217201920,72192,Les Mées,101,98,3
52,72,217201938,72193,Melleray,436,429,7
52,72,217201946,72194,Meurcé,269,267,2
52,72,217201953,72195,Mézeray,1881,1853,28
52,72,217201961,72196,Mézières-sur-Ponthouin,736,730,6
52,72,217201979,72197,Mézières-sous-Lavardin,691,686,5
52,72,217201987,72198,La Milesse,2671,2635,36
52,72,217201995,72199,Moitron-sur-Sarthe,283,282,1
52,72,217202001,72200,Moncé-en-Belin,3730,3669,61
52,72,217202019,72201,Moncé-en-Saosnois,264,259,5
52,72,217202027,72202,Monhoudou,204,194,10
52,72,217202043,72204,Montaillé,519,512,7
52,72,217202050,72205,Montbizot,1845,1821,24
52,72,217202084,72208,Montmirail,383,374,9
52,72,217202092,72209,Montreuil-le-Chétif,305,304,1
52,72,217202100,72210,Montreuil-le-Henri,306,301,5
52,72,217202118,72211,Mont-Saint-Jean,645,636,9
52,72,217202126,72212,Moulins-le-Carbonnel,710,697,13
52,72,217202134,72213,Mulsanne,5295,5231,64
52,72,217202142,72214,Nauvay,11,11,0
52,72,217202159,72215,Neufchâtel-en-Saosnois,1054,1042,12
52,72,217202167,72216,Neuvillalais,612,598,14
52,72,217202175,72217,Neuville-sur-Sarthe,2509,2461,48
52,72,217202183,72218,Neuvillette-en-Charnie,296,292,4
52,72,200083004,72219,Bernay-Neuvy-en-Champagne,909,821,88
52,72,217202209,72220,Nogent-le-Bernard,936,899,37
52,72,217202217,72221,Nogent-sur-Loir,374,369,5
52,72,217202225,72222,Nouans,264,264,0
52,72,217202233,72223,Noyen-sur-Sarthe,2665,2633,32
52,72,217202241,72224,Nuillé-le-Jalais,531,528,3
52,72,217202258,72225,Oisseau-le-Petit,677,669,8
52,72,217202266,72226,Oizé,1353,1334,19
52,72,217202274,72227,Panon,39,39,0
52,72,217202282,72228,Parcé-sur-Sarthe,2135,2086,49
52,72,217202290,72229,Parennes,473,465,8
52,72,217202308,72230,Parigné-le-Pôlin,1088,1062,26
52,72,217202316,72231,Parigné-l'Évêque,5404,5320,84
52,72,217202324,72232,Notre-Dame-du-Pé,687,674,13
52,72,217202332,72233,Peray,64,64,0
52,72,217202340,72234,Pezé-le-Robert,364,359,5
52,72,217202357,72235,Piacé,380,373,7
52,72,217202365,72236,Pincé,198,190,8
52,72,217202373,72237,Pirmil,508,502,6
52,72,217202381,72238,Pizieux,73,73,0
52,72,217202399,72239,Poillé-sur-Vègre,626,605,21
52,72,217202415,72241,Montfort-le-Gesnois,2954,2906,48
52,72,217202431,72243,Pontvallain,1660,1634,26
52,72,217202449,72244,Précigné,3001,2938,63
52,72,217202456,72245,Préval,698,684,14
52,72,217202464,72246,Prévelles,209,203,6
52,72,217202472,72247,Pruillé-le-Chétif,1362,1331,31
52,72,217202480,72248,Pruillé-l'Éguillé,841,818,23
52,72,217202498,72249,La Quinte,791,778,13
52,72,217202506,72250,Rahay,156,147,9
52,72,217202514,72251,René,394,389,5
52,72,217202522,72252,Requeil,1144,1134,10
52,72,217202530,72253,Roëzé-sur-Sarthe,2659,2589,70
52,72,217202548,72254,Rouessé-Fontaine,270,264,6
52,72,217202555,72255,Rouessé-Vassé,811,795,16
52,72,217202563,72256,Rouez,812,796,16
52,72,217202571,72257,Rouillon,2613,2297,316
52,72,217202597,72259,Rouperroux-le-Coquet,286,279,7
52,72,217202605,72260,Ruaudin,3600,3536,64
52,72,217202613,72261,Ruillé-en-Champagne,309,297,12
52,72,200072262,72262,Loir en Vallée,2250,2120,130
52,72,217202647,72264,Sablé-sur-Sarthe,12594,12123,471
52,72,217202654,72265,Saint-Aignan,234,232,2
52,72,217202662,72266,Saint-Aubin-de-Locquenay,760,743,17
52,72,217202670,72267,Saint-Aubin-des-Coudrais,934,913,21
52,72,217202688,72268,Saint-Biez-en-Belin,716,705,11
52,72,217202696,72269,Saint-Calais,3346,3139,207
52,72,217202704,72270,Saint-Calez-en-Saosnois,196,196,0
52,72,217202712,72271,Saint-Célerin,904,897,7
52,72,217202720,72272,Sainte-Cérotte,323,316,7
52,72,217202738,72273,Saint-Christophe-du-Jambet,234,231,3
52,72,217202746,72274,Saint-Christophe-en-Champagne,213,206,7
52,72,217202753,72275,Saint-Corneille,1541,1520,21
52,72,217202761,72276,Saint-Cosme-en-Vairais,1948,1902,46
52,72,217202779,72277,Saint-Denis-des-Coudrais,114,113,1
52,72,217202787,72278,Saint-Denis-d'Orques,773,762,11
52,72,217202795,72279,Saint-Georges-de-la-Couée,154,151,3
52,72,217202803,72280,Saint-Georges-du-Bois,2199,2162,37
52,72,217202811,72281,Saint-Georges-du-Rosay,452,447,5
52,72,217202829,72282,Saint-Georges-le-Gaultier,537,530,7
52,72,217202837,72283,Saint-Germain-d'Arcé,343,337,6
52,72,217202860,72286,Saint-Gervais-de-Vic,396,389,7
52,72,217202878,72287,Saint-Gervais-en-Belin,2049,2004,45
52,72,217202894,72289,Sainte-Jamme-sur-Sarthe,2044,2010,34
52,72,217202902,72290,Saint-Jean-d'Assé,1859,1842,17
52,72,217202910,72291,Saint-Jean-de-la-Motte,993,975,18
52,72,217202928,72292,Saint-Jean-des-Échelles,235,230,5
52,72,217202936,72293,Saint-Jean-du-Bois,620,613,7
52,72,217202944,72294,Saint-Léonard-des-Bois,489,474,15
52,72,217202951,72295,Saint-Longis,509,503,6
52,72,217202969,72296,Saint-Maixent,767,744,23
52,72,217202977,72297,Saint-Marceau,550,538,12
52,72,217202985,72298,Saint-Mars-de-Locquenay,579,565,14
52,72,217202993,72299,Saint-Mars-d'Outillé,2484,2450,34
52,72,217203009,72300,Saint-Mars-la-Brière,2726,2698,28
52,72,217203025,72302,Saint-Martin-des-Monts,174,170,4
52,72,217203033,72303,Saint-Michel-de-Chavaignes,740,731,9
52,72,217203058,72305,Saint-Ouen-de-Mimbré,957,933,24
52,72,217203066,72306,Saint-Ouen-en-Belin,1347,1323,24
52,72,217203074,72307,Saint-Ouen-en-Champagne,243,237,6
52,72,200065811,72308,Saint-Paterne - Le Chevain,2353,2103,250
52,72,217203090,72309,Saint-Paul-le-Gaultier,290,283,7
52,72,217203108,72310,Saint-Pavace,1968,1909,59
52,72,217203116,72311,Saint-Pierre-de-Chevillé,350,344,6
52,72,217203124,72312,Saint-Pierre-des-Bois,235,232,3
52,72,217203132,72313,Saint-Pierre-des-Ormes,229,224,5
52,72,217203140,72314,Saint-Pierre-du-Lorouër,386,378,8
52,72,217203157,72315,Saint-Rémy-de-Sillé,848,834,14
52,72,217203165,72316,Saint-Rémy-des-Monts,705,692,13
52,72,217203173,72317,Saint-Rémy-du-Val,515,500,15
52,72,217203199,72319,Sainte-Sabine-sur-Longève,757,738,19
52,72,217203207,72320,Saint-Saturnin,2787,2705,82
52,72,217203215,72321,Saint-Symphorien,519,509,10
52,72,217203223,72322,Saint-Ulphace,225,223,2
52,72,217203231,72323,Saint-Victeur,459,452,7
52,72,217203249,72324,Saint-Vincent-des-Prés,517,503,14
52,72,217203256,72325,Saint-Vincent-du-Lorouër,849,832,17
52,72,217203264,72326,Saosnes,214,211,3
52,72,217203272,72327,Sarcé,297,289,8
52,72,217203280,72328,Sargé-lès-le-Mans,3854,3761,93
52,72,217203298,72329,Savigné-l'Évêque,4141,4062,79
52,72,217203306,72330,Savigné-sous-le-Lude,449,436,13
52,72,217203314,72331,Sceaux-sur-Huisne,589,577,12
52,72,217203322,72332,Ségrie,611,603,8
52,72,217203330,72333,Semur-en-Vallon,449,438,11
52,72,217203348,72334,Sillé-le-Guillaume,2280,2195,85
52,72,217203355,72335,Sillé-le-Philippe,1088,1073,15
52,72,217203363,72336,Solesmes,1252,1212,40
52,72,217203371,72337,Sougé-le-Ganelon,867,847,20
52,72,217203389,72338,Souillé,795,784,11
52,72,217203397,72339,Souligné-Flacé,675,665,10
52,72,217203405,72340,Souligné-sous-Ballon,1261,1239,22
52,72,217203413,72341,Soulitré,631,619,12
52,72,217203421,72342,Souvigné-sur-Même,170,163,7
52,72,217203439,72343,Souvigné-sur-Sarthe,632,619,13
52,72,217203447,72344,Spay,2913,2863,50
52,72,217203454,72345,Surfonds,344,339,5
52,72,217203462,72346,La Suze-sur-Sarthe,4557,4498,59
52,72,217203470,72347,Tassé,302,297,5
52,72,217203488,72348,Tassillé,130,129,1
52,72,217203496,72349,Teillé,478,476,2
52,72,217203504,72350,Teloché,3118,3056,62
52,72,217203512,72351,Tennie,1067,1048,19
52,72,217203520,72352,Terrehault,140,140,0
52,72,217203538,72353,Théligny,220,215,5
52,72,217203546,72354,Thoigné,164,163,1
52,72,217203553,72355,Thoiré-sous-Contensor,111,110,1
52,72,217203561,72356,Thoiré-sur-Dinan,412,406,6
52,72,217203579,72357,Thorée-les-Pins,747,735,12
52,72,217203587,72358,Thorigné-sur-Dué,1650,1613,37
52,72,217203595,72359,Torcé-en-Vallée,1439,1430,9
52,72,217203603,72360,Trangé,1592,1553,39
52,72,217203611,72361,Tresson,499,491,8
52,72,217203629,72362,Le Tronchet,167,166,1
52,72,200054559,72363,Tuffé Val de la Chéronne,1684,1668,16
52,72,217203645,72364,Vaas,1419,1394,25
52,72,217203660,72366,Valennes,317,315,2
52,72,217203678,72367,Vallon-sur-Gée,796,785,11
52,72,217203686,72368,Vancé,313,310,3
52,72,217203694,72369,Verneil-le-Chétif,633,578,55
52,72,217203702,72370,Vernie,332,326,6
52,72,217203728,72372,Vezot,77,77,0
52,72,217203736,72373,Vibraye,2564,2509,55
52,72,217203744,72374,Villaines-la-Carelle,151,146,5
52,72,217203751,72375,Villaines-la-Gonais,543,529,14
52,72,217203769,72376,Villaines-sous-Lucé,713,688,25
52,72,217203777,72377,Villaines-sous-Malicorne,1046,1034,12
52,72,217203785,72378,Vion,1454,1426,28
52,72,217203793,72379,Viré-en-Champagne,205,198,7
52,72,217203801,72380,Vivoin,944,931,13
52,72,217203819,72381,Voivres-lès-le-Mans,1383,1371,12
52,72,217203827,72382,Volnay,973,955,18
52,72,217203835,72383,Vouvray-sur-Huisne,136,132,4
52,72,217203850,72385,Yvré-le-Pôlin,1783,1759,24
52,72,217203868,72386,Yvré-l'Évêque,4375,4241,134
84,73,217300011,73001,Aiguebelette-le-Lac,239,230,9
84,73,200084572,73003,Grand-Aigueblanche,3927,3823,104
84,73,217300045,73004,Aillon-le-Jeune,446,431,15
84,73,217300052,73005,Aillon-le-Vieux,199,194,5
84,73,200055762,73006,Aime-la-Plagne,4537,4433,104
84,73,217300078,73007,Aiton,1706,1683,23
84,73,217300086,73008,Aix-les-Bains,31642,31100,542
84,73,200053833,73010,Entrelacs,6480,6340,140
84,73,217300110,73011,Albertville,20414,19830,584
84,73,217300128,73012,Albiez-le-Jeune,148,146,2
84,73,217300136,73013,Albiez-Montrond,374,364,10
84,73,217300144,73014,Allondaz,298,290,8
84,73,217300151,73015,Les Allues,1877,1829,48
84,73,217300177,73017,Apremont,1000,979,21
84,73,217300185,73018,Arbin,786,765,21
84,73,217300193,73019,Argentine,972,951,21
84,73,217300201,73020,Arith,451,440,11
84,73,217300219,73021,Arvillard,863,846,17
84,73,217300227,73022,Attignat-Oncin,579,566,13
84,73,217300235,73023,Aussois,711,693,18
84,73,217300243,73024,Les Avanchers-Valmorel,790,768,22
84,73,217300250,73025,Avressieux,542,531,11
84,73,217300268,73026,Avrieux,405,389,16
84,73,217300276,73027,Ayn,393,387,6
84,73,217300284,73028,La Balme,347,344,3
84,73,217300292,73029,Barberaz,5290,5167,123
84,73,217300300,73030,Barby,3604,3551,53
84,73,217300318,73031,Bassens,5190,5063,127
84,73,217300326,73032,La Bâthie,2166,2129,37
84,73,217300334,73033,La Bauche,522,510,12
84,73,217300342,73034,Beaufort,2106,2024,82
84,73,217300367,73036,Bellecombe-en-Bauges,708,689,19
84,73,217300391,73039,Belmont-Tramonet,535,523,12
84,73,217300409,73040,Bessans,367,359,8
84,73,217300417,73041,Betton-Bettonet,315,307,8
84,73,217300425,73042,Billième,265,259,6
84,73,217300433,73043,La Biolle,2904,2867,37
84,73,217300474,73047,Bonneval-sur-Arc,268,263,5
84,73,217300482,73048,Bonvillard,367,353,14
84,73,217300490,73049,Bonvillaret,147,147,0
84,73,217300508,73050,Bourdeau,599,579,20
84,73,217300516,73051,Le Bourget-du-Lac,5009,4911,98
84,73,217300524,73052,Bourget-en-Huile,152,147,5
84,73,217300532,73053,Bourgneuf,705,694,11
84,73,217300540,73054,Bourg-Saint-Maurice,7561,7160,401
84,73,217300557,73055,Bozel,1934,1876,58
84,73,217300573,73057,Brides-les-Bains,504,491,13
84,73,217300581,73058,La Bridoire,1269,1250,19
84,73,217300599,73059,Brison-Saint-Innocent,2400,2327,73
84,73,217300615,73061,Césarches,437,421,16
84,73,217300631,73063,Cevins,714,705,9
84,73,217300649,73064,Challes-les-Eaux,5875,5609,266
84,73,217300656,73065,Chambéry,60749,59172,1577
84,73,217300672,73067,La Chambre,1183,1164,19
84,73,217300680,73068,Chamousset,610,597,13
84,73,217300698,73069,Chamoux-sur-Gelon,971,954,17
84,73,217300706,73070,Champagneux,701,692,9
84,73,217300714,73071,Champagny-en-Vanoise,577,557,20
84,73,217300722,73072,Champ-Laurent,32,31,1
84,73,217300730,73073,Chanaz,554,547,7
84,73,217300748,73074,La Chapelle,341,330,11
84,73,217300755,73075,La Chapelle-Blanche,600,577,23
84,73,217300763,73076,La Chapelle-du-Mont-du-Chat,265,260,5
84,73,217300771,73077,Les Chapelles,572,563,9
84,73,217300789,73078,La Chapelle-Saint-Martin,148,142,6
84,73,217300797,73079,Châteauneuf,952,936,16
84,73,217300813,73081,Le Châtelard,704,661,43
84,73,217300821,73082,La Chavanne,769,740,29
84,73,217300839,73083,Les Chavannes-en-Maurienne,226,223,3
84,73,217300847,73084,Chignin,953,938,15
84,73,217300854,73085,Chindrieux,1429,1408,21
84,73,217300862,73086,Cléry,401,388,13
84,73,217300870,73087,Cognin,6656,6467,189
84,73,217300888,73088,Cohennoz,155,151,4
84,73,217300896,73089,Coise-Saint-Jean-Pied-Gauthier,1307,1281,26
84,73,217300904,73090,La Compôte,271,264,7
84,73,217300912,73091,Conjux,213,210,3
84,73,217300920,73092,Corbel,158,154,4
84,73,217300946,73094,Crest-Voland,345,332,13
84,73,217300953,73095,La Croix-de-la-Rochette,392,383,9
84,73,217300961,73096,Cruet,1064,1045,19
84,73,217300979,73097,Curienne,692,671,21
84,73,217300987,73098,Les Déserts,834,812,22
84,73,217300995,73099,Détrier,439,435,4
84,73,217301001,73100,Domessin,1974,1929,45
84,73,217301019,73101,Doucy-en-Bauges,99,97,2
84,73,217301035,73103,Drumettaz-Clarafond,3065,2998,67
84,73,217301043,73104,Dullin,488,483,5
84,73,217301050,73105,Les Échelles,1262,1246,16
84,73,217301068,73106,École,312,306,6
84,73,217301076,73107,Entremont-le-Vieux,649,641,8
84,73,217301092,73109,Épierre,784,770,14
84,73,217301100,73110,Esserts-Blay,778,771,7
84,73,217301134,73113,Feissons-sur-Salins,178,175,3
84,73,217301142,73114,Flumet,824,796,28
84,73,217301167,73116,Fontcouverte-la-Toussuire,493,481,12
84,73,217301175,73117,Fourneaux,708,698,10
84,73,217301191,73119,Freney,104,100,4
84,73,217301209,73120,Fréterive,626,616,10
84,73,217301217,73121,Frontenex,1991,1943,48
84,73,217301225,73122,Gerbaix,446,427,19
84,73,217301233,73123,La Giettaz,397,383,14
84,73,217301241,73124,Gilly-sur-Isère,3141,3062,79
84,73,217301282,73128,Grésy-sur-Aix,4701,4598,103
84,73,217301290,73129,Grésy-sur-Isère,1241,1202,39
84,73,217301308,73130,Grignon,2137,2097,40
84,73,217301316,73131,Hautecour,310,301,9
84,73,217301324,73132,Hauteluce,782,759,23
84,73,217301332,73133,Hauteville,359,351,8
84,73,200084523,73135,La Tour-en-Maurienne,1102,1083,19
84,73,217301373,73137,Jacob-Bellecombette,4094,4017,77
84,73,217301381,73138,Jarrier,506,495,11
84,73,217301399,73139,Jarsy,270,266,4
84,73,217301407,73140,Jongieux,287,281,6
84,73,217301415,73141,Laissaud,717,709,8
84,73,217301423,73142,Landry,822,802,20
84,73,217301456,73145,Lépin-le-Lac,482,469,13
84,73,217301464,73146,Lescheraines,807,790,17
84,73,217301472,73147,Loisieux,200,200,0
84,73,217301498,73149,Lucey,304,298,6
84,73,200055499,73150,La Plagne Tarentaise,3959,3828,131
84,73,200083681,73151,Porte-de-Savoie,3903,3830,73
84,73,217301522,73152,Marcieux,230,225,5
84,73,217301530,73153,Marthod,1376,1345,31
84,73,217301548,73154,Mercury,3434,3351,83
84,73,217301555,73155,Méry,2148,2106,42
84,73,217301563,73156,Meyrieux-Trouet,320,314,6
84,73,217301571,73157,Modane,3154,3010,144
84,73,217301597,73159,Les Mollettes,868,859,9
84,73,217301605,73160,Montagnole,1002,976,26
84,73,217301613,73161,Montagny,665,651,14
84,73,217301621,73162,Montailleur,695,671,24
84,73,217301647,73164,Montcel,1092,1037,55
84,73,217301662,73166,Montendry,55,53,2
84,73,217301688,73168,Montgilbert,119,117,2
84,73,217301704,73170,Monthion,536,526,10
84,73,217301712,73171,Montmélian,4137,4064,73
84,73,217301738,73173,Montricher-Albanne,487,477,10
84,73,217301753,73175,Montsapey,81,78,3
84,73,217301761,73176,Montvalezan,728,718,10
84,73,217301779,73177,Montvernier,243,236,7
84,73,217301787,73178,La Motte-en-Bauges,521,509,12
84,73,217301795,73179,La Motte-Servolex,13035,12377,658
84,73,217301803,73180,Motz,443,436,7
84,73,217301811,73181,Moûtiers,3932,3467,465
84,73,217301829,73182,Mouxy,2299,2248,51
84,73,217301837,73183,Myans,1330,1296,34
84,73,217301845,73184,Nances,529,518,11
84,73,217301860,73186,Notre-Dame-de-Bellecombe,486,474,12
84,73,200084705,73187,La Léchère,2651,2601,50
84,73,217301886,73188,Notre-Dame-des-Millières,1048,1024,24
84,73,217301894,73189,Notre-Dame-du-Cruet,225,223,2
84,73,217301902,73190,Notre-Dame-du-Pré,256,250,6
84,73,217301910,73191,Novalaise,2251,2185,66
84,73,217301928,73192,Le Noyer,216,211,5
84,73,217301936,73193,Ontex,110,107,3
84,73,217301944,73194,Orelle,326,317,9
84,73,217301969,73196,Pallud,812,794,18
84,73,217301977,73197,Peisey-Nancroix,660,636,24
84,73,217302009,73200,Planaise,562,555,7
84,73,217302017,73201,Planay,452,441,11
84,73,217302025,73202,Plancherine,474,463,11
84,73,217302041,73204,Le Pont-de-Beauvoisin,2099,2069,30
84,73,217302058,73205,Le Pontet,123,122,1
84,73,217302066,73206,Pralognan-la-Vanoise,734,712,22
84,73,217302074,73207,Presle,445,433,12
84,73,217302082,73208,Pugny-Chatenod,1012,987,25
84,73,217302108,73210,Puygros,383,377,6
84,73,217302116,73211,Queige,844,821,23
84,73,200086569,73212,Val-d'Arc,2038,2015,23
84,73,217302132,73213,La Ravoire,9487,8939,548
84,73,217302140,73214,Rochefort,253,243,10
84,73,200086882,73215,Valgelon-La Rochette,4244,4175,69
84,73,217302165,73216,Rognaix,498,492,6
84,73,217302173,73217,Rotherens,380,368,12
84,73,217302181,73218,Ruffieux,825,808,17
84,73,217302199,73219,Saint-Alban-de-Montbel,681,666,15
84,73,217302207,73220,Saint-Alban-d'Hurtières,379,369,10
84,73,217302215,73221,Saint-Alban-des-Villards,90,87,3
84,73,217302223,73222,Saint-Alban-Leysse,6499,6286,213
84,73,217302231,73223,Saint-André,453,446,7
84,73,217302249,73224,Saint-Avre,920,899,21
84,73,217302256,73225,Saint-Baldoph,2819,2730,89
84,73,217302264,73226,Saint-Béron,1731,1710,21
84,73,200064038,73227,Courchevel,2435,2358,77
84,73,217302280,73228,Saint-Cassin,959,936,23
84,73,217302298,73229,Saint-Christophe,542,529,13
84,73,217302306,73230,Saint-Colomban-des-Villards,131,130,1
84,73,217302314,73231,Saint-Étienne-de-Cuines,1232,1208,24
84,73,217302322,73232,Sainte-Foy-Tarentaise,729,707,22
84,73,217302330,73233,Saint-Franc,162,158,4
84,73,217302348,73234,Saint-François-de-Sales,151,148,3
84,73,200072270,73235,Saint François Longchamp,551,545,6
84,73,200084242,73236,Saint-Genix-les-Villages,2962,2895,67
84,73,217302371,73237,Saint-Georges-d'Hurtières,373,369,4
84,73,217302405,73240,Sainte-Hélène-du-Lac,824,803,21
84,73,217302413,73241,Sainte-Hélène-sur-Isère,1221,1201,20
84,73,217302421,73242,Saint-Jean-d'Arves,282,272,10
84,73,217302439,73243,Saint-Jean-d'Arvey,1783,1724,59
84,73,217302454,73245,Saint-Jean-de-Chevelu,849,834,15
84,73,217302462,73246,Saint-Jean-de-Couz,308,303,5
84,73,217302470,73247,Saint-Jean-de-la-Porte,1036,963,73
84,73,217302488,73248,Saint-Jean-de-Maurienne,7894,7560,334
84,73,217302496,73249,Saint-Jeoire-Prieuré,1948,1898,50
84,73,217302504,73250,Saint-Julien-Mont-Denis,1625,1588,37
84,73,217302520,73252,Saint-Léger,250,247,3
84,73,217302538,73253,Saint-Marcel,611,606,5
84,73,217302546,73254,Sainte-Marie-d'Alvey,125,123,2
84,73,217302553,73255,Sainte-Marie-de-Cuines,847,826,21
84,73,217302561,73256,Saint-Martin-d'Arc,318,310,8
84,73,200084606,73257,Les Belleville,3592,3476,116
84,73,217302587,73258,Saint-Martin-de-la-Porte,699,679,20
84,73,217302595,73259,Saint-Martin-sur-la-Chambre,556,541,15
84,73,217302611,73261,Saint-Michel-de-Maurienne,2754,2474,280
84,73,217302629,73262,Saint-Nicolas-la-Chapelle,511,476,35
84,73,200049393,73263,Saint-Offenge,1182,1151,31
84,73,217302652,73265,Saint-Ours,752,732,20
84,73,217302678,73267,Saint-Pancrace,311,301,10
84,73,217302686,73268,Saint-Paul-sur-Isère,587,526,61
84,73,217302694,73269,Saint-Paul,744,730,14
84,73,217302702,73270,Saint-Pierre-d'Albigny,4272,4168,104
84,73,217302710,73271,Saint-Pierre-d'Alvey,320,310,10
84,73,217302728,73272,Saint-Pierre-de-Belleville,181,177,4
84,73,217302736,73273,Saint-Pierre-de-Curtille,494,488,6
84,73,217302744,73274,Saint-Pierre-d'Entremont,462,447,15
84,73,217302751,73275,Saint-Pierre-de-Genebroz,328,319,9
84,73,217302769,73276,Saint-Pierre-de-Soucy,437,418,19
84,73,217302777,73277,Sainte-Reine,179,172,7
84,73,217302785,73278,Saint-Rémy-de-Maurienne,1259,1238,21
84,73,217302801,73280,Saint-Sorlin-d'Arves,357,349,8
84,73,217302819,73281,Saint-Sulpice,791,771,20
84,73,217302827,73282,Saint-Thibaud-de-Couz,1092,1074,18
84,73,217302835,73283,Saint-Vital,744,726,18
84,73,200056273,73284,Salins-Fontaine,1014,994,20
84,73,217302850,73285,Séez,2416,2367,49
84,73,217302868,73286,Serrières-en-Chautagne,1184,1166,18
84,73,217302884,73288,Sonnaz,2119,2072,47
84,73,217302892,73289,La Table,431,421,10
84,73,200064061,73290,Val-Cenis,2106,2068,38
84,73,217302926,73292,Thénésol,325,317,8
84,73,217302934,73293,Thoiry,461,454,7
84,73,217302942,73294,La Thuile,347,341,6
84,73,217302967,73296,Tignes,2058,2016,42
84,73,217302975,73297,Tournon,606,583,23
84,73,217302983,73298,Tours-en-Savoie,919,908,11
84,73,217302991,73299,Traize,332,326,6
84,73,217303007,73300,Tresserve,3088,2981,107
84,73,217303015,73301,Trévignin,849,833,16
84,73,217303023,73302,La Trinité,358,352,6
84,73,217303031,73303,Ugine,7366,7135,231
84,73,217303049,73304,Val-d'Isère,1636,1589,47
84,73,217303064,73306,Valloire,1096,1071,25
84,73,217303072,73307,Valmeinier,572,569,3
84,73,217303080,73308,Venthon,602,584,18
84,73,217303098,73309,Verel-de-Montbel,319,313,6
84,73,217303106,73310,Verel-Pragondran,492,480,12
84,73,217303114,73311,Le Verneil,105,100,5
84,73,217303122,73312,Verrens-Arvey,967,932,35
84,73,217303130,73313,Verthemex,233,231,2
84,73,217303148,73314,Villard-d'Héry,262,257,5
84,73,217303155,73315,Villard-Léger,463,450,13
84,73,217303163,73316,Villard-Sallet,292,288,4
84,73,217303171,73317,Villard-sur-Doron,718,692,26
84,73,217303189,73318,Villarembert,259,250,9
84,73,217303205,73320,Villargondran,860,834,26
84,73,217303221,73322,Villarodin-Bourget,552,538,14
84,73,217303239,73323,Villaroger,377,362,15
84,73,217303247,73324,Villaroux,196,189,7
84,73,217303262,73326,Vimines,2212,2172,40
84,73,217303270,73327,Vions,408,405,3
84,73,217303288,73328,Viviers-du-Lac,2342,2286,56
84,73,217303296,73329,Voglans,1971,1941,30
84,73,217303304,73330,Yenne,3114,3083,31
84,74,217400019,74001,Abondance,1568,1450,118
84,74,217400027,74002,Alby-sur-Chéran,2723,2665,58
84,74,217400035,74003,Alex,1140,1106,34
84,74,217400043,74004,Allèves,419,411,8
84,74,217400050,74005,Allinges,4885,4767,118
84,74,217400068,74006,Allonzier-la-Caille,2219,2182,37
84,74,217400076,74007,Amancy,2823,2767,56
84,74,217400084,74008,Ambilly,6080,6014,66
84,74,217400092,74009,Andilly,999,980,19
84,74,200063402,74010,Annecy,134942,131766,3176
84,74,217400126,74012,Annemasse,37859,37485,374
84,74,217400134,74013,Anthy-sur-Léman,2345,2253,92
84,74,217400142,74014,Arâches-la-Frasse,1865,1814,51
84,74,217400159,74015,Arbusigny,1159,1135,24
84,74,217400167,74016,Archamps,2657,2621,36
84,74,217400183,74018,Arenthon,1938,1888,50
84,74,217400191,74019,Argonay,3781,3508,273
84,74,217400209,74020,Armoy,1456,1398,58
84,74,217400217,74021,Arthaz-Pont-Notre-Dame,1677,1646,31
84,74,217400241,74024,Ayse,2285,2225,60
84,74,217400258,74025,Ballaison,1516,1495,21
84,74,217400266,74026,La Balme-de-Sillingy,5259,5119,140
84,74,217400274,74027,La Balme-de-Thuy,460,451,9
84,74,217400290,74029,Bassy,428,414,14
84,74,217400308,74030,La Baume,328,322,6
84,74,217400316,74031,Beaumont,3102,3045,57
84,74,217400324,74032,Bellevaux,1314,1275,39
84,74,217400332,74033,Bernex,1435,1407,28
84,74,217400340,74034,Le Biot,643,636,7
84,74,217400357,74035,Bloye,610,587,23
84,74,217400365,74036,Bluffy,394,382,12
84,74,217400373,74037,Boëge,1932,1870,62
84,74,217400381,74038,Bogève,1157,1128,29
84,74,217400407,74040,Bonne,3392,3246,146
84,74,217400415,74041,Bonnevaux,288,283,5
84,74,217400423,74042,Bonneville,12902,12511,391
84,74,217400431,74043,Bons-en-Chablais,5915,5806,109
84,74,217400449,74044,Bossey,1020,1010,10
84,74,217400456,74045,Le Bouchet-Mont-Charvin,259,253,6
84,74,217400464,74046,Boussy,524,512,12
84,74,217400480,74048,Brenthonne,1123,1103,20
84,74,217400498,74049,Brizon,482,481,1
84,74,217400506,74050,Burdignin,696,680,16
84,74,217400514,74051,Cercier,723,712,11
84,74,217400522,74052,Cernex,1128,1109,19
84,74,217400530,74053,Cervens,1266,1237,29
84,74,217400548,74054,Chainaz-les-Frasses,792,763,29
84,74,217400555,74055,Challonges,559,546,13
84,74,217400563,74056,Chamonix-Mont-Blanc,9019,8644,375
84,74,217400571,74057,Champanges,1160,1128,32
84,74,217400589,74058,La Chapelle-d'Abondance,925,909,16
84,74,217400597,74059,La Chapelle-Rambaud,267,258,9
84,74,217400605,74060,La Chapelle-Saint-Maurice,113,113,0
84,74,217400613,74061,Chapeiry,964,948,16
84,74,217400621,74062,Charvonnex,1482,1454,28
84,74,217400639,74063,Châtel,1248,1219,29
84,74,217400647,74064,Châtillon-sur-Cluses,1232,1190,42
84,74,217400654,74065,Chaumont,524,513,11
84,74,217400662,74066,Chavannaz,250,249,1
84,74,217400670,74067,Chavanod,2974,2803,171
84,74,217400688,74068,Chêne-en-Semine,524,515,9
84,74,217400696,74069,Chênex,821,807,14
84,74,217400704,74070,Chens-sur-Léman,2912,2877,35
84,74,217400712,74071,Chessenaz,231,224,7
84,74,217400720,74072,Chevaline,199,195,4
84,74,217400738,74073,Chevenoz,685,674,11
84,74,217400746,74074,Chevrier,645,638,7
84,74,217400753,74075,Chilly,1531,1507,24
84,74,217400761,74076,Choisy,1732,1688,44
84,74,217400779,74077,Clarafond-Arcine,1063,1040,23
84,74,217400787,74078,Clermont,405,400,5
84,74,217400795,74079,Les Clefs,690,684,6
84,74,217400803,74080,La Clusaz,1758,1706,52
84,74,217400811,74081,Cluses,17372,16976,396
84,74,217400829,74082,Collonges-sous-Salève,4089,3973,116
84,74,217400837,74083,Combloux,2223,2109,114
84,74,217400852,74085,Les Contamines-Montjoie,1153,1107,46
84,74,217400860,74086,Contamine-Sarzin,756,743,13
84,74,217400878,74087,Contamine-sur-Arve,2406,2256,150
84,74,217400886,74088,Copponex,1266,1243,23
84,74,217400894,74089,Cordon,1010,984,26
84,74,217400902,74090,Cornier,1405,1385,20
84,74,217400910,74091,La Côte-d'Arbroz,361,359,2
84,74,217400944,74094,Cranves-Sales,7239,7069,170
84,74,217400951,74095,Crempigny-Bonneguête,332,321,11
84,74,217400969,74096,Cruseilles,4981,4665,316
84,74,217400977,74097,Cusy,1893,1843,50
84,74,217400985,74098,Cuvat,1641,1584,57
84,74,217400993,74099,Demi-Quartier,850,814,36
84,74,217401009,74100,Desingy,801,775,26
84,74,217401017,74101,Dingy-en-Vuache,755,737,18
84,74,217401025,74102,Dingy-Saint-Clair,1492,1445,47
84,74,217401033,74103,Domancy,2312,2236,76
84,74,217401041,74104,Doussard,3713,3626,87
84,74,217401058,74105,Douvaine,6772,6688,84
84,74,217401066,74106,Draillant,918,895,23
84,74,217401074,74107,Droisy,158,153,5
84,74,217401082,74108,Duingt,1046,1020,26
84,74,217401090,74109,Éloise,951,931,20
84,74,217401116,74111,Entrevernes,213,210,3
84,74,200053551,74112,Epagny Metz-Tessy,8473,8271,202
84,74,217401140,74114,Essert-Romand,522,516,6
84,74,217401165,74116,Etaux,2105,2032,73
84,74,217401173,74117,Étercy,902,884,18
84,74,217401181,74118,Étrembières,2641,2612,29
84,74,217401199,74119,Évian-les-Bains,9369,9117,252
84,74,217401215,74121,Excenevex,1248,1231,17
84,74,217401223,74122,Faucigny,667,646,21
84,74,200054138,74123,Faverges-Seythenex,7814,7591,223
84,74,217401249,74124,Feigères,1833,1791,42
84,74,217401264,74126,Fessy,1058,1026,32
84,74,217401272,74127,Féternes,1506,1461,45
84,74,217401280,74128,Fillinges,3596,3525,71
84,74,217401298,74129,La Forclaz,229,226,3
84,74,217401306,74130,Franclens,571,540,31
84,74,217401314,74131,Frangy,2086,2047,39
84,74,217401330,74133,Gaillard,10468,10350,118
84,74,217401348,74134,Les Gets,1250,1224,26
84,74,217401355,74135,Giez,552,540,12
84,74,217401363,74136,Le Grand-Bornand,2135,2082,53
84,74,217401371,74137,Groisy,4092,3936,156
84,74,217401389,74138,Gruffy,1571,1508,63
84,74,217401397,74139,Habère-Lullin,1080,1049,31
84,74,217401405,74140,Habère-Poche,1501,1476,25
84,74,217401413,74141,Hauteville-sur-Fier,1072,1045,27
84,74,217401421,74142,Héry-sur-Alby,1011,979,32
84,74,217401439,74143,Les Houches,3251,3177,74
84,74,217401447,74144,Jonzier-Épagny,853,833,20
84,74,217401454,74145,Juvigny,641,629,12
84,74,217401462,74146,Larringes,1632,1584,48
84,74,217401470,74147,Lathuile,1047,1018,29
84,74,217401488,74148,Leschaux,277,270,7
84,74,217401504,74150,Loisin,1677,1647,30
84,74,217401512,74151,Lornay,587,578,9
84,74,217401520,74152,Lovagny,1313,1271,42
84,74,217401538,74153,Lucinges,1659,1594,65
84,74,217401546,74154,Lugrin,2563,2511,52
84,74,217401553,74155,Lullin,831,804,27
84,74,217401561,74156,Lully,714,700,14
84,74,217401579,74157,Lyaud,1808,1745,63
84,74,217401587,74158,Machilly,1121,1104,17
84,74,217401595,74159,Magland,3330,3266,64
84,74,217401603,74160,Manigod,1026,999,27
84,74,217401611,74161,Marcellaz-Albanais,2035,1977,58
84,74,217401629,74162,Marcellaz,1086,1067,19
84,74,217401637,74163,Margencel,2315,2235,80
84,74,217401645,74164,Marignier,6513,6333,180
84,74,217401652,74165,Marigny-Saint-Marcel,711,696,15
84,74,217401660,74166,Marin,1938,1885,53
84,74,200055382,74167,Val de Chaise,1411,1387,24
84,74,217401686,74168,Marlioz,1067,1053,14
84,74,217401694,74169,Marnaz,5837,5735,102
84,74,217401702,74170,Massingy,890,869,21
84,74,217401710,74171,Massongy,1573,1540,33
84,74,217401728,74172,Maxilly-sur-Léman,1485,1451,34
84,74,217401736,74173,Megève,3123,2999,124
84,74,217401744,74174,Mégevette,615,590,25
84,74,217401751,74175,Meillerie,319,313,6
84,74,217401769,74176,Menthon-Saint-Bernard,1954,1884,70
84,74,217401777,74177,Menthonnex-en-Bornes,1117,1097,20
84,74,217401785,74178,Menthonnex-sous-Clermont,747,733,14
84,74,217401793,74179,Mésigny,820,794,26
84,74,217401801,74180,Messery,2214,2164,50
84,74,217401835,74183,Mieussy,2527,2461,66
84,74,217401843,74184,Minzier,1055,1043,12
84,74,217401850,74185,Monnetier-Mornex,2378,2332,46
84,74,217401868,74186,Montagny-les-Lanches,795,772,23
84,74,217401884,74188,Montriond,968,944,24
84,74,217401892,74189,Mont-Saxonnex,1715,1666,49
84,74,217401900,74190,Morillon,684,671,13
84,74,217401918,74191,Morzine,2764,2690,74
84,74,217401926,74192,Moye,1006,970,36
84,74,217401934,74193,La Muraz,1082,1059,23
84,74,217401942,74194,Mûres,916,892,24
84,74,217401959,74195,Musièges,424,416,8
84,74,217401967,74196,Nancy-sur-Cluses,488,473,15
84,74,217401975,74197,Nangy,1663,1629,34
84,74,217401983,74198,Nâves-Parmelan,1026,1003,23
84,74,217401991,74199,Nernier,409,398,11
84,74,217402007,74200,Neuvecelle,3278,3181,97
84,74,217402015,74201,Neydens,2295,2271,24
84,74,217402023,74202,Nonglard,734,724,10
84,74,217402031,74203,Novel,52,50,2
84,74,217402056,74205,Onnion,1309,1280,29
84,74,217402064,74206,Orcier,1072,1053,19
84,74,217402080,74208,Passy,11790,11350,440
84,74,217402098,74209,Peillonnex,1411,1371,40
84,74,217402106,74210,Perrignier,1914,1875,39
84,74,217402114,74211,Pers-Jussy,3236,3145,91
84,74,200081446,74212,Glières-Val-de-Borne,1859,1828,31
84,74,217402130,74213,Poisy,8886,8522,364
84,74,217402155,74215,Praz-sur-Arly,1279,1245,34
84,74,217402163,74216,Présilly,1070,1053,17
84,74,217402189,74218,Publier,7686,7499,187
84,74,217402197,74219,Quintal,1305,1254,51
84,74,217402205,74220,Reignier-Ésery,8349,8150,199
84,74,217402213,74221,Le Reposoir,562,539,23
84,74,217402221,74222,Reyvroz,511,502,9
84,74,217402239,74223,La Rivière-Enverse,485,477,8
84,74,217402247,74224,La Roche-sur-Foron,11537,11155,382
84,74,217402254,74225,Rumilly,16362,15944,418
84,74,217402262,74226,Saint-André-de-Boëge,604,592,12
84,74,217402288,74228,Saint-Blaise,370,358,12
84,74,217402296,74229,Saint-Cergues,3755,3682,73
84,74,217402312,74231,Saint-Eusèbe,634,620,14
84,74,217402320,74232,Saint-Eustache,512,491,21
84,74,217402338,74233,Saint-Félix,2470,2425,45
84,74,217402346,74234,Saint-Ferréol,920,897,23
84,74,217402353,74235,Saint-Germain-sur-Rhône,629,617,12
84,74,217402361,74236,Saint-Gervais-les-Bains,5730,5606,124
84,74,217402379,74237,Saint-Gingolph,894,890,4
84,74,217402387,74238,Saint-Jean-d'Aulps,1606,1580,26
84,74,217402395,74239,Saint-Jean-de-Sixt,1502,1465,37
84,74,217402403,74240,Saint-Jean-de-Tholome,1079,1057,22
84,74,217402411,74241,Saint-Jeoire,3527,3426,101
84,74,217402429,74242,Saint-Jorioz,6358,6151,207
84,74,217402437,74243,Saint-Julien-en-Genevois,15968,15739,229
84,74,217402445,74244,Saint-Laurent,874,840,34
84,74,217402494,74249,Saint-Paul-en-Chablais,2583,2522,61
84,74,217402502,74250,Saint-Pierre-en-Faucigny,7464,7333,131
84,74,217402528,74252,Saint-Sigismond,628,608,20
84,74,217402536,74253,Saint-Sixt,1055,1017,38
84,74,217402544,74254,Saint-Sylvestre,619,603,16
84,74,217402551,74255,Sales,2204,2152,52
84,74,217402569,74256,Sallanches,17450,16986,464
84,74,217402577,74257,Sallenôves,811,792,19
84,74,217402585,74258,Samoëns,2438,2380,58
84,74,217402593,74259,Le Sappey,454,446,8
84,74,217402601,74260,Savigny,1006,985,21
84,74,217402619,74261,Saxel,499,491,8
84,74,217402627,74262,Scientrier,1180,1159,21
84,74,217402635,74263,Sciez,6516,6375,141
84,74,217402643,74264,Scionzier,9195,9057,138
84,74,217402650,74265,Serraval,774,702,72
84,74,217402668,74266,Servoz,1103,1068,35
84,74,217402676,74267,Sevrier,4336,4151,185
84,74,217402692,74269,Seyssel,2426,2353,73
84,74,217402718,74271,Seytroux,542,529,13
84,74,217402726,74272,Sillingy,5619,5480,139
84,74,217402734,74273,Sixt-Fer-à-Cheval,769,752,17
84,74,200056141,74275,Talloires-Montmin,1990,1924,66
84,74,217402767,74276,Taninges,3522,3429,93
84,74,217402783,74278,Thyez,6567,6419,148
84,74,217402791,74279,Thollon-les-Mémises,849,825,24
84,74,217402809,74280,Thônes,6876,6599,277
84,74,217402817,74281,Thonon-les-Bains,37732,36626,1106
84,74,200062586,74282,Fillière,9781,9534,247
84,74,217402833,74283,Thusy,1162,1143,19
84,74,217402841,74284,La Tour,1338,1313,25
84,74,217402858,74285,Usinens,430,421,9
84,74,217402866,74286,Vacheresse,877,860,17
84,74,217402874,74287,Vailly,936,916,20
84,74,217402882,74288,Valleiry,4968,4907,61
84,74,200081172,74289,Vallières-sur-Fier,2694,2633,61
84,74,217402908,74290,Vallorcine,419,407,12
84,74,217402916,74291,Vanzy,345,340,5
84,74,217402924,74292,Vaulx,1075,1044,31
84,74,217402932,74293,Veigy-Foncenex,4012,3967,45
84,74,217402940,74294,Verchaix,791,766,25
84,74,217402957,74295,La Vernaz,331,323,8
84,74,217402965,74296,Vers,950,933,17
84,74,217402973,74297,Versonnex,670,643,27
84,74,217402981,74298,Vétraz-Monthoux,9631,9360,271
84,74,217402999,74299,Veyrier-du-Lac,2369,2286,83
84,74,217403013,74301,Villard,962,941,21
84,74,217403021,74302,Les Villards-sur-Thônes,1110,1089,21
84,74,217403039,74303,Villaz,3477,3348,129
84,74,217403047,74304,Ville-en-Sallaz,945,935,10
84,74,217403054,74305,Ville-la-Grand,9149,9031,118
84,74,217403062,74306,Villy-le-Bouveret,625,608,17
84,74,217403070,74307,Villy-le-Pelloux,1011,995,16
84,74,217403088,74308,Vinzier,880,858,22
84,74,217403096,74309,Viry,5674,5590,84
84,74,217403104,74310,Viuz-la-Chiésaz,1332,1299,33
84,74,217403112,74311,Viuz-en-Sallaz,4636,4532,104
84,74,217403120,74312,Vougy,1611,1584,27
84,74,217403138,74313,Vovray-en-Bornes,562,554,8
84,74,217403146,74314,Vulbens,1699,1645,54
84,74,217403153,74315,Yvoire,1106,1084,22
11,75,217500016,75056,Paris,2162598,2145906,16692
28,76,217600014,76001,Allouville-Bellefosse,1174,1155,19
28,76,217600022,76002,Alvimare,627,618,9
28,76,217600048,76004,Ambrumesnil,487,473,14
28,76,217600055,76005,Amfreville-la-Mi-Voie,3329,3299,30
28,76,217600063,76006,Amfreville-les-Champs,183,179,4
28,76,217600071,76007,Anceaumeville,699,689,10
28,76,217600089,76008,Ancourt,641,630,11
28,76,217600097,76009,Ancourteville-sur-Héricourt,353,349,4
28,76,217600105,76010,Ancretiéville-Saint-Victor,377,371,6
28,76,217600113,76011,Ancretteville-sur-Mer,155,151,4
28,76,217600121,76012,Angerville-Bailleul,189,186,3
28,76,217600139,76013,Angerville-la-Martel,1115,1084,31
28,76,217600147,76014,Angerville-l'Orcher,1415,1400,15
28,76,217600154,76015,Angiens,523,514,9
28,76,217600162,76016,Anglesqueville-la-Bras-Long,127,125,2
28,76,217600170,76017,Anglesqueville-l'Esneval,668,662,6
28,76,217600188,76018,Val-de-Saâne,1516,1484,32
28,76,217600196,76019,Anneville-sur-Scie,435,425,10
28,76,217600204,76020,Anneville-Ambourville,1199,1176,23
28,76,217600212,76021,Annouville-Vilmesnil,464,461,3
28,76,217600220,76022,Anquetierville,347,334,13
28,76,217600238,76023,Anvéville,305,300,5
28,76,217600246,76024,Ardouval,160,156,4
28,76,217600253,76025,Argueil,348,343,5
28,76,217600261,76026,Arques-la-Bataille,2570,2526,44
28,76,217600287,76028,Aubéguimont,187,186,1
28,76,217600295,76029,Aubermesnil-aux-Érables,203,200,3
28,76,217600303,76030,Aubermesnil-Beaumais,519,516,3
28,76,217600329,76032,Auberville-la-Manuel,140,138,2
28,76,217600337,76033,Auberville-la-Renault,462,456,6
28,76,200083152,76034,Val-de-Scie,2550,2525,25
28,76,217600352,76035,Aumale,2014,1963,51
28,76,217600360,76036,Auppegard,711,692,19
28,76,217600386,76038,Authieux-Ratiéville,407,401,6
28,76,217600394,76039,Les Authieux-sur-le-Port-Saint-Ouen,1280,1254,26
28,76,217600402,76040,Autigny,312,312,0
28,76,200087369,76041,Les Hauts-de-Caux,1365,1347,18
28,76,217600428,76042,Auvilliers,106,103,3
28,76,217600436,76043,Auzebosc,1498,1138,360
28,76,217600451,76045,Auzouville-l'Esneval,367,358,9
28,76,217600469,76046,Auzouville-sur-Ry,702,690,12
28,76,217600477,76047,Auzouville-sur-Saâne,151,150,1
28,76,217600485,76048,Avesnes-en-Bray,297,291,6
28,76,217600493,76049,Avesnes-en-Val,283,275,8
28,76,217600501,76050,Avremesnil,1035,1008,27
28,76,217600519,76051,Bacqueville-en-Caux,1941,1904,37
28,76,217600527,76052,Bailleul-Neuville,224,223,1
28,76,217600535,76053,Baillolet,111,109,2
28,76,217600543,76054,Bailly-en-Rivière,526,522,4
28,76,217600550,76055,Baons-le-Comte,351,334,17
28,76,217600568,76056,Bardouville,632,622,10
28,76,217600576,76057,Barentin,12478,12239,239
28,76,217600584,76058,Baromesnil,221,216,5
28,76,217600592,76059,Bazinval,430,419,11
28,76,217600600,76060,Beaubec-la-Rosière,495,485,10
28,76,217600626,76062,Beaumont-le-Hareng,267,264,3
28,76,217600634,76063,Beauval-en-Caux,473,463,10
28,76,217600642,76064,Beaurepaire,511,498,13
28,76,217600659,76065,Beaussault,417,413,4
28,76,217600667,76066,Beautot,156,152,4
28,76,217600675,76067,Beauvoir-en-Lyons,610,596,14
28,76,217600683,76068,Bec-de-Mortagne,660,643,17
28,76,217600691,76069,Belbeuf,2295,2242,53
28,76,217600709,76070,Bellencombre,607,596,11
28,76,217600717,76071,Bellengreville,487,473,14
28,76,217600725,76072,Belleville-en-Caux,753,742,11
28,76,217600741,76074,La Bellière,53,53,0
28,76,217600758,76075,Belmesnil,453,450,3
28,76,217600766,76076,Bénarville,272,267,5
28,76,217600774,76077,Bénesville,175,170,5
28,76,217600790,76079,Bénouville,183,182,1
28,76,217600824,76082,Bernières,640,634,6
28,76,217600832,76083,Bertheauville,97,96,1
28,76,217600840,76084,Bertreville,121,119,2
28,76,217600857,76085,Bertreville-Saint-Ouen,344,335,9
28,76,217600865,76086,Bertrimont,218,216,2
28,76,217600873,76087,Berville-en-Caux,697,687,10
28,76,217600881,76088,Berville-sur-Seine,555,544,11
28,76,217600907,76090,Beuzeville-la-Grenier,1269,1253,16
28,76,217600915,76091,Beuzeville-la-Guérard,238,231,7
28,76,217600923,76092,Beuzevillette,636,626,10
28,76,217600931,76093,Bézancourt,373,360,13
28,76,217600949,76094,Bierville,333,331,2
28,76,217600956,76095,Bihorel,8363,8197,166
28,76,217600964,76096,Biville-la-Baignarde,670,660,10
28,76,217600972,76097,Biville-la-Rivière,105,105,0
28,76,217600998,76099,Blacqueville,739,730,9
28,76,217601004,76100,Blainville-Crevon,1245,1227,18
28,76,217601012,76101,Blangy-sur-Bresle,2912,2882,30
28,76,217601038,76103,Bonsecours,6561,6466,95
28,76,217601046,76104,Blosseville,265,252,13
28,76,217601053,76105,Le Bocasse,664,657,7
28,76,217601061,76106,Bois-d'Ennebourg,577,569,8
28,76,217601079,76107,Bois-Guilbert,301,297,4
28,76,217601087,76108,Bois-Guillaume,14753,14378,375
28,76,217601095,76109,Bois-Héroult,177,173,4
28,76,217601103,76110,Bois-Himont,474,469,5
28,76,217601111,76111,Bois-l'Évêque,620,610,10
28,76,217601129,76112,Le Bois-Robert,374,364,10
28,76,217601137,76113,Boissay,416,409,7
28,76,217601145,76114,Bolbec,11684,11551,133
28,76,217601152,76115,Bolleville,582,579,3
28,76,217601160,76116,Boos,4036,3990,46
28,76,217601178,76117,Bordeaux-Saint-Clair,664,644,20
28,76,217601186,76118,Bornambusc,256,248,8
28,76,217601194,76119,Bosc-Bérenger,203,201,2
28,76,217601202,76120,Bosc-Bordel,451,441,10
28,76,217601210,76121,Bosc-Édeline,369,366,3
28,76,217601228,76122,Callengeville,512,504,8
28,76,217601236,76123,Bosc-Guérard-Saint-Adrien,1091,1062,29
28,76,217601244,76124,Bosc-Hyons,441,433,8
28,76,217601251,76125,Bosc-le-Hard,1586,1567,19
28,76,217601269,76126,Bosc-Mesnil,324,318,6
28,76,217601285,76128,Bosville,595,580,15
28,76,217601293,76129,Boudeville,216,211,5
28,76,217601301,76130,Bouelles,285,281,4
28,76,217601319,76131,La Bouille,719,707,12
28,76,217601327,76132,Bourdainville,470,468,2
28,76,217601335,76133,Le Bourg-Dun,442,433,9
28,76,217601343,76134,Bourville,297,293,4
28,76,217601350,76135,Bouville,1008,996,12
28,76,217601368,76136,Brachy,713,700,13
28,76,217601384,76138,Bracquetuit,338,330,8
28,76,217601392,76139,Bradiancourt,224,221,3
28,76,217601400,76140,Brametot,197,195,2
28,76,217601418,76141,Bréauté,1380,1367,13
28,76,217601426,76142,Brémontier-Merval,572,447,125
28,76,217601434,76143,Bretteville-du-Grand-Caux,1389,1366,23
28,76,217601442,76144,Bretteville-Saint-Laurent,159,157,2
28,76,200068187,76146,Buchy,2933,2820,113
28,76,217601475,76147,Bully,920,898,22
28,76,217601483,76148,Bures-en-Bray,332,328,4
28,76,217601491,76149,Butot,290,285,5
28,76,217601517,76151,Cailleville,264,257,7
28,76,217601525,76152,Cailly,753,749,4
28,76,217601533,76153,Calleville-les-Deux-Églises,336,333,3
28,76,217601541,76154,Campneuseville,472,465,7
28,76,217601558,76155,Canehan,387,383,4
28,76,217601566,76156,Canouville,353,344,9
28,76,217601574,76157,Canteleu,14157,13807,350
28,76,217601582,76158,Canville-les-Deux-Églises,320,319,1
28,76,217601590,76159,Cany-Barville,3043,2997,46
28,76,217601608,76160,Carville-la-Folletière,433,424,9
28,76,217601616,76161,Carville-Pot-de-Fer,101,98,3
28,76,217601624,76162,Le Catelier,280,275,5
28,76,217601632,76163,Catenay,695,681,14
28,76,200059111,76164,Rives-en-Seine,4158,4092,66
28,76,217601657,76165,Caudebec-lès-Elbeuf,10061,9996,65
28,76,217601665,76166,Le Caule-Sainte-Beuve,485,481,4
28,76,217601673,76167,Cauville-sur-Mer,1627,1599,28
28,76,217601681,76168,Les Cent-Acres,66,65,1
28,76,217601699,76169,La Cerlangue,1402,1287,115
28,76,217601707,76170,La Chapelle-du-Bourgay,113,112,1
28,76,217601715,76171,La Chapelle-Saint-Ouen,138,137,1
28,76,217601723,76172,La Chapelle-sur-Dun,162,159,3
28,76,217601731,76173,La Chaussée,544,538,6
28,76,217601749,76174,Cideville,414,409,5
28,76,217601756,76175,Clais,268,261,7
28,76,217601764,76176,Clasville,355,348,7
28,76,217601772,76177,Claville-Motteville,282,276,6
28,76,217601780,76178,Cléon,4945,4919,26
28,76,217601798,76179,Clères,1393,1376,17
28,76,217601806,76180,Cleuville,198,190,8
28,76,217601814,76181,Cléville,152,149,3
28,76,217601822,76182,Cliponville,256,254,2
28,76,217601830,76183,Colleville,784,765,19
28,76,217601848,76184,Colmesnil-Manneville,113,110,3
28,76,217601855,76185,Compainville,169,165,4
28,76,217601863,76186,Conteville,500,497,3
28,76,217601871,76187,Contremoulins,169,166,3
28,76,217601889,76188,Cottévrard,478,474,4
28,76,217601897,76189,Crasville-la-Mallet,168,165,3
28,76,217601905,76190,Crasville-la-Rocquefort,212,209,3
28,76,217601921,76192,Criel-sur-Mer,2669,2617,52
28,76,217601939,76193,La Crique,341,336,5
28,76,217601947,76194,Criquebeuf-en-Caux,405,402,3
28,76,217601954,76195,Criquetot-le-Mauconduit,187,183,4
28,76,217601962,76196,Criquetot-l'Esneval,2645,2563,82
28,76,217601970,76197,Criquetot-sur-Longueville,220,218,2
28,76,217601988,76198,Criquetot-sur-Ouville,813,794,19
28,76,217601996,76199,Criquiers,721,711,10
28,76,217602002,76200,Critot,492,481,11
28,76,217602010,76201,Croisy-sur-Andelle,531,527,4
28,76,217602028,76202,Croixdalle,322,319,3
28,76,217602036,76203,Croix-Mare,740,733,7
28,76,217602044,76204,Cropus,259,258,1
28,76,217602051,76205,Crosville-sur-Scie,250,248,2
28,76,217602069,76206,Cuverville,352,344,8
28,76,217602077,76207,Cuverville-sur-Yères,202,196,6
28,76,217602085,76208,Cuy-Saint-Fiacre,663,654,9
28,76,217602093,76209,Dampierre-en-Bray,452,444,8
28,76,217602101,76210,Dampierre-Saint-Nicolas,454,453,1
28,76,217602119,76211,Dancourt,234,232,2
28,76,217602127,76212,Darnétal,9864,9780,84
28,76,217602135,76213,Daubeuf-Serville,408,399,9
28,76,217602143,76214,Dénestanville,273,271,2
28,76,217602168,76216,Déville-lès-Rouen,10723,10644,79
28,76,217602176,76217,Dieppe,28535,28091,444
28,76,217602184,76218,Doudeauville,106,104,2
28,76,217602192,76219,Doudeville,2516,2472,44
28,76,217602200,76220,Douvrend,534,522,12
28,76,217602218,76221,Drosay,197,192,5
28,76,217602226,76222,Duclair,4061,4010,51
28,76,217602234,76223,Écalles-Alix,515,509,6
28,76,217602242,76224,Écrainville,991,972,19
28,76,217602259,76225,Écretteville-lès-Baons,375,369,6
28,76,217602267,76226,Écretteville-sur-Mer,164,162,2
28,76,217602275,76227,Ectot-l'Auber,711,701,10
28,76,217602283,76228,Ectot-lès-Baons,404,397,7
28,76,217602291,76229,Elbeuf-en-Bray,415,401,14
28,76,217602309,76230,Elbeuf-sur-Andelle,481,475,6
28,76,217602317,76231,Elbeuf,16225,16087,138
28,76,217602325,76232,Életot,647,639,8
28,76,217602333,76233,Ellecourt,157,153,4
28,76,217602341,76234,Émanville,765,753,12
28,76,217602358,76235,Envermeu,2126,1993,133
28,76,217602366,76236,Envronville,352,351,1
28,76,217602374,76237,Épinay-sur-Duclair,517,510,7
28,76,217602382,76238,Épouville,2677,2638,39
28,76,217602390,76239,Épretot,798,784,14
28,76,217602408,76240,Épreville,1049,1036,13
28,76,217602416,76241,Ermenouville,145,139,6
28,76,217602424,76242,Ernemont-la-Villette,208,204,4
28,76,217602432,76243,Ernemont-sur-Buchy,295,293,2
28,76,217602440,76244,Esclavelles,391,385,6
28,76,217602457,76245,Eslettes,1654,1638,16
28,76,217602473,76247,Esteville,500,496,4
28,76,217602499,76249,Étaimpuis,845,838,7
28,76,217602507,76250,Étainhus,1230,1203,27
28,76,217602515,76251,Étalleville,437,434,3
28,76,217602523,76252,Étalondes,1077,1047,30
28,76,217602531,76253,Étoutteville,848,834,14
28,76,217602549,76254,Étretat,1244,1238,6
28,76,217602556,76255,Eu,6853,6653,200
28,76,217602572,76257,Fallencourt,185,183,2
28,76,200065845,76258,Terres-de-Caux,4317,4205,112
28,76,217602598,76259,Fécamp,18334,18054,280
28,76,217602606,76260,Ferrières-en-Bray,1687,1669,18
28,76,217602614,76261,La Ferté-Saint-Samson,461,450,11
28,76,217602622,76262,Fesques,144,142,2
28,76,217602630,76263,La Feuillie,1303,1280,23
28,76,217602648,76264,Flamanville,485,476,9
28,76,217602655,76265,Flamets-Frétils,166,162,4
28,76,217602663,76266,Flocques,716,701,15
28,76,217602689,76268,Fongueusemare,187,182,5
28,76,217602697,76269,Fontaine-en-Bray,175,172,3
28,76,217602705,76270,Fontaine-la-Mallet,2691,2637,54
28,76,217602713,76271,Fontaine-le-Bourg,1835,1817,18
28,76,217602721,76272,Fontaine-le-Dun,903,893,10
28,76,217602739,76273,Fontaine-sous-Préaux,572,558,14
28,76,217602747,76274,La Fontelaye,27,27,0
28,76,217602754,76275,Fontenay,1690,1664,26
28,76,200054674,76276,Forges-les-Eaux,3922,3750,172
28,76,217602788,76278,Foucarmont,794,781,13
28,76,217602796,76279,Foucart,369,359,10
28,76,217602804,76280,Fréauville,137,136,1
28,76,217602812,76281,La Frénaye,2135,2091,44
28,76,217602820,76282,Freneuse,969,960,9
28,76,217602838,76283,Fresles,242,237,5
28,76,217602846,76284,Fresnay-le-Long,334,329,5
28,76,217602853,76285,Fresne-le-Plan,575,567,8
28,76,217602861,76286,Fresnoy-Folny,686,678,8
28,76,217602879,76287,Fresquiennes,1061,1046,15
28,76,217602887,76288,Freulleville,365,362,3
28,76,200057339,76289,Saint Martin de l'If,1752,1728,24
28,76,217602903,76290,Frichemesnil,403,393,10
28,76,217602911,76291,Froberville,1193,1168,25
28,76,217602929,76292,Fry,145,142,3
28,76,217602937,76293,Fultot,240,240,0
28,76,217602945,76294,La Gaillarde,393,385,8
28,76,217602952,76295,Gaillefontaine,1220,1205,15
28,76,217602960,76296,Gainneville,2525,2495,30
28,76,217602978,76297,Gancourt-Saint-Étienne,232,226,6
28,76,217602986,76298,Ganzeville,474,468,6
28,76,217602994,76299,Gerponville,392,388,4
28,76,217603000,76300,Gerville,443,439,4
28,76,217603026,76302,Goderville,2893,2853,40
28,76,217603034,76303,Gommerville,734,726,8
28,76,217603042,76304,Gonfreville-Caillot,386,385,1
28,76,217603059,76305,Gonfreville-l'Orcher,9101,9042,59
28,76,217603067,76306,Gonnetot,178,176,2
28,76,217603075,76307,Gonneville-la-Mallet,1395,1376,19
28,76,217603083,76308,Gonneville-sur-Scie,530,522,8
28,76,217603091,76309,Gonzeville,128,126,2
28,76,217603117,76311,Goupillières,422,417,5
28,76,217603125,76312,Gournay-en-Bray,6120,6027,93
28,76,217603133,76313,Gouy,912,898,14
28,76,217603141,76314,Graimbouville,625,616,9
28,76,217603158,76315,Grainville-la-Teinturière,1094,1076,18
28,76,217603166,76316,Grainville-sur-Ry,450,441,9
28,76,217603174,76317,Grainville-Ymauville,442,430,12
28,76,217603182,76318,Grand-Camp,783,755,28
28,76,217603190,76319,Grand-Couronne,9912,9731,181
28,76,217603208,76320,Grandcourt,323,317,6
28,76,217603216,76321,Les Grandes-Ventes,1790,1764,26
28,76,217603224,76322,Le Grand-Quevilly,26269,26034,235
28,76,217603232,76323,Graval,159,155,4
28,76,217603240,76324,Grèges,867,852,15
28,76,217603257,76325,Grémonville,455,450,5
28,76,217603273,76327,Greuville,377,372,5
28,76,217603281,76328,Grigneuseville,381,376,5
28,76,217603299,76329,Gruchet-le-Valasse,3162,3123,39
28,76,217603307,76330,Gruchet-Saint-Siméon,706,686,20
28,76,217603315,76331,Grugny,1011,1006,5
28,76,217603323,76332,Grumesnil,444,437,7
28,76,217603331,76333,Guerville,475,471,4
28,76,217603349,76334,Gueures,544,527,17
28,76,217603356,76335,Gueutteville,89,89,0
28,76,217603364,76336,Gueutteville-les-Grès,377,372,5
28,76,217603380,76338,La Hallotière,222,218,4
28,76,217603398,76339,Le Hanouard,265,261,4
28,76,217603406,76340,Harcanville,537,530,7
28,76,217603414,76341,Harfleur,8387,8333,54
28,76,217603422,76342,Hattenville,729,712,17
28,76,217603430,76343,Haucourt,191,187,4
28,76,217603448,76344,Haudricourt,431,423,8
28,76,217603455,76345,Haussez,283,281,2
28,76,217603463,76346,Hautot-l'Auvray,323,315,8
28,76,217603471,76347,Hautot-le-Vatois,357,351,6
28,76,217603489,76348,Hautot-Saint-Sulpice,696,688,8
28,76,217603497,76349,Hautot-sur-Mer,1966,1896,70
28,76,217603505,76350,Hautot-sur-Seine,403,396,7
28,76,217603513,76351,Le Havre,167658,165830,1828
28,76,217603521,76352,La Haye,371,368,3
28,76,217603539,76353,Héberville,109,103,6
28,76,217603547,76354,Hénouville,1380,1366,14
28,76,217603554,76355,Héricourt-en-Caux,963,950,13
28,76,217603562,76356,Hermanville,117,115,2
28,76,217603570,76357,Hermeville,370,354,16
28,76,217603588,76358,Le Héron,251,250,1
28,76,217603596,76359,Héronchelles,149,147,2
28,76,217603604,76360,Heugleville-sur-Scie,649,640,9
28,76,217603612,76361,Heuqueville,722,713,9
28,76,217603620,76362,Heurteauville,300,293,7
28,76,217603638,76363,Hodeng-au-Bosc,588,579,9
28,76,217603646,76364,Hodeng-Hodenger,273,268,5
28,76,217603653,76365,Houdetot,189,189,0
28,76,217603661,76366,Le Houlme,4182,4149,33
28,76,217603679,76367,Houppeville,2966,2918,48
28,76,217603687,76368,Houquetot,341,335,6
28,76,217603695,76369,La Houssaye-Béranger,541,534,7
28,76,217603703,76370,Hugleville-en-Caux,432,429,3
28,76,217603711,76371,Les Ifs,71,71,0
28,76,217603729,76372,Illois,414,411,3
28,76,217603737,76373,Imbleville,310,304,6
28,76,217603745,76374,Incheville,1219,1202,17
28,76,217603752,76375,Ingouville,287,275,12
28,76,217603778,76377,Isneauville,3664,3601,63
28,76,217603786,76378,Jumièges,1727,1693,34
28,76,217603794,76379,Lamberville,197,195,2
28,76,217603802,76380,Lammerville,320,312,8
28,76,217603810,76381,Landes-Vieilles-et-Neuves,130,129,1
28,76,217603828,76382,Lanquetot,1175,1156,19
28,76,217603836,76383,Lestanville,96,95,1
28,76,217603844,76384,Lillebonne,8904,8761,143
28,76,217603851,76385,Limésy,1537,1483,54
28,76,217603869,76386,Limpiville,397,391,6
28,76,217603877,76387,Lindebeuf,395,388,7
28,76,217603885,76388,Lintot,477,473,4
28,76,217603893,76389,Lintot-les-Bois,195,188,7
28,76,217603901,76390,Les Loges,1116,1095,21
28,76,217603919,76391,La Londe,2419,2351,68
28,76,217603927,76392,Londinières,1273,1253,20
28,76,217603935,76393,Longmesnil,48,48,0
28,76,217603943,76394,Longroy,640,634,6
28,76,217603950,76395,Longueil,552,543,9
28,76,217603968,76396,Longuerue,340,338,2
28,76,217603976,76397,Longueville-sur-Scie,980,964,16
28,76,217603984,76398,Louvetot,766,760,6
28,76,217603992,76399,Lucy,194,191,3
28,76,217604008,76400,Luneray,2201,2164,37
28,76,200059061,76401,Arelaune-en-Seine,2568,2524,44
28,76,217604024,76402,Malaunay,6207,6160,47
28,76,217604032,76403,Malleville-les-Grès,208,205,3
28,76,217604040,76404,Manéglise,1288,1265,23
28,76,217604057,76405,Manéhouville,225,224,1
28,76,217604065,76406,Maniquerville,430,424,6
28,76,217604073,76407,Manneville-ès-Plains,315,307,8
28,76,217604081,76408,Manneville-la-Goupil,1064,1051,13
28,76,217604099,76409,Mannevillette,922,909,13
28,76,217604107,76410,Maromme,10971,10845,126
28,76,217604115,76411,Marques,234,233,1
28,76,217604123,76412,Martainville-Épreville,726,716,10
28,76,217604131,76413,Martigny,425,419,6
28,76,217604149,76414,Martin-Église,1655,1605,50
28,76,217604156,76415,Massy,332,327,5
28,76,217604164,76416,Mathonville,338,333,5
28,76,217604172,76417,Maucomble,417,407,10
28,76,217604180,76418,Maulévrier-Sainte-Gertrude,1034,1017,17
28,76,217604198,76419,Mauny,165,159,6
28,76,217604206,76420,Mauquenchy,364,359,5
28,76,217604214,76421,Mélamare,935,921,14
28,76,217604222,76422,Melleville,270,264,6
28,76,217604230,76423,Ménerval,170,168,2
28,76,217604248,76424,Ménonval,233,231,2
28,76,217604255,76425,Mentheville,301,296,5
28,76,217604263,76426,Mésangueville,159,159,0
28,76,217604271,76427,Mesnières-en-Bray,1177,928,249
28,76,217604289,76428,Le Mesnil-Durdent,20,17,3
28,76,217604297,76429,Le Mesnil-Esnard,8273,7925,348
28,76,217604305,76430,Mesnil-Follemprise,121,118,3
28,76,217604313,76431,Le Mesnil-Lieubray,99,96,3
28,76,217604321,76432,Mesnil-Mauger,248,244,4
28,76,217604339,76433,Mesnil-Panneville,749,742,7
28,76,217604347,76434,Mesnil-Raoul,1133,1126,7
28,76,217604354,76435,Le Mesnil-Réaume,811,795,16
28,76,217604362,76436,Le Mesnil-sous-Jumièges,621,617,4
28,76,217604370,76437,Meulers,576,562,14
28,76,217604388,76438,Millebosc,242,237,5
28,76,217604396,76439,Mirville,360,351,9
28,76,217604404,76440,Molagnies,211,207,4
28,76,217604412,76441,Monchaux-Soreng,634,622,12
28,76,217604420,76442,Monchy-sur-Eu,591,578,13
28,76,217604438,76443,Mont-Cauvaire,867,851,16
28,76,217604453,76445,Montérolier,613,606,7
28,76,217604461,76446,Montigny,1306,1288,18
28,76,217604479,76447,Montivilliers,15719,15500,219
28,76,217604487,76448,Montmain,1433,1397,36
28,76,217604495,76449,Montreuil-en-Caux,503,497,6
28,76,217604503,76450,Montroty,292,271,21
28,76,217604511,76451,Mont-Saint-Aignan,20101,19686,415
28,76,217604529,76452,Montville,4642,4593,49
28,76,217604537,76453,Morgny-la-Pommeraye,1094,1074,20
28,76,217604545,76454,Mortemer,86,86,0
28,76,217604552,76455,Morville-sur-Andelle,307,302,5
28,76,217604560,76456,Motteville,779,767,12
28,76,217604578,76457,Moulineaux,937,922,15
28,76,217604586,76458,Muchedent,131,128,3
28,76,217604594,76459,Nesle-Hodeng,353,348,5
28,76,217604602,76460,Nesle-Normandeuse,511,503,8
28,76,217604610,76461,Neufbosc,408,403,5
28,76,217604628,76462,Neufchâtel-en-Bray,4855,4646,209
28,76,217604636,76463,Neuf-Marché,685,664,21
28,76,217604644,76464,La Neuville-Chant-d'Oisel,2416,2378,38
28,76,217604651,76465,Neuville-Ferrières,568,559,9
28,76,217604677,76467,Néville,1348,1329,19
28,76,217604685,76468,Nointot,1398,1365,33
28,76,217604693,76469,Nolléval,429,424,5
28,76,217604701,76470,Normanville,683,658,25
28,76,217604719,76471,Norville,1022,995,27
28,76,217604727,76472,Notre-Dame-d'Aliermont,759,754,5
28,76,217604735,76473,Notre-Dame-de-Bliquetuit,819,808,11
28,76,217604743,76474,Notre-Dame-de-Bondeville,7053,6966,87
28,76,217604750,76475,Franqueville-Saint-Pierre,6291,6099,192
28,76,200057065,76476,Port-Jérôme-sur-Seine,10453,10264,189
28,76,217604776,76477,Notre-Dame-du-Bec,456,449,7
28,76,217604784,76478,Notre-Dame-du-Parc,191,190,1
28,76,217604792,76479,Nullemont,140,138,2
28,76,217604800,76480,Ocqueville,464,453,11
28,76,217604818,76481,Octeville-sur-Mer,6189,6070,119
28,76,217604826,76482,Offranville,3373,3162,211
28,76,217604834,76483,Oherville,229,227,2
28,76,217604842,76484,Oissel,12341,12266,75
28,76,217604859,76485,Omonville,318,275,43
28,76,217604867,76486,Orival,886,881,5
28,76,217604875,76487,Osmoy-Saint-Valery,321,315,6
28,76,217604883,76488,Ouainville,529,517,12
28,76,217604891,76489,Oudalle,452,441,11
28,76,217604909,76490,Ourville-en-Caux,1133,1118,15
28,76,217604917,76491,Ouville-l'Abbaye,670,659,11
28,76,217604925,76492,Ouville-la-Rivière,475,459,16
28,76,217604933,76493,Paluel,413,401,12
28,76,217604941,76494,Parc-d'Anxtot,596,587,9
28,76,217604958,76495,Pavilly,6216,6164,52
28,76,217604974,76497,Petit-Couronne,8910,8732,178
28,76,217604982,76498,Le Petit-Quevilly,22283,21997,286
28,76,217604990,76499,Petiville,1152,1124,28
28,76,217605005,76500,Pierrecourt,483,479,4
28,76,217605013,76501,Pierrefiques,141,134,7
28,76,217605021,76502,Pierreval,551,541,10
28,76,217605039,76503,Pissy-Pôville,1295,1275,20
28,76,217605047,76504,Pleine-Sève,129,127,2
28,76,217605054,76505,Pommereux,100,98,2
28,76,217605062,76506,Pommeréval,500,496,4
28,76,217605070,76507,Ponts-et-Marais,834,819,15
28,76,217605088,76508,La Poterie-Cap-d'Antifer,468,453,15
28,76,217605096,76509,Préaux,1878,1846,32
28,76,217605104,76510,Prétot-Vicquemare,236,234,2
28,76,217605112,76511,Preuseville,159,158,1
28,76,217605120,76512,Puisenval,23,23,0
28,76,217605138,76513,Quevillon,608,593,15
28,76,217605146,76514,Quévreville-la-Poterie,1042,1029,13
28,76,217605153,76515,Quiberville,548,534,14
28,76,217605161,76516,Quièvrecourt,429,411,18
28,76,217605179,76517,Quincampoix,3174,3102,72
28,76,217605187,76518,Raffetot,508,499,9
28,76,217605195,76519,Rainfreville,79,75,4
28,76,217605203,76520,Réalcamp,609,595,14
28,76,217605211,76521,Rebets,148,147,1
28,76,217605229,76522,La Remuée,1298,1274,24
28,76,217605237,76523,Rétonval,181,179,2
28,76,217605245,76524,Reuville,142,140,2
28,76,217605260,76526,Ricarville-du-Val,192,185,7
28,76,217605278,76527,Richemont,441,438,3
28,76,217605286,76528,Rieux,617,605,12
28,76,217605294,76529,Riville,307,301,6
28,76,217605302,76530,Robertot,228,223,5
28,76,217605310,76531,Rocquefort,331,323,8
28,76,217605328,76532,Rocquemont,802,784,18
28,76,217605336,76533,Rogerville,1686,1668,18
28,76,217605344,76534,Rolleville,1208,1196,12
28,76,217605351,76535,Roncherolles-en-Bray,470,462,8
28,76,217605369,76536,Roncherolles-sur-le-Vivier,1234,1212,22
28,76,217605377,76537,Ronchois,189,183,6
28,76,217605385,76538,Rosay,273,268,5
28,76,217605401,76540,Rouen,115792,114187,1605
28,76,217605419,76541,Roumare,1563,1536,27
28,76,217605427,76542,Routes,284,280,4
28,76,217605435,76543,Rouville,618,607,11
28,76,217605443,76544,Rouvray-Catillon,231,224,7
28,76,217605450,76545,Rouxmesnil-Bouteilles,1852,1811,41
28,76,217605468,76546,Royville,315,308,7
28,76,217605476,76547,La Rue-Saint-Pierre,782,773,9
28,76,217605484,76548,Ry,776,760,16
28,76,217605492,76549,Saâne-Saint-Just,145,139,6
28,76,217605500,76550,Sahurs,1228,1212,16
28,76,217605518,76551,Sainneville,863,852,11
28,76,217605526,76552,Sainte-Adresse,7406,7216,190
28,76,217605534,76553,Sainte-Agathe-d'Aliermont,302,298,4
28,76,217605542,76554,Saint-Aignan-sur-Ry,353,350,3
28,76,217605559,76555,Saint-André-sur-Cailly,842,821,21
28,76,217605567,76556,Saint-Antoine-la-Forêt,1115,1093,22
28,76,217605575,76557,Saint-Arnoult,1477,1455,22
28,76,217605583,76558,Saint-Aubin-Celloville,1186,1180,6
28,76,217605591,76559,Saint-Aubin-de-Crétot,513,505,8
28,76,217605609,76560,Saint-Aubin-Épinay,1037,1020,17
28,76,217605617,76561,Saint-Aubin-lès-Elbeuf,8501,8428,73
28,76,217605625,76562,Saint-Aubin-le-Cauf,860,838,22
28,76,217605633,76563,Saint-Aubin-Routot,1956,1935,21
28,76,217605641,76564,Saint-Aubin-sur-Mer,166,163,3
28,76,217605658,76565,Saint-Aubin-sur-Scie,1301,1200,101
28,76,217605666,76566,Sainte-Austreberthe,660,654,6
28,76,217605674,76567,Sainte-Beuve-en-Rivière,180,175,5
28,76,217605682,76568,Saint-Clair-sur-les-Monts,623,611,12
28,76,217605690,76569,Sainte-Colombe,223,222,1
28,76,217605708,76570,Saint-Crespin,317,313,4
28,76,217605716,76571,Sainte-Croix-sur-Buchy,691,688,3
28,76,217605724,76572,Saint-Denis-d'Aclon,128,123,5
28,76,217605732,76573,Saint-Denis-le-Thiboult,512,498,14
28,76,217605740,76574,Saint-Denis-sur-Scie,705,701,4
28,76,217605757,76575,Saint-Étienne-du-Rouvray,28562,28331,231
28,76,217605765,76576,Saint-Eustache-la-Forêt,1234,1218,16
28,76,217605773,76577,Sainte-Foy,638,625,13
28,76,217605781,76578,Sainte-Geneviève,274,269,5
28,76,217605807,76580,Saint-Georges-sur-Fontaine,929,912,17
28,76,217605815,76581,Saint-Germain-des-Essourts,392,383,9
28,76,217605823,76582,Saint-Germain-d'Étables,244,239,5
28,76,217605831,76583,Saint-Germain-sous-Cailly,336,331,5
28,76,217605849,76584,Saint-Germain-sur-Eaulne,224,219,5
28,76,217605856,76585,Saint-Gilles-de-Crétot,415,400,15
28,76,217605864,76586,Saint-Gilles-de-la-Neuville,649,644,5
28,76,217605872,76587,Sainte-Hélène-Bondeville,741,732,9
28,76,217605880,76588,Saint-Hellier,516,504,12
28,76,217605898,76589,Saint-Honoré,199,194,5
28,76,217605906,76590,Saint-Jacques-d'Aliermont,343,341,2
28,76,217605914,76591,Saint-Jacques-sur-Darnétal,3156,3108,48
28,76,217605922,76592,Saint-Jean-de-Folleville,837,811,26
28,76,217605930,76593,Saint-Jean-de-la-Neuville,635,624,11
28,76,217605948,76594,Saint-Jean-du-Cardonnay,1364,1338,26
28,76,217605955,76595,Saint-Jouin-Bruneval,1872,1837,35
28,76,217605963,76596,Saint-Laurent-de-Brèvedent,1529,1491,38
28,76,217605971,76597,Saint-Laurent-en-Caux,772,763,9
28,76,217605989,76598,Saint-Léger-aux-Bois,494,485,9
28,76,217605997,76599,Saint-Léger-du-Bourg-Denis,3659,3617,42
28,76,217606003,76600,Saint-Léonard,1736,1702,34
28,76,217606011,76601,Saint-Lucien,237,234,3
28,76,217606029,76602,Saint-Maclou-de-Folleville,634,619,15
28,76,217606037,76603,Saint-Maclou-la-Brière,468,462,6
28,76,217606045,76604,Saint-Mards,183,177,6
28,76,217606052,76605,Sainte-Marguerite-sur-Mer,476,463,13
28,76,217606060,76606,Morienne,214,189,25
28,76,217606086,76608,Sainte-Marguerite-sur-Duclair,2060,2027,33
28,76,217606094,76609,Sainte-Marie-au-Bosc,378,367,11
28,76,217606102,76610,Sainte-Marie-des-Champs,1589,1576,13
28,76,217606110,76611,Saint-Martin-aux-Arbres,325,316,9
28,76,217606128,76612,Saint-Martin-au-Bosc,268,262,6
28,76,217606136,76613,Saint-Martin-aux-Buneaux,658,646,12
28,76,217606144,76614,Saint-Martin-de-Boscherville,1566,1536,30
28,76,217606151,76615,Saint-Martin-du-Bec,660,637,23
28,76,217606169,76616,Saint-Martin-du-Manoir,1493,1460,33
28,76,217606177,76617,Saint-Martin-du-Vivier,1739,1675,64
28,76,200056943,76618,Petit-Caux,9862,9654,208
28,76,217606193,76619,Saint-Martin-le-Gaillard,289,284,5
28,76,217606201,76620,Saint-Martin-l'Hortier,279,272,7
28,76,217606219,76621,Saint-Martin-Osmonville,1205,1183,22
28,76,217606227,76622,Saint-Maurice-d'Ételan,308,298,10
28,76,217606235,76623,Saint-Michel-d'Halescourt,119,116,3
28,76,217606243,76624,Saint-Nicolas-d'Aliermont,3778,3718,60
28,76,217606268,76626,Saint-Nicolas-de-la-Haie,428,414,14
28,76,217606276,76627,Saint-Nicolas-de-la-Taille,1667,1649,18
28,76,217606284,76628,Saint-Ouen-du-Breuil,829,816,13
28,76,217606292,76629,Saint-Ouen-le-Mauger,283,278,5
28,76,217606300,76630,Saint-Ouen-sous-Bailly,234,227,7
28,76,217606318,76631,Saint-Paër,1322,1307,15
28,76,217606326,76632,Saint-Pierre-Bénouville,382,379,3
28,76,217606342,76634,Saint-Pierre-de-Manneville,900,885,15
28,76,217606359,76635,Saint-Pierre-des-Jonquières,74,74,0
28,76,217606367,76636,Saint-Pierre-de-Varengeville,2323,2290,33
28,76,217606375,76637,Saint-Pierre-en-Port,840,826,14
28,76,217606383,76638,Saint-Pierre-en-Val,1103,1087,16
28,76,217606409,76640,Saint-Pierre-lès-Elbeuf,8324,8251,73
28,76,217606417,76641,Saint-Pierre-le-Vieux,199,194,5
28,76,217606425,76642,Saint-Pierre-le-Viger,268,265,3
28,76,217606441,76644,Saint-Rémy-Boscrocourt,813,797,16
28,76,217606458,76645,Saint-Riquier-en-Rivière,150,145,5
28,76,217606466,76646,Saint-Riquier-ès-Plains,628,614,14
28,76,217606474,76647,Saint-Romain-de-Colbosc,4397,4355,42
28,76,217606482,76648,Saint-Saëns,2350,2326,24
28,76,217606490,76649,Saint-Saire,590,579,11
28,76,217606508,76650,Saint-Sauveur-d'Émalleville,1255,1226,29
28,76,217606516,76651,Saint-Sylvain,143,140,3
28,76,217606524,76652,Saint-Vaast-d'Équiqueville,767,762,5
28,76,217606532,76653,Saint-Vaast-Dieppedalle,375,372,3
28,76,217606540,76654,Saint-Vaast-du-Val,476,466,10
28,76,217606557,76655,Saint-Valery-en-Caux,4068,3906,162
28,76,217606565,76656,Saint-Victor-l'Abbaye,767,761,6
28,76,217606573,76657,Saint-Vigor-d'Ymonville,1164,1141,23
28,76,217606581,76658,Saint-Vincent-Cramesnil,716,695,21
28,76,217606607,76660,Sandouville,806,795,11
28,76,217606623,76662,Sassetot-le-Malgardé,109,108,1
28,76,217606631,76663,Sassetot-le-Mauconduit,1021,1002,19
28,76,217606649,76664,Sasseville,285,280,5
28,76,217606656,76665,Sauchay,443,438,5
28,76,217606664,76666,Saumont-la-Poterie,427,411,16
28,76,217606672,76667,Sauqueville,348,342,6
28,76,217606680,76668,Saussay,373,366,7
28,76,217606698,76669,Sausseuzemare-en-Caux,436,429,7
28,76,217606706,76670,Senneville-sur-Fécamp,899,888,11
28,76,217606714,76671,Sept-Meules,172,171,1
28,76,217606722,76672,Serqueux,980,965,15
28,76,217606730,76673,Servaville-Salmonville,1147,1131,16
28,76,217606755,76675,Sierville,1125,1111,14
28,76,217606763,76676,Sigy-en-Bray,502,494,8
28,76,217606771,76677,Smermesnil,376,368,8
28,76,217606789,76678,Sommery,847,837,10
28,76,217606797,76679,Sommesnil,114,113,1
28,76,217606805,76680,Sorquainville,189,185,4
28,76,217606813,76681,Sotteville-lès-Rouen,29530,29071,459
28,76,217606821,76682,Sotteville-sous-le-Val,753,749,4
28,76,217606839,76683,Sotteville-sur-Mer,409,399,10
28,76,217606847,76684,Tancarville,1255,1233,22
28,76,217606854,76685,Thérouldeville,674,666,8
28,76,217606862,76686,Theuville-aux-Maillots,543,535,8
28,76,217606888,76688,Thiergeville,410,399,11
28,76,217606896,76689,Thiétreville,407,369,38
28,76,217606904,76690,Thil-Manneville,673,654,19
28,76,217606912,76691,Le Thil-Riberpré,237,236,1
28,76,217606920,76692,Thiouville,290,285,5
28,76,217606938,76693,Le Tilleul,693,686,7
28,76,217606946,76694,Tocqueville-en-Caux,142,139,3
28,76,217606953,76695,Tocqueville-les-Murs,285,280,5
28,76,217606979,76697,Torcy-le-Grand,816,792,24
28,76,217606987,76698,Torcy-le-Petit,507,499,8
28,76,217606995,76699,Le Torp-Mesnil,463,459,4
28,76,217607001,76700,Tôtes,1606,1576,30
28,76,217607027,76702,Touffreville-la-Corbeline,851,835,16
28,76,217607035,76703,Touffreville-sur-Eu,223,215,8
28,76,217607050,76705,Tourville-la-Rivière,2581,2562,19
28,76,217607068,76706,Tourville-les-Ifs,730,722,8
28,76,217607076,76707,Tourville-sur-Arques,1235,1200,35
28,76,217607084,76708,Toussaint,710,699,11
28,76,217607092,76709,Le Trait,4876,4831,45
28,76,217607100,76710,Trémauville,105,103,2
28,76,217607118,76711,Le Tréport,4533,4441,92
28,76,217607126,76712,La Trinité-du-Mont,877,850,27
28,76,217607142,76714,Les Trois-Pierres,800,786,14
28,76,217607159,76715,Trouville,633,625,8
28,76,217607167,76716,Turretot,1524,1505,19
28,76,217607175,76717,Val-de-la-Haye,721,718,3
28,76,217607183,76718,Valliquerville,1461,1423,38
28,76,217607191,76719,Valmont,878,863,15
28,76,217607209,76720,Varengeville-sur-Mer,983,952,31
28,76,217607217,76721,Varneville-Bretteville,336,327,9
28,76,217607233,76723,Vassonville,436,429,7
28,76,217607241,76724,Vatierville,133,131,2
28,76,217607258,76725,Vattetot-sous-Beaumont,583,578,5
28,76,217607266,76726,Vattetot-sur-Mer,329,323,6
28,76,217607274,76727,Vatteville-la-Rue,1172,1146,26
28,76,217607282,76728,La Vaupalière,1192,1171,21
28,76,217607308,76730,Veauville-lès-Quelles,136,131,5
28,76,217607316,76731,Vénestanville,211,209,2
28,76,217607324,76732,Butot-Vénesville,244,240,4
28,76,217607332,76733,Ventes-Saint-Rémy,227,224,3
28,76,217607340,76734,Vergetot,457,445,12
28,76,217607357,76735,Veules-les-Roses,536,523,13
28,76,217607365,76736,Veulettes-sur-Mer,281,275,6
28,76,217607373,76737,Vibeuf,618,607,11
28,76,217607381,76738,Vieux-Manoir,778,767,11
28,76,217607399,76739,Vieux-Rouen-sur-Bresle,569,563,6
28,76,217607407,76740,La Vieux-Rue,588,578,10
28,76,217607415,76741,Villainville,294,282,12
28,76,217607431,76743,Villers-Écalles,1772,1753,19
28,76,217607449,76744,Villers-sous-Foucarmont,186,184,2
28,76,217607456,76745,Villy-sur-Yères,207,205,2
28,76,217607464,76746,Vinnemerville,230,228,2
28,76,217607472,76747,Virville,351,348,3
28,76,217607480,76748,Vittefleur,661,654,7
28,76,217607498,76749,Wanchy-Capval,343,335,8
28,76,217607506,76750,Yainville,1050,1037,13
28,76,217607514,76751,Yébleron,1289,1274,15
28,76,217607522,76752,Yerville,2535,2515,20
28,76,217607530,76753,Ymare,1204,1182,22
28,76,217607548,76754,Yport,731,718,13
28,76,217607555,76755,Ypreville-Biville,573,565,8
28,76,217607563,76756,Yquebeuf,241,240,1
28,76,217607571,76757,Yvecrique,649,636,13
28,76,217607589,76758,Yvetot,11485,11280,205
28,76,217607597,76759,Yville-sur-Seine,445,437,8
11,77,217700012,77001,Achères-la-Forêt,1180,1151,29
11,77,217700020,77002,Amillis,823,819,4
11,77,217700038,77003,Amponville,349,342,7
11,77,217700046,77004,Andrezel,300,299,1
11,77,217700053,77005,Annet-sur-Marne,3352,3305,47
11,77,217700061,77006,Arbonne-la-Forêt,998,978,20
11,77,217700079,77007,Argentières,361,355,6
11,77,217700087,77008,Armentières-en-Brie,1237,1213,24
11,77,217700095,77009,Arville,131,129,2
11,77,217700103,77010,Aubepierre-Ozouer-le-Repos,951,941,10
11,77,217700111,77011,Aufferville,498,491,7
11,77,217700129,77012,Augers-en-Brie,299,292,7
11,77,217700137,77013,Aulnoy,370,361,9
11,77,217700145,77014,Avon,13763,13545,218
11,77,217700152,77015,Baby,102,100,2
11,77,217700160,77016,Bagneaux-sur-Loing,1621,1607,14
11,77,217700186,77018,Bailly-Romainvilliers,7368,7288,80
11,77,217700194,77019,Balloy,338,335,3
11,77,217700202,77020,Bannost-Villegagnon,661,649,12
11,77,217700210,77021,Barbey,157,154,3
11,77,217700228,77022,Barbizon,1285,1245,40
11,77,217700236,77023,Barcy,366,359,7
11,77,217700244,77024,Bassevelle,394,393,1
11,77,217700251,77025,Bazoches-lès-Bray,880,872,8
11,77,217700269,77026,Beauchery-Saint-Martin,369,354,15
11,77,217700277,77027,Beaumont-du-Gâtinais,1191,1175,16
11,77,217700293,77029,Beauvoir,188,185,3
11,77,217700301,77030,Bellot,778,773,5
11,77,217700319,77031,Bernay-Vilbert,957,946,11
11,77,217700327,77032,Beton-Bazoches,941,924,17
11,77,217700335,77033,Bezalles,238,230,8
11,77,217700343,77034,Blandy,789,782,7
11,77,217700350,77035,Blennes,553,546,7
11,77,217700368,77036,Boisdon,137,134,3
11,77,217700376,77037,Bois-le-Roi,6080,5933,147
11,77,217700384,77038,Boissettes,420,413,7
11,77,217700392,77039,Boissise-la-Bertrand,1180,1169,11
11,77,217700400,77040,Boissise-le-Roi,3754,3712,42
11,77,217700418,77041,Boissy-aux-Cailles,285,278,7
11,77,217700426,77042,Boissy-le-Châtel,3290,3249,41
11,77,217700434,77043,Boitron,341,334,7
11,77,217700442,77044,Bombon,961,952,9
11,77,217700459,77045,Bougligny,732,721,11
11,77,217700467,77046,Boulancourt,339,329,10
11,77,217700475,77047,Bouleurs,1711,1698,13
11,77,217700483,77048,Bourron-Marlotte,2854,2768,86
11,77,217700491,77049,Boutigny,850,837,13
11,77,217700509,77050,Bransles,539,528,11
11,77,217700517,77051,Bray-sur-Seine,2355,2337,18
11,77,217700525,77052,Bréau,366,361,5
11,77,217700533,77053,Brie-Comte-Robert,19447,19161,286
11,77,217700541,77054,La Brosse-Montceaux,735,721,14
11,77,217700558,77055,Brou-sur-Chantereine,4900,4890,10
11,77,217700566,77056,Burcy,153,147,6
11,77,217700574,77057,Bussières,542,539,3
11,77,217700582,77058,Bussy-Saint-Georges,26907,26551,356
11,77,217700590,77059,Bussy-Saint-Martin,690,676,14
11,77,217700608,77060,Buthiers,746,730,16
11,77,217700616,77061,Cannes-Écluse,2601,2575,26
11,77,217700624,77062,Carnetin,466,456,10
11,77,217700632,77063,La Celle-sur-Morin,1266,1251,15
11,77,217700657,77065,Cély,1271,1247,24
11,77,217700665,77066,Cerneux,313,310,3
11,77,217700673,77067,Cesson,11069,10937,132
11,77,217700681,77068,Cessoy-en-Montois,219,215,4
11,77,217700699,77069,Chailly-en-Bière,2115,2083,32
11,77,217700707,77070,Chailly-en-Brie,1651,1520,131
11,77,217700715,77071,Chaintreaux,857,842,15
11,77,217700723,77072,Chalautre-la-Grande,688,678,10
11,77,217700731,77073,Chalautre-la-Petite,570,553,17
11,77,217700756,77075,Chalifert,1394,1384,10
11,77,217700764,77076,Chalmaison,811,757,54
11,77,217700772,77077,Chambry,1043,1032,11
11,77,217700780,77078,Chamigny,1417,1365,52
11,77,217700798,77079,Champagne-sur-Seine,6504,6354,150
11,77,217700806,77080,Champcenest,199,197,2
11,77,217700814,77081,Champdeuil,739,731,8
11,77,217700822,77082,Champeaux,824,812,12
11,77,217700830,77083,Champs-sur-Marne,25372,25230,142
11,77,217700848,77084,Changis-sur-Marne,1384,1372,12
11,77,217700855,77085,Chanteloup-en-Brie,4068,4017,51
11,77,217700863,77086,La Chapelle-Gauthier,1434,1428,6
11,77,217700871,77087,La Chapelle-Iger,179,177,2
11,77,217700889,77088,La Chapelle-la-Reine,2396,2367,29
11,77,217700897,77089,La Chapelle-Rablais,915,908,7
11,77,217700905,77090,La Chapelle-Saint-Sulpice,244,240,4
11,77,217700913,77091,Les Chapelles-Bourbon,497,494,3
11,77,217700939,77093,La Chapelle-Moutils,436,434,2
11,77,217700947,77094,Charmentray,301,300,1
11,77,217700954,77095,Charny,1556,1539,17
11,77,217700962,77096,Chartrettes,2598,2542,56
11,77,217700970,77097,Chartronges,301,299,2
11,77,217700988,77098,Châteaubleau,365,360,5
11,77,217700996,77099,Château-Landon,3074,3020,54
11,77,217701002,77100,Le Châtelet-en-Brie,4349,4282,67
11,77,217701010,77101,Châtenay-sur-Seine,1076,1060,16
11,77,217701028,77102,Châtenoy,162,161,1
11,77,217701036,77103,Châtillon-la-Borde,222,220,2
11,77,217701044,77104,Châtres,711,704,7
11,77,217701069,77106,Chauffry,1042,1024,18
11,77,217701077,77107,Chaumes-en-Brie,3414,3387,27
11,77,217701085,77108,Chelles,54691,54372,319
11,77,200084036,77109,Chenoise-Cucharmoy,1679,1653,26
11,77,217701101,77110,Chenou,312,305,7
11,77,217701119,77111,Chessy,6780,6724,56
11,77,217701127,77112,Chevrainvilliers,259,255,4
11,77,217701135,77113,Chevru,1079,1068,11
11,77,217701143,77114,Chevry-Cossigny,3962,3920,42
11,77,217701150,77115,Chevry-en-Sereine,528,511,17
11,77,217701168,77116,Choisy-en-Brie,1329,1314,15
11,77,217701176,77117,Citry,970,958,12
11,77,217701184,77118,Claye-Souilly,12435,12316,119
11,77,217701192,77119,Clos-Fontaine,247,244,3
11,77,217701200,77120,Cocherel,636,631,5
11,77,217701218,77121,Collégien,3381,3339,42
11,77,217701226,77122,Combs-la-Ville,21801,21657,144
11,77,217701234,77123,Compans,818,816,2
11,77,217701242,77124,Conches-sur-Gondoire,1774,1746,28
11,77,217701259,77125,Condé-Sainte-Libiaire,1446,1429,17
11,77,217701267,77126,Congis-sur-Thérouanne,1951,1769,182
11,77,217701275,77127,Coubert,1898,1885,13
11,77,217701283,77128,Couilly-Pont-aux-Dames,2125,2096,29
11,77,217701291,77129,Coulombs-en-Valois,574,566,8
11,77,217701309,77130,Coulommes,521,517,4
11,77,217701317,77131,Coulommiers,15167,14953,214
11,77,217701325,77132,Coupvray,2895,2867,28
11,77,217701333,77133,Courcelles-en-Bassée,199,196,3
11,77,217701341,77134,Courchamp,153,150,3
11,77,217701358,77135,Courpalay,1287,1272,15
11,77,217705359,77136,Courquetaine,196,189,7
11,77,217701374,77137,Courtacon,250,240,10
11,77,217701382,77138,Courtomer,553,548,5
11,77,217701390,77139,Courtry,6696,6643,53
11,77,217701408,77140,Coutençon,274,271,3
11,77,217701416,77141,Coutevroult,1205,1196,9
11,77,217701424,77142,Crécy-la-Chapelle,4843,4774,69
11,77,217701432,77143,Crégy-lès-Meaux,5328,5288,40
11,77,217701440,77144,Crèvecoeur-en-Brie,441,440,1
11,77,217701457,77145,Crisenoy,628,616,12
11,77,217701465,77146,Croissy-Beaubourg,2029,2009,20
11,77,217701473,77147,La Croix-en-Brie,671,664,7
11,77,217701481,77148,Crouy-sur-Ourcq,1843,1820,23
11,77,217701507,77150,Cuisy,465,460,5
11,77,217701515,77151,Dagny,274,270,4
11,77,217701523,77152,Dammarie-les-Lys,22471,22318,153
11,77,217701531,77153,Dammartin-en-Goële,10922,10830,92
11,77,217701549,77154,Dammartin-sur-Tigeaux,1183,1168,15
11,77,217701556,77155,Dampmart,3556,3517,39
11,77,217701564,77156,Darvault,915,903,12
11,77,217701572,77157,Dhuisy,322,317,5
11,77,217701580,77158,Diant,201,199,2
11,77,217701598,77159,Donnemarie-Dontilly,2809,2760,49
11,77,217701614,77161,Dormelles,815,797,18
11,77,217701622,77162,Doue,1103,1094,9
11,77,217701630,77163,Douy-la-Ramée,380,374,6
11,77,217701648,77164,Échouboulains,563,558,5
11,77,217701655,77165,Les Écrennes,607,602,5
11,77,217701671,77167,Égligny,325,320,5
11,77,217701689,77168,Égreville,2187,2151,36
11,77,217701697,77169,Émerainville,7699,7667,32
11,77,217701713,77171,Esbly,6509,6464,45
11,77,217701721,77172,Esmans,901,891,10
11,77,217701739,77173,Étrépilly,833,825,8
11,77,217701747,77174,Everly,590,578,12
11,77,217701754,77175,Évry-Grégy-sur-Yerre,3101,3070,31
11,77,217701762,77176,Faremoutiers,3018,2991,27
11,77,217701770,77177,Favières,1192,1186,6
11,77,217701788,77178,Faÿ-lès-Nemours,507,497,10
11,77,217701796,77179,Féricy,616,601,15
11,77,217701804,77180,Férolles-Attilly,1290,1263,27
11,77,217701812,77181,Ferrières-en-Brie,3832,3796,36
11,77,217701820,77182,La Ferté-Gaucher,4910,4877,33
11,77,217701838,77183,La Ferté-sous-Jouarre,9752,9672,80
11,77,217701846,77184,Flagy,621,610,11
11,77,217701853,77185,Fleury-en-Bière,671,654,17
11,77,217701861,77186,Fontainebleau,16368,15903,465
11,77,217701879,77187,Fontaine-Fourches,584,581,3
11,77,217701887,77188,Fontaine-le-Port,1010,992,18
11,77,217701903,77190,Fontains,269,263,6
11,77,217701911,77191,Fontenailles,1065,1052,13
11,77,217701929,77192,Fontenay-Trésigny,5814,5756,58
11,77,217701937,77193,Forfry,242,241,1
11,77,217701945,77194,Forges,438,421,17
11,77,217701952,77195,Fouju,593,583,10
11,77,217701960,77196,Fresnes-sur-Marne,971,964,7
11,77,217701978,77197,Frétoy,169,166,3
11,77,217701986,77198,Fromont,250,241,9
11,77,217701994,77199,Fublaines,1413,1402,11
11,77,217702000,77200,Garentreville,124,122,2
11,77,217702018,77201,Gastins,691,688,3
11,77,217702026,77202,La Genevraye,815,809,6
11,77,217702034,77203,Germigny-l'Évêque,1357,1336,21
11,77,217702042,77204,Germigny-sous-Coulombs,212,209,3
11,77,217702059,77205,Gesvres-le-Chapitre,148,147,1
11,77,217702067,77206,Giremoutiers,187,183,4
11,77,217702075,77207,Gironville,157,152,5
11,77,217702083,77208,Gouaix,1388,1361,27
11,77,217702091,77209,Gouvernes,1211,1188,23
11,77,217702109,77210,La Grande-Paroisse,2922,2886,36
11,77,217702117,77211,Grandpuits-Bailly-Carrois,1020,1015,5
11,77,217702125,77212,Gravon,166,163,3
11,77,217702141,77214,Gressy,820,807,13
11,77,217702158,77215,Gretz-Armainvilliers,8525,8459,66
11,77,217702166,77216,Grez-sur-Loing,1455,1421,34
11,77,217702174,77217,Grisy-Suisnes,2551,2521,30
11,77,217702182,77218,Grisy-sur-Seine,108,107,1
11,77,217702190,77219,Guérard,2673,2641,32
11,77,217702208,77220,Guercheville,269,265,4
11,77,217702216,77221,Guermantes,1160,1136,24
11,77,217702224,77222,Guignes,4373,4344,29
11,77,217702232,77223,Gurcy-le-Châtel,570,564,6
11,77,217702240,77224,Hautefeuille,257,253,4
11,77,217702257,77225,La Haute-Maison,333,327,6
11,77,217702265,77226,Héricy,2615,2518,97
11,77,217702273,77227,Hermé,632,615,17
11,77,217702281,77228,Hondevilliers,259,257,2
11,77,217702299,77229,La Houssaye-en-Brie,1664,1646,18
11,77,217702307,77230,Ichy,161,160,1
11,77,217702315,77231,Isles-les-Meldeuses,821,819,2
11,77,217702323,77232,Isles-lès-Villenoy,1162,1145,17
11,77,217702331,77233,Iverny,602,596,6
11,77,217702349,77234,Jablines,709,702,7
11,77,217702356,77235,Jaignes,322,317,5
11,77,217702364,77236,Jaulnes,349,345,4
11,77,217702372,77237,Jossigny,649,640,9
11,77,217702380,77238,Jouarre,4384,4345,39
11,77,217702398,77239,Jouy-le-Châtel,1524,1504,20
11,77,217702406,77240,Jouy-sur-Morin,2238,2212,26
11,77,217702414,77241,Juilly,2032,2018,14
11,77,217702422,77242,Jutigny,540,532,8
11,77,217702430,77243,Lagny-sur-Marne,21332,21139,193
11,77,217702448,77244,Larchant,709,697,12
11,77,217702455,77245,Laval-en-Brie,407,403,4
11,77,217702463,77246,Léchelle,599,583,16
11,77,217702471,77247,Lescherolles,449,441,8
11,77,217702489,77248,Lesches,784,776,8
11,77,217702497,77249,Lésigny,7242,7125,117
11,77,217702505,77250,Leudon-en-Brie,166,163,3
11,77,217702513,77251,Lieusaint,13891,13804,87
11,77,217702521,77252,Limoges-Fourches,570,564,6
11,77,217702539,77253,Lissy,316,315,1
11,77,217702547,77254,Liverdy-en-Brie,1318,1295,23
11,77,217702554,77255,Livry-sur-Seine,2237,2207,30
11,77,217702562,77256,Lizines,188,187,1
11,77,217702570,77257,Lizy-sur-Ourcq,3547,3529,18
11,77,217702588,77258,Lognes,14441,14388,53
11,77,217702596,77259,Longperrier,2313,2303,10
11,77,217702604,77260,Longueville,1804,1778,26
11,77,217702612,77261,Lorrez-le-Bocage-Préaux,1230,1208,22
11,77,217702620,77262,Louan-Villegruis-Fontaine,515,497,18
11,77,217702638,77263,Luisetaines,239,232,7
11,77,217702646,77264,Lumigny-Nesles-Ormeaux,1532,1512,20
11,77,217702653,77265,Luzancy,1144,1092,52
11,77,217702661,77266,Machault,797,785,12
11,77,217702679,77267,La Madeleine-sur-Loing,359,355,4
11,77,217702687,77268,Magny-le-Hongre,9230,9082,148
11,77,217702695,77269,Maincy,1872,1819,53
11,77,217702703,77270,Maisoncelles-en-Brie,966,954,12
11,77,217702711,77271,Maisoncelles-en-Gâtinais,138,137,1
11,77,217702729,77272,Maison-Rouge,869,861,8
11,77,217702737,77273,Marchémoret,597,594,3
11,77,217702745,77274,Marcilly,451,449,2
11,77,217702752,77275,Les Marêts,153,150,3
11,77,217702760,77276,Mareuil-lès-Meaux,3349,3306,43
11,77,217702778,77277,Marles-en-Brie,1819,1798,21
11,77,217702786,77278,Marolles-en-Brie,421,415,6
11,77,217702794,77279,Marolles-sur-Seine,1866,1832,34
11,77,217702802,77280,Mary-sur-Marne,1105,1095,10
11,77,217702810,77281,Mauperthuis,476,472,4
11,77,217702828,77282,Mauregard,369,365,4
11,77,217702836,77283,May-en-Multien,934,923,11
11,77,217702844,77284,Meaux,56191,55709,482
11,77,217702851,77285,Le Mée-sur-Seine,20817,20677,140
11,77,217702869,77286,Meigneux,237,231,6
11,77,217702877,77287,Meilleray,500,499,1
11,77,217702885,77288,Melun,41867,41609,258
11,77,217702893,77289,Melz-sur-Seine,354,351,3
11,77,217702901,77290,Méry-sur-Marne,741,684,57
11,77,217702919,77291,Le Mesnil-Amelot,1045,1041,4
11,77,217702927,77292,Messy,1220,1210,10
11,77,217702935,77293,Misy-sur-Yonne,911,894,17
11,77,217702943,77294,Mitry-Mory,20713,20620,93
11,77,217702950,77295,Moisenay,1393,1379,14
11,77,217702968,77296,Moissy-Cramayel,18117,17982,135
11,77,217702976,77297,Mondreville,332,327,5
11,77,217702984,77298,Mons-en-Montois,455,445,10
11,77,217703008,77300,Montceaux-lès-Meaux,613,601,12
11,77,217703016,77301,Montceaux-lès-Provins,323,322,1
11,77,217703024,77302,Montcourt-Fromonville,1976,1943,33
11,77,217703032,77303,Montdauphin,239,236,3
11,77,217703040,77304,Montenils,25,25,0
11,77,217703057,77305,Montereau-Fault-Yonne,22073,21888,185
11,77,217703065,77306,Montereau-sur-le-Jard,502,497,5
11,77,217703073,77307,Montévrain,14120,14017,103
11,77,217703081,77308,Montgé-en-Goële,734,728,6
11,77,217703099,77309,Monthyon,1761,1751,10
11,77,217703107,77310,Montigny-le-Guesdier,311,305,6
11,77,217703115,77311,Montigny-Lencoup,1423,1405,18
11,77,217703123,77312,Montigny-sur-Loing,2715,2640,75
11,77,217703131,77313,Montmachoux,261,259,2
11,77,217703149,77314,Montolivet,241,239,2
11,77,217703156,77315,Montry,3770,3740,30
11,77,200073039,77316,Moret-Loing-et-Orvanne,12845,12507,338
11,77,217703172,77317,Mormant,5141,5104,37
11,77,217703180,77318,Mortcerf,1444,1423,21
11,77,217703198,77319,Mortery,146,142,4
11,77,217703206,77320,Mouroux,6031,5972,59
11,77,217703214,77321,Mousseaux-lès-Bray,671,667,4
11,77,217703222,77322,Moussy-le-Neuf,3239,3212,27
11,77,217703230,77323,Moussy-le-Vieux,1485,1476,9
11,77,217703255,77325,Mouy-sur-Seine,365,360,5
11,77,217703263,77326,Nandy,6335,6262,73
11,77,217703271,77327,Nangis,8990,8904,86
11,77,217703289,77328,Nanteau-sur-Essonne,426,419,7
11,77,217703297,77329,Nanteau-sur-Lunain,690,687,3
11,77,217703305,77330,Nanteuil-lès-Meaux,6625,6549,76
11,77,217703313,77331,Nanteuil-sur-Marne,434,428,6
11,77,217703321,77332,Nantouillet,294,293,1
11,77,217703339,77333,Nemours,13109,12966,143
11,77,217703354,77335,Chauconin-Neufmontiers,3623,3595,28
11,77,217703362,77336,Neufmoutiers-en-Brie,1206,1195,11
11,77,217703370,77337,Noisiel,15853,15750,103
11,77,217703388,77338,Noisy-Rudignon,603,595,8
11,77,217703396,77339,Noisy-sur-École,1890,1829,61
11,77,217703404,77340,Nonville,618,606,12
11,77,217703412,77341,Noyen-sur-Seine,392,382,10
11,77,217703420,77342,Obsonville,109,109,0
11,77,217703438,77343,Ocquerre,405,386,19
11,77,217703446,77344,Oissery,2471,2448,23
11,77,217703453,77345,Orly-sur-Morin,669,660,9
11,77,217703479,77347,Les Ormes-sur-Voulzie,865,855,10
11,77,217703487,77348,Ormesson,240,237,3
11,77,217703495,77349,Othis,6807,6737,70
11,77,217703503,77350,Ozoir-la-Ferrière,20921,20712,209
11,77,217703529,77352,Ozouer-le-Voulgis,1971,1951,20
11,77,217703537,77353,Paley,449,444,5
11,77,217703545,77354,Pamfou,960,951,9
11,77,217703552,77355,Paroy,167,167,0
11,77,217703560,77356,Passy-sur-Seine,46,45,1
11,77,217703578,77357,Pécy,855,845,10
11,77,217703586,77358,Penchard,1353,1340,13
11,77,217703594,77359,Perthes,2040,2007,33
11,77,217703602,77360,Pézarches,396,392,4
11,77,217703610,77361,Pierre-Levée,468,461,7
11,77,217703636,77363,Le Pin,1581,1569,12
11,77,217703644,77364,Le Plessis-aux-Bois,259,257,2
11,77,217703651,77365,Le Plessis-Feu-Aussoux,629,624,5
11,77,217703669,77366,Le Plessis-l'Évêque,290,289,1
11,77,217703677,77367,Le Plessis-Placy,283,279,4
11,77,217703685,77368,Poigny,521,508,13
11,77,217703693,77369,Poincy,770,759,11
11,77,217703701,77370,Poligny,795,783,12
11,77,217703719,77371,Pommeuse,3017,2990,27
11,77,217703727,77372,Pomponne,4205,4168,37
11,77,217703735,77373,Pontault-Combault,37804,37579,225
11,77,217703743,77374,Pontcarré,2173,2154,19
11,77,217703768,77376,Précy-sur-Marne,799,797,2
11,77,217703776,77377,Presles-en-Brie,2339,2310,29
11,77,217703784,77378,Pringy,3284,3254,30
11,77,217703792,77379,Provins,12394,12115,279
11,77,217703800,77380,Puisieux,327,321,6
11,77,217703818,77381,Quiers,666,661,5
11,77,217703826,77382,Quincy-Voisins,5497,5443,54
11,77,217703834,77383,Rampillon,838,828,10
11,77,217703842,77384,Réau,1957,1954,3
11,77,217703859,77385,Rebais,2321,2298,23
11,77,217703867,77386,Recloses,629,607,22
11,77,217703875,77387,Remauville,477,468,9
11,77,217703883,77388,Reuil-en-Brie,829,822,7
11,77,217703891,77389,La Rochette,3911,3820,91
11,77,217703909,77390,Roissy-en-Brie,22747,22643,104
11,77,217703917,77391,Rouilly,502,491,11
11,77,217703925,77392,Rouvres,928,916,12
11,77,217703933,77393,Rozay-en-Brie,2863,2826,37
11,77,217703941,77394,Rubelles,3126,3095,31
11,77,217703958,77395,Rumont,124,120,4
11,77,217703966,77396,Rupéreux,100,100,0
11,77,217703974,77397,Saâcy-sur-Marne,1880,1859,21
11,77,217703982,77398,Sablonnières,730,722,8
11,77,217704006,77400,Saint-Augustin,1799,1774,25
11,77,217704014,77401,Sainte-Aulde,678,671,7
11,77,217704022,77402,Saint-Barthélemy,344,339,5
11,77,217704030,77403,Saint-Brice,821,808,13
11,77,217704048,77404,Sainte-Colombe,1845,1808,37
11,77,217704055,77405,Saint-Cyr-sur-Morin,1998,1955,43
11,77,217704063,77406,Saint-Denis-lès-Rebais,1025,1005,20
11,77,217704071,77407,Saint-Fargeau-Ponthierry,14429,14315,114
11,77,217704089,77408,Saint-Fiacre,427,425,2
11,77,217704097,77409,Saint-Germain-Laval,2851,2769,82
11,77,217704105,77410,Saint-Germain-Laxis,779,746,33
11,77,217704113,77411,Saint-Germain-sous-Doue,572,560,12
11,77,217704121,77412,Saint-Germain-sur-École,391,386,5
11,77,217704139,77413,Saint-Germain-sur-Morin,3895,3849,46
11,77,217704147,77414,Saint-Hilliers,496,489,7
11,77,217704154,77415,Saint-Jean-les-Deux-Jumeaux,1298,1281,17
11,77,217704162,77416,Saint-Just-en-Brie,252,247,5
11,77,217704170,77417,Saint-Léger,255,254,1
11,77,217704188,77418,Saint-Loup-de-Naud,883,871,12
11,77,217704196,77419,Saint-Mammès,3522,3404,118
11,77,217704204,77420,Saint-Mard,3872,3846,26
11,77,217704212,77421,Saint-Mars-Vieux-Maisons,263,256,7
11,77,217704238,77423,Saint-Martin-des-Champs,667,658,9
11,77,217704246,77424,Saint-Martin-du-Boschet,278,274,4
11,77,217704253,77425,Saint-Martin-en-Bière,751,730,21
11,77,217704261,77426,Saint-Méry,341,332,9
11,77,217704279,77427,Saint-Mesmes,613,608,5
11,77,217704287,77428,Saint-Ouen-en-Brie,843,834,9
11,77,217704295,77429,Saint-Ouen-sur-Morin,540,533,7
11,77,217704303,77430,Saint-Pathus,6291,6238,53
11,77,217704311,77431,Saint-Pierre-lès-Nemours,5503,5408,95
11,77,217704329,77432,Saint-Rémy-la-Vanne,997,987,10
11,77,200081628,77433,Beautheil-Saints,2026,1992,34
11,77,217704345,77434,Saint-Sauveur-lès-Bray,371,366,5
11,77,217704352,77435,Saint-Sauveur-sur-École,1134,1102,32
11,77,217704360,77436,Saint-Siméon,910,905,5
11,77,217704378,77437,Saint-Soupplets,3605,3574,31
11,77,217704386,77438,Saint-Thibault-des-Vignes,6378,6304,74
11,77,217704394,77439,Salins,1183,1170,13
11,77,217704402,77440,Sammeron,1150,1138,12
11,77,217704410,77441,Samois-sur-Seine,2072,2024,48
11,77,217704428,77442,Samoreau,2503,2441,62
11,77,217704436,77443,Sancy,398,390,8
11,77,217704444,77444,Sancy-lès-Provins,330,324,6
11,77,217704451,77445,Savigny-le-Temple,30404,30169,235
11,77,217704469,77446,Savins,607,598,9
11,77,217704477,77447,Seine-Port,1883,1835,48
11,77,217704485,77448,Sept-Sorts,556,547,9
11,77,217704493,77449,Serris,9789,9699,90
11,77,217704501,77450,Servon,3359,3308,51
11,77,217704519,77451,Signy-Signets,590,584,6
11,77,217704527,77452,Sigy,66,66,0
11,77,217704535,77453,Sivry-Courtry,1150,1136,14
11,77,217704543,77454,Sognolles-en-Montois,372,367,5
11,77,217704550,77455,Soignolles-en-Brie,2069,2038,31
11,77,217704568,77456,Soisy-Bouy,842,823,19
11,77,217704576,77457,Solers,1235,1212,23
11,77,217704584,77458,Souppes-sur-Loing,5352,5253,99
11,77,217704592,77459,Sourdun,1912,1519,393
11,77,217704600,77460,Tancrou,342,338,4
11,77,217704618,77461,Thénisy,305,299,6
11,77,217704626,77462,Thieux,895,893,2
11,77,217704634,77463,Thomery,3531,3419,112
11,77,217704642,77464,Thorigny-sur-Marne,10533,10427,106
11,77,217704659,77465,Thoury-Férottes,655,646,9
11,77,217704667,77466,Tigeaux,381,378,3
11,77,217704675,77467,La Tombe,203,203,0
11,77,217704683,77468,Torcy,22604,22500,104
11,77,217704691,77469,Touquin,1236,1224,12
11,77,217704709,77470,Tournan-en-Brie,8533,8429,104
11,77,217704717,77471,Tousson,357,349,8
11,77,217704725,77472,La Trétoire,499,492,7
11,77,217704733,77473,Treuzy-Levelay,411,404,7
11,77,217704741,77474,Trilbardou,671,666,5
11,77,217704758,77475,Trilport,5051,5020,31
11,77,217704766,77476,Trocy-en-Multien,232,230,2
11,77,217704774,77477,Ury,885,855,30
11,77,217704782,77478,Ussy-sur-Marne,1092,1085,7
11,77,217704790,77479,Vaires-sur-Marne,13450,13340,110
11,77,217704808,77480,Valence-en-Brie,1065,1056,9
11,77,217704816,77481,Vanvillé,190,188,2
11,77,217704824,77482,Varennes-sur-Seine,3732,3660,72
11,77,217704832,77483,Varreddes,2094,2077,17
11,77,217704840,77484,Vaucourtois,290,284,6
11,77,217704857,77485,Le Vaudoué,743,730,13
11,77,217704865,77486,Vaudoy-en-Brie,909,893,16
11,77,217704873,77487,Vaux-le-Pénil,11254,11102,152
11,77,217704899,77489,Vaux-sur-Lunain,239,237,2
11,77,217704907,77490,Vendrest,698,689,9
11,77,217704923,77492,Verdelot,645,641,4
11,77,217704931,77493,Verneuil-l'Étang,3208,3186,22
11,77,217704949,77494,Vernou-la-Celle-sur-Seine,2667,2630,37
11,77,217704956,77495,Vert-Saint-Denis,8649,8564,85
11,77,217704964,77496,Vieux-Champagne,193,189,4
11,77,217704980,77498,Vignely,318,313,5
11,77,217705003,77500,Villebéon,474,463,11
11,77,217705011,77501,Villecerf,734,720,14
11,77,200086478,77504,Villemaréchal,1119,1096,23
11,77,217705052,77505,Villemareuil,386,381,5
11,77,217705060,77506,Villemer,799,789,10
11,77,217705078,77507,Villenauxe-la-Petite,431,424,7
11,77,217705086,77508,Villeneuve-le-Comte,1899,1862,37
11,77,217705094,77509,Villeneuve-les-Bordes,621,615,6
11,77,217705102,77510,Villeneuve-Saint-Denis,1198,1193,5
11,77,217705110,77511,Villeneuve-sous-Dammartin,645,645,0
11,77,217705128,77512,Villeneuve-sur-Bellot,1140,1128,12
11,77,217705136,77513,Villenoy,5013,4982,31
11,77,217705144,77514,Villeparisis,26797,26700,97
11,77,217705151,77515,Villeroy,706,701,5
11,77,217705169,77516,Ville-Saint-Jacques,855,845,10
11,77,217705177,77517,Villevaudé,2148,2135,13
11,77,217705185,77518,Villiers-en-Bière,240,234,6
11,77,217705193,77519,Villiers-Saint-Georges,1194,1168,26
11,77,217705201,77520,Villiers-sous-Grez,678,659,19
11,77,217705219,77521,Villiers-sur-Morin,1972,1928,44
11,77,217705227,77522,Villiers-sur-Seine,302,297,5
11,77,217705235,77523,Villuis,261,258,3
11,77,217705243,77524,Vimpelles,528,522,6
11,77,217705250,77525,Vinantes,383,382,1
11,77,217705268,77526,Vincy-Manoeuvre,281,276,5
11,77,217705276,77527,Voinsles,600,583,17
11,77,217705284,77528,Voisenon,1184,1168,16
11,77,217705292,77529,Voulangis,1520,1490,30
11,77,217705300,77530,Voulton,315,310,5
11,77,217705318,77531,Voulx,1668,1645,23
11,77,217705326,77532,Vulaines-lès-Provins,65,65,0
11,77,217705334,77533,Vulaines-sur-Seine,2803,2743,60
11,77,217705342,77534,Yèbles,950,949,1
11,78,217800036,78003,Ablis,3557,3509,48
11,78,217800051,78005,Achères,21812,21660,152
11,78,217800069,78006,Adainville,670,654,16
11,78,217800077,78007,Aigremont,1122,1085,37
11,78,217800093,78009,Allainville,292,286,6
11,78,217800101,78010,Les Alluets-le-Roi,1253,1215,38
11,78,217800135,78013,Andelu,486,482,4
11,78,217800150,78015,Andrésy,13385,13236,149
11,78,217800200,78020,Arnouville-lès-Mantes,954,940,14
11,78,217800291,78029,Aubergenville,12164,12082,82
11,78,217800309,78030,Auffargis,2017,1970,47
11,78,217800317,78031,Auffreville-Brasseuil,660,650,10
11,78,217800333,78033,Aulnay-sur-Mauldre,1167,1143,24
11,78,217800341,78034,Auteuil,995,976,19
11,78,217800366,78036,Autouillet,619,612,7
11,78,217800432,78043,Bailly,3829,3692,137
11,78,217800481,78048,Bazainville,1501,1460,41
11,78,217800499,78049,Bazemont,1728,1682,46
11,78,217800507,78050,Bazoches-sur-Guyonne,660,650,10
11,78,217800531,78053,Béhoust,501,488,13
11,78,217800572,78057,Bennecourt,1903,1882,21
11,78,217800622,78062,Beynes,7697,7585,112
11,78,217800689,78068,Blaru,919,892,27
11,78,217800705,78070,Boinville-en-Mantois,292,287,5
11,78,217800713,78071,Boinville-le-Gaillard,617,607,10
11,78,217800721,78072,Boinvilliers,252,250,2
11,78,217800739,78073,Bois-d'Arcy,15184,15028,156
11,78,217800762,78076,Boissets,284,280,4
11,78,217800770,78077,La Boissière-École,813,756,57
11,78,217800820,78082,Boissy-Mauvoisin,636,625,11
11,78,217800846,78084,Boissy-sans-Avoir,653,640,13
11,78,217800879,78087,Bonnelles,2144,2095,49
11,78,217800895,78089,Bonnières-sur-Seine,4924,4882,42
11,78,217800903,78090,Bouafle,2229,2204,25
11,78,217800929,78092,Bougival,9127,8983,144
11,78,217800960,78096,Bourdonné,516,502,14
11,78,217801042,78104,Breuil-Bois-Robert,767,754,13
11,78,217801075,78107,Bréval,1929,1901,28
11,78,217801083,78108,Les Bréviaires,1334,1305,29
11,78,217801133,78113,Brueil-en-Vexin,712,698,14
11,78,217801174,78117,Buc,6097,5972,125
11,78,217801182,78118,Buchelay,3334,3315,19
11,78,217801208,78120,Bullion,1978,1915,63
11,78,217801232,78123,Carrières-sous-Poissy,17542,17417,125
11,78,217801240,78124,Carrières-sur-Seine,15335,15115,220
11,78,217801257,78125,La Celle-les-Bordes,862,831,31
11,78,217801265,78126,La Celle-Saint-Cloud,20889,20496,393
11,78,217801281,78128,Cernay-la-Ville,1584,1546,38
11,78,217801331,78133,Chambourcy,5796,5646,150
11,78,217801380,78138,Chanteloup-les-Vignes,10795,10730,65
11,78,217801406,78140,Chapet,1361,1336,25
11,78,217801430,78143,Châteaufort,1506,1467,39
11,78,217801463,78146,Chatou,30190,29709,481
11,78,217801471,78147,Chaufour-lès-Bonnières,485,478,7
11,78,217801521,78152,Chavenay,1817,1743,74
11,78,200085470,78158,Le Chesnay-Rocquencourt,31707,31057,650
11,78,217801604,78160,Chevreuse,5708,5572,136
11,78,217801620,78162,Choisel,566,540,26
11,78,217801638,78163,Civry-la-Forêt,354,344,10
11,78,217801646,78164,Clairefontaine-en-Yvelines,894,829,65
11,78,217801653,78165,Les Clayes-sous-Bois,17624,17378,246
11,78,217801687,78168,Coignières,4408,4375,33
11,78,217801711,78171,Condé-sur-Vesgre,1282,1255,27
11,78,217801729,78172,Conflans-Sainte-Honorine,36372,35957,415
11,78,217801851,78185,Courgent,377,366,11
11,78,217801885,78188,Cravent,416,410,6
11,78,217801893,78189,Crespières,1764,1700,64
11,78,217801901,78190,Croissy-sur-Seine,10624,10324,300
11,78,217801927,78192,Dammartin-en-Serve,1396,1381,15
11,78,217801935,78193,Dampierre-en-Yvelines,1029,1012,17
11,78,217801943,78194,Dannemarie,220,217,3
11,78,217801968,78196,Davron,300,286,14
11,78,217802024,78202,Drocourt,569,561,8
11,78,217802065,78206,Ecquevilly,4168,4124,44
11,78,217802081,78208,Élancourt,26117,25857,260
11,78,217802099,78209,Émancé,903,890,13
11,78,217802172,78217,Épône,6716,6625,91
11,78,217802206,78220,Les Essarts-le-Roi,6877,6737,140
11,78,217802248,78224,L'Étang-la-Ville,4613,4430,183
11,78,217802271,78227,Évecquemont,787,782,5
11,78,217802305,78230,La Falaise,625,617,8
11,78,217802313,78231,Favrieux,160,154,6
11,78,217802339,78233,Feucherolles,3090,3001,89
11,78,217802347,78234,Flacourt,186,186,0
11,78,217802362,78236,Flexanville,588,579,9
11,78,217802370,78237,Flins-Neuve-Église,157,155,2
11,78,217802388,78238,Flins-sur-Seine,2469,2439,30
11,78,217802396,78239,Follainville-Dennemont,2196,2167,29
11,78,217802420,78242,Fontenay-le-Fleury,13682,13518,164
11,78,217802453,78245,Fontenay-Mauvoisin,414,401,13
11,78,217802461,78246,Fontenay-Saint-Père,968,950,18
11,78,217802552,78255,Freneuse,4320,4262,58
11,78,217802610,78261,Gaillon-sur-Montcient,682,670,12
11,78,217802628,78262,Galluis,1263,1246,17
11,78,217802636,78263,Gambais,2533,2469,64
11,78,217802644,78264,Gambaiseuil,62,60,2
11,78,217802651,78265,Garancières,2492,2447,45
11,78,217802677,78267,Gargenville,7933,7878,55
11,78,217802693,78269,Gazeran,1325,1295,30
11,78,217802768,78276,Gommecourt,664,656,8
11,78,217802784,78278,Goupillières,542,530,12
11,78,217802818,78281,Goussonville,638,628,10
11,78,217802834,78283,Grandchamp,303,293,10
11,78,217802859,78285,Gressey,557,542,15
11,78,217802891,78289,Grosrouvre,931,892,39
11,78,217802909,78290,Guernes,1089,1075,14
11,78,217802917,78291,Guerville,2195,2157,38
11,78,217802966,78296,Guitrancourt,637,626,11
11,78,217802974,78297,Guyancourt,29760,29269,491
11,78,217802990,78299,Hardricourt,2508,2488,20
11,78,217803006,78300,Hargeville,454,444,10
11,78,217803022,78302,La Hauteville,169,164,5
11,78,217803055,78305,Herbeville,246,242,4
11,78,217803071,78307,Hermeray,967,942,25
11,78,217803105,78310,Houdan,3730,3690,40
11,78,217803113,78311,Houilles,33569,33250,319
11,78,217803147,78314,Issou,3959,3913,46
11,78,217803170,78317,Jambville,800,787,13
11,78,200084325,78320,Notre-Dame-de-la-Mer,719,704,15
11,78,217803212,78321,Jouars-Pontchartrain,5922,5803,119
11,78,217803220,78322,Jouy-en-Josas,8149,7983,166
11,78,217803246,78324,Jouy-Mauvoisin,562,559,3
11,78,217803253,78325,Jumeauville,613,607,6
11,78,217803279,78327,Juziers,3952,3912,40
11,78,217803295,78329,Lainville-en-Vexin,801,786,15
11,78,217803345,78334,Lévis-Saint-Nom,1637,1604,33
11,78,217803352,78335,Limay,17216,17112,104
11,78,217803378,78337,Limetz-Villez,2005,1972,33
11,78,217803436,78343,Les Loges-en-Josas,1727,1661,66
11,78,217803444,78344,Lommoye,661,652,9
11,78,217803469,78346,Longnes,1552,1529,23
11,78,217803493,78349,Longvilliers,517,505,12
11,78,217803501,78350,Louveciennes,7505,7342,163
11,78,217803543,78354,Magnanville,6269,6138,131
11,78,217803568,78356,Magny-les-Hameaux,9569,9417,152
11,78,217803584,78358,Maisons-Laffitte,23700,23204,496
11,78,217803618,78361,Mantes-la-Jolie,44114,43945,169
11,78,217803626,78362,Mantes-la-Ville,21015,20844,171
11,78,217803642,78364,Marcq,777,768,9
11,78,217803667,78366,Mareil-le-Guyon,410,397,13
11,78,217803675,78367,Mareil-Marly,3835,3669,166
11,78,217803683,78368,Mareil-sur-Mauldre,1740,1705,35
11,78,217803725,78372,Marly-le-Roi,16857,16352,505
11,78,217803808,78380,Maule,6182,5949,233
11,78,217803816,78381,Maulette,1048,1033,15
11,78,217803824,78382,Maurecourt,4435,4384,51
11,78,217803832,78383,Maurepas,18280,18046,234
11,78,217803840,78384,Médan,1375,1332,43
11,78,217803857,78385,Ménerville,217,214,3
11,78,217803899,78389,Méré,1707,1658,49
11,78,217803915,78391,Méricourt,387,380,7
11,78,217803964,78396,Le Mesnil-le-Roi,6414,6304,110
11,78,217803972,78397,Le Mesnil-Saint-Denis,6948,6831,117
11,78,217803980,78398,Les Mesnuls,899,876,23
11,78,217804012,78401,Meulan-en-Yvelines,9162,9080,82
11,78,217804020,78402,Mézières-sur-Seine,3818,3776,42
11,78,217804038,78403,Mézy-sur-Seine,2326,2292,34
11,78,217804046,78404,Millemont,284,280,4
11,78,217804061,78406,Milon-la-Chapelle,295,283,12
11,78,217804079,78407,Mittainville,647,632,15
11,78,217804103,78410,Moisson,974,959,15
11,78,217804137,78413,Mondreville,410,407,3
11,78,217804152,78415,Montainville,523,502,21
11,78,217804160,78416,Montalet-le-Bois,323,318,5
11,78,217804178,78417,Montchauvet,312,306,6
11,78,217804186,78418,Montesson,15076,14811,265
11,78,217804202,78420,Montfort-l'Amaury,2980,2903,77
11,78,217804236,78423,Montigny-le-Bretonneux,32335,31854,481
11,78,217804319,78431,Morainvilliers,3152,3069,83
11,78,217804376,78437,Mousseaux-sur-Seine,686,677,9
11,78,217804392,78439,Mulcent,109,108,1
11,78,217804400,78440,Les Mureaux,33705,33543,162
11,78,217804426,78442,Neauphle-le-Château,3439,3384,55
11,78,217804434,78443,Neauphle-le-Vieux,929,910,19
11,78,217804442,78444,Neauphlette,855,839,16
11,78,217804517,78451,Nézel,1069,1054,15
11,78,217804558,78455,Noisy-le-Roi,7977,7692,285
11,78,217804608,78460,Oinville-sur-Montcient,1095,1078,17
11,78,217804640,78464,Orcemont,1024,1007,17
11,78,217804657,78465,Orgerus,2536,2467,69
11,78,217804665,78466,Orgeval,7053,6849,204
11,78,217804707,78470,Orphin,901,882,19
11,78,217804723,78472,Orsonville,335,328,7
11,78,217804749,78474,Orvilliers,946,938,8
11,78,217804756,78475,Osmoy,409,400,9
11,78,217804780,78478,Paray-Douaville,231,224,7
11,78,217804814,78481,Le Pecq,16081,15792,289
11,78,217804848,78484,Perdreauville,669,652,17
11,78,217804863,78486,Le Perray-en-Yvelines,6671,6571,100
11,78,217804905,78490,Plaisir,31243,30897,346
11,78,217804970,78497,Poigny-la-Forêt,950,909,41
11,78,217804988,78498,Poissy,40049,39731,318
11,78,217804996,78499,Ponthévrard,706,685,21
11,78,217805019,78501,Porcheville,3213,3155,58
11,78,217805027,78502,Le Port-Marly,5505,5454,51
11,78,217805050,78505,Prunay-le-Temple,429,412,17
11,78,217805068,78506,Prunay-en-Yvelines,868,861,7
11,78,217805134,78513,La Queue-les-Yvelines,2379,2346,33
11,78,217805167,78516,Raizeux,1004,991,13
11,78,217805175,78517,Rambouillet,27534,27043,491
11,78,217805183,78518,Rennemoulin,116,112,4
11,78,217805209,78520,Richebourg,1615,1565,50
11,78,217805225,78522,Rochefort-en-Yvelines,932,894,38
11,78,217805282,78528,Rolleboise,370,367,3
11,78,217805308,78530,Rosay,383,377,6
11,78,217805316,78531,Rosny-sur-Seine,6953,6906,47
11,78,217805365,78536,Sailly,358,348,10
11,78,217805373,78537,Saint-Arnoult-en-Yvelines,5925,5791,134
11,78,217805456,78545,Saint-Cyr-l'École,21244,20611,633
11,78,217805480,78548,Saint-Forget,462,450,12
11,78,217805506,78550,Saint-Germain-de-la-Grange,1884,1847,37
11,78,200086924,78551,Saint-Germain-en-Laye,46171,44410,1761
11,78,217805571,78557,Saint-Hilarion,984,966,18
11,78,217805589,78558,Saint-Illiers-la-Ville,384,378,6
11,78,217805597,78559,Saint-Illiers-le-Bois,430,425,5
11,78,217805613,78561,Saint-Lambert,479,444,35
11,78,217805621,78562,Saint-Léger-en-Yvelines,1434,1402,32
11,78,217805647,78564,Saint-Martin-de-Bréthencourt,688,680,8
11,78,217805654,78565,Saint-Martin-des-Champs,312,303,9
11,78,217805670,78567,Saint-Martin-la-Garenne,940,929,11
11,78,217805696,78569,Sainte-Mesme,930,912,18
11,78,217805712,78571,Saint-Nom-la-Bretèche,5100,4892,208
11,78,217805753,78575,Saint-Rémy-lès-Chevreuse,7908,7750,158
11,78,217805761,78576,Saint-Rémy-l'Honoré,1671,1647,24
11,78,217805860,78586,Sartrouville,52158,51746,412
11,78,217805886,78588,Saulx-Marchais,989,961,28
11,78,217805902,78590,Senlisse,514,503,11
11,78,217805910,78591,Septeuil,2351,2310,41
11,78,217805977,78597,Soindres,705,698,7
11,78,217806017,78601,Sonchamp,1639,1580,59
11,78,217806058,78605,Tacoignières,1108,1092,16
11,78,217806066,78606,Le Tartre-Gaudran,37,36,1
11,78,217806082,78608,Le Tertre-Saint-Denis,122,121,1
11,78,217806090,78609,Tessancourt-sur-Aubette,1034,1024,10
11,78,217806157,78615,Thiverval-Grignon,1220,1198,22
11,78,217806165,78616,Thoiry,1456,1428,28
11,78,217806181,78618,Tilly,523,509,14
11,78,217806207,78620,Toussus-le-Noble,1202,1164,38
11,78,217806215,78621,Trappes,33527,33419,108
11,78,217806231,78623,Le Tremblay-sur-Mauldre,1106,956,150
11,78,217806249,78624,Triel-sur-Seine,12556,12360,196
11,78,217806389,78638,Vaux-sur-Seine,5088,5020,68
11,78,217806405,78640,Vélizy-Villacoublay,23020,22836,184
11,78,217806421,78642,Verneuil-sur-Seine,16283,15959,324
11,78,217806439,78643,Vernouillet,10458,10266,192
11,78,217806447,78644,La Verrière,6296,6222,74
11,78,217806462,78646,Versailles,85474,83583,1891
11,78,217806470,78647,Vert,864,851,13
11,78,217806504,78650,Le Vésinet,16108,15619,489
11,78,217806538,78653,Vicq,375,366,9
11,78,217806553,78655,Vieille-Église-en-Yvelines,648,622,26
11,78,217806686,78668,La Villeneuve-en-Chevrie,677,658,19
11,78,217806728,78672,Villennes-sur-Seine,5648,5476,172
11,78,217806744,78674,Villepreux,11239,11044,195
11,78,217806777,78677,Villette,544,526,18
11,78,217806819,78681,Villiers-le-Mahieu,856,840,16
11,78,217806835,78683,Villiers-Saint-Frédéric,3055,2895,160
11,78,217806868,78686,Viroflay,17089,16744,345
11,78,217806884,78688,Voisins-le-Bretonneux,11118,10722,396
75,79,217900018,79001,L'Absie,1078,1062,16
75,79,217900026,79002,Adilly,319,310,9
75,79,217900034,79003,Aiffres,5523,5359,164
75,79,200085785,79005,Airvault,3328,3279,49
75,79,217900075,79007,Allonne,673,652,21
75,79,217900083,79008,Amailloux,835,822,13
75,79,217900091,79009,Amuré,443,434,9
75,79,217900109,79010,Arçais,615,609,6
75,79,217900125,79012,Ardin,1276,1245,31
75,79,200055994,79013,Argentonnay,3283,3197,86
75,79,200081321,79014,Loretz-d'Argenton,2657,2609,48
75,79,217900158,79015,Asnières-en-Poitou,197,192,5
75,79,217900166,79016,Assais-les-Jumeaux,780,770,10
75,79,217900182,79018,Aubigné,175,171,4
75,79,217900190,79019,Aubigny,164,163,1
75,79,217900208,79020,Augé,905,886,19
75,79,217900224,79022,Availles-Thouarsais,195,193,2
75,79,217900232,79023,Avon,62,61,1
75,79,217900240,79024,Azay-le-Brûlé,2089,1995,94
75,79,217900257,79025,Azay-sur-Thouet,1142,1113,29
75,79,217900299,79029,Beaulieu-sous-Parthenay,686,668,18
75,79,200035285,79030,Beaussais-Vitré,1023,968,55
75,79,217900315,79031,Beauvoir-sur-Niort,1809,1776,33
75,79,217900323,79032,Béceleuf,794,780,14
75,79,217900349,79034,Bessines,1828,1774,54
75,79,217900380,79038,Boismé,1206,1186,20
75,79,217900406,79040,La Boissière-en-Gâtine,235,233,2
75,79,217900422,79042,Bougon,182,176,6
75,79,217900463,79046,Le Bourdet,580,568,12
75,79,217900471,79047,Boussais,461,452,9
75,79,217900489,79048,La Crèche,5917,5782,135
75,79,217900497,79049,Bressuire,20846,19862,984
75,79,217900505,79050,Bretignolles,607,591,16
75,79,217900554,79055,Brieuil-sur-Chizé,127,124,3
75,79,217900562,79056,Brion-près-Thouet,751,740,11
75,79,217900570,79057,Brioux-sur-Boutonne,1493,1440,53
75,79,217900588,79058,Brûlain,792,775,17
75,79,217900596,79059,Le Busseau,742,733,9
75,79,217900604,79060,Caunay,180,177,3
75,79,200083897,79061,Celles-sur-Belle,3960,3881,79
75,79,217900620,79062,Cerizay,4874,4802,72
75,79,200068575,79063,Val en Vignes,2154,2035,119
75,79,200082162,79064,Fontivillié,842,823,19
75,79,217900661,79066,Champdeniers,1791,1753,38
75,79,217900695,79069,Chanteloup,1029,1003,26
75,79,217900703,79070,La Chapelle-Bâton,416,406,10
75,79,217900711,79071,La Chapelle-Bertrand,481,467,14
75,79,217900745,79074,La Chapelle-Pouilloux,182,176,6
75,79,217900760,79076,La Chapelle-Saint-Laurent,2075,2049,26
75,79,200085793,79077,Beugnon-Thireuil,743,733,10
75,79,200076198,79078,Plaine-d'Argenson,996,974,22
75,79,217900794,79079,Mauléon,8844,8623,221
75,79,217900802,79080,Châtillon-sur-Thouet,2724,2671,53
75,79,217900810,79081,Chauray,7362,7155,207
75,79,200082386,79083,Chef-Boutonne,2514,2407,107
75,79,217900844,79084,Chenay,453,447,6
75,79,217900851,79085,Chérigné,138,133,5
75,79,217900869,79086,Cherveux,1975,1929,46
75,79,217900877,79087,Chey,563,554,9
75,79,217900885,79088,Chiché,1732,1688,44
75,79,217900893,79089,Le Chillou,163,161,2
75,79,217900901,79090,Chizé,864,843,21
75,79,217900919,79091,Cirières,970,946,24
75,79,217900927,79092,Clavé,365,361,4
75,79,217900943,79094,Clessé,960,943,17
75,79,217900950,79095,Clussais-la-Pommeraie,596,584,12
75,79,217900968,79096,Combrand,1173,1139,34
75,79,217901008,79100,Coulon,2319,2266,53
75,79,217901016,79101,Coulonges-sur-l'Autize,2401,2349,52
75,79,217901024,79102,Coulonges-Thouarsais,446,437,9
75,79,217901032,79103,Courlay,2464,2416,48
75,79,217901040,79104,Cours,576,563,13
75,79,200084481,79105,Les Châteliers,478,465,13
75,79,217901065,79106,Couture-d'Argenson,407,405,2
75,79,217901081,79108,Doux,231,230,1
75,79,217901099,79109,Échiré,3632,3532,100
75,79,217901115,79111,Ensigné,293,289,4
75,79,217901123,79112,Épannes,879,857,22
75,79,217901149,79114,Exireuil,1601,1571,30
75,79,217901156,79115,Exoudun,568,558,10
75,79,217901164,79116,Faye-l'Abbesse,1136,1119,17
75,79,217901172,79117,Faye-sur-Ardin,664,656,8
75,79,217901180,79118,Fénery,289,283,6
75,79,217901198,79119,Fenioux,646,633,13
75,79,217901206,79120,La Ferrière-en-Parthenay,770,757,13
75,79,217901214,79121,Fomperron,409,399,10
75,79,217901222,79122,Fontenille-Saint-Martin-d'Entraigues,541,533,8
75,79,217901230,79123,La Forêt-sur-Sèvre,2332,2284,48
75,79,217901248,79124,Les Forges,114,109,5
75,79,217901255,79125,Fors,1878,1824,54
75,79,217901263,79126,Les Fosses,445,435,10
75,79,217901271,79127,La Foye-Monjault,863,847,16
75,79,217901289,79128,François,983,953,30
75,79,217901297,79129,Fressines,1782,1751,31
75,79,217901305,79130,Frontenay-Rohan-Rohan,2998,2924,74
75,79,217901313,79131,Geay,329,322,7
75,79,217901321,79132,Genneton,318,313,5
75,79,217901339,79133,Germond-Rouvre,1218,1194,24
75,79,217901347,79134,Glénay,584,570,14
75,79,217901354,79135,Gourgé,952,937,15
75,79,200064145,79136,Alloinay,924,907,17
75,79,217901370,79137,Granzay-Gript,920,902,18
75,79,217901396,79139,Les Groseillers,57,55,2
75,79,200081537,79140,Valdelaume,828,818,10
75,79,217901412,79141,Irais,211,207,4
75,79,217901420,79142,Juillé,102,100,2
75,79,217901446,79144,Juscorps,383,377,6
75,79,217901453,79145,Lageon,372,367,5
75,79,217901479,79147,Largeasse,740,731,9
75,79,217901487,79148,Lezay,2004,1977,27
75,79,217901495,79149,Lhoumois,139,137,2
75,79,217901503,79150,Limalonges,845,831,14
75,79,217901529,79152,Lorigné,308,303,5
75,79,217901537,79153,Loubigné,159,156,3
75,79,217901545,79154,Loubillé,393,386,7
75,79,217901560,79156,Louin,713,685,28
75,79,217901578,79157,Louzy,1339,1300,39
75,79,217901586,79158,Luché-sur-Brioux,130,127,3
75,79,217901594,79159,Luché-Thouarsais,532,528,4
75,79,217901602,79160,Lusseray,170,167,3
75,79,217901610,79161,Luzay,648,637,11
75,79,217901628,79162,Magné,2752,2689,63
75,79,217901636,79163,Mairé-Levescault,520,510,10
75,79,217901644,79164,Maisonnay,258,258,0
75,79,217901651,79165,Maisontiers,142,137,5
75,79,217901669,79166,Marigny,906,885,21
75,79,217901677,79167,Marnes,232,225,7
75,79,217901701,79170,Mauzé-sur-le-Mignon,2946,2893,53
75,79,217901727,79172,Mazières-en-Gâtine,1051,1029,22
75,79,200081511,79174,Melle,6319,6018,301
75,79,217901750,79175,Melleran,494,483,11
75,79,217901768,79176,Ménigoute,885,862,23
75,79,217901776,79177,Messé,197,193,4
75,79,200085264,79179,Moncoutant-sur-Sèvre,5251,5070,181
75,79,217901800,79180,Montalembert,314,311,3
75,79,217901834,79183,Montravers,379,369,10
75,79,217901842,79184,La Mothe-Saint-Héray,1688,1665,23
75,79,200084630,79185,Aigondigné,4832,4683,149
75,79,217901891,79189,Nanteuil,1732,1701,31
75,79,217901909,79190,Neuvy-Bouin,483,481,2
75,79,217901917,79191,Niort,60845,58966,1879
75,79,217920081,79195,Nueil-les-Aubiers,5658,5541,117
75,79,200084408,79196,Plaine-et-Vallées,2416,2367,49
75,79,217901974,79197,Oroux,99,95,4
75,79,217901982,79198,Paizay-le-Chapt,261,258,3
75,79,217902006,79200,Pamplie,270,267,3
75,79,217902014,79201,Pamproux,1701,1683,18
75,79,217902022,79202,Parthenay,10494,10108,386
75,79,217902030,79203,Pas-de-Jeu,367,359,8
75,79,217902048,79204,Périgné,1036,998,38
75,79,217902055,79205,Pers,77,74,3
75,79,217902071,79207,La Petite-Boissière,651,633,18
75,79,217902089,79208,La Peyratte,1148,1119,29
75,79,217902097,79209,Pierrefitte,340,332,8
75,79,217902105,79210,Le Pin,1067,1044,23
75,79,217902121,79212,Pliboux,211,208,3
75,79,217902139,79213,Pompaire,2060,2013,47
75,79,217902154,79215,Pougne-Hérisson,374,367,7
75,79,217902162,79216,Prahecq,2282,2242,40
75,79,200082527,79217,Prailles-La Couarde,973,951,22
75,79,217902188,79218,Pressigny,198,192,6
75,79,217902204,79220,Prin-Deyrançon,611,600,11
75,79,217902238,79223,Puihardy,64,62,2
75,79,217902253,79225,Reffannes,386,380,6
75,79,217902261,79226,Le Retail,278,273,5
75,79,217902295,79229,La Rochénard,552,538,14
75,79,217902303,79230,Rom,854,844,10
75,79,217902311,79231,Romans,725,710,15
75,79,217920073,79235,Saint-Amand-sur-Sèvre,1449,1408,41
75,79,217902360,79236,Saint-André-sur-Sèvre,662,647,15
75,79,217902386,79238,Saint-Aubin-du-Plain,562,547,15
75,79,217902394,79239,Saint-Aubin-le-Cloud,1824,1688,136
75,79,217902410,79241,Saint-Christophe-sur-Roc,582,571,11
75,79,200034320,79242,Voulmentin,1143,1123,20
75,79,217902436,79243,Saint-Coutant,282,282,0
75,79,217902444,79244,Saint-Cyr-la-Lande,375,371,4
75,79,217902469,79246,Sainte-Eanne,617,604,13
75,79,217902493,79249,Saint-Gelais,2212,2150,62
75,79,217902501,79250,Sainte-Gemme,409,405,4
75,79,200081719,79251,Marcillé,766,737,29
75,79,217902527,79252,Saint-Généroux,354,342,12
75,79,217902535,79253,Saint-Georges-de-Noisné,705,692,13
75,79,217902543,79254,Saint-Georges-de-Rex,453,445,8
75,79,217902550,79255,Saint-Germain-de-Longue-Chaume,405,402,3
75,79,217902568,79256,Saint-Germier,247,242,5
75,79,217902576,79257,Saint-Hilaire-la-Palud,1545,1523,22
75,79,217902584,79258,Saint-Jacques-de-Thouars,441,427,14
75,79,217902592,79259,Saint-Jean-de-Thouars,1386,1355,31
75,79,217902634,79263,Saint-Laurs,620,610,10
75,79,217902659,79265,Saint-Léger-de-Montbrun,1283,1260,23
75,79,217902675,79267,Saint-Lin,324,320,4
75,79,217902683,79268,Saint-Loup-Lamairé,1034,996,38
75,79,217902691,79269,Saint-Maixent-de-Beugné,424,419,5
75,79,217902709,79270,Saint-Maixent-l'École,7377,7243,134
75,79,217902717,79271,Saint-Marc-la-Lande,375,373,2
75,79,217902733,79273,Saint-Martin-de-Bernegoue,825,802,23
75,79,217902741,79274,Saint-Martin-de-Mâcon,305,301,4
75,79,217902766,79276,Saint-Martin-de-Saint-Maixent,1104,1072,32
75,79,217902774,79277,Saint-Martin-de-Sanzay,1086,1069,17
75,79,217902782,79278,Saint-Martin-du-Fouilloux,246,243,3
75,79,200054898,79280,Saint Maurice Étusson,896,881,15
75,79,217902816,79281,Saint-Maxire,1344,1308,36
75,79,217902832,79283,Sainte-Néomaye,1362,1331,31
75,79,217902840,79284,Sainte-Ouenne,787,777,10
75,79,200082873,79285,Saint-Pardoux-Soutiers,1896,1855,41
75,79,217902865,79286,Saint-Paul-en-Gâtine,472,459,13
75,79,217902899,79289,Saint-Pierre-des-Échaubrognes,1456,1428,28
75,79,217902907,79290,Saint-Pompain,973,948,25
75,79,217902931,79293,Saint-Rémy,1148,1115,33
75,79,217902949,79294,Saint-Romans-des-Champs,172,167,5
75,79,217902956,79295,Saint-Romans-lès-Melle,729,711,18
75,79,217902972,79297,Sainte-Soline,357,350,7
75,79,217902980,79298,Saint-Symphorien,2031,1975,56
75,79,217902998,79299,Saint-Varent,2444,2397,47
75,79,217903004,79300,Sainte-Verge,1415,1385,30
75,79,217903012,79301,Saint-Vincent-la-Châtre,639,620,19
75,79,217903020,79302,Saivres,1388,1355,33
75,79,217903038,79303,Salles,333,326,7
75,79,217903046,79304,Sansais,815,765,50
75,79,217903061,79306,Saurais,191,189,2
75,79,217903079,79307,Sauzé-Vaussais,1531,1505,26
75,79,217903087,79308,Sciecq,655,646,9
75,79,217903095,79309,Scillé,354,347,7
75,79,217903103,79310,Secondigné-sur-Belle,511,498,13
75,79,217903111,79311,Secondigny,1870,1790,80
75,79,217903129,79312,Séligné,120,117,3
75,79,217903137,79313,Sepvret,647,632,15
75,79,217903160,79316,Soudan,445,431,14
75,79,217903194,79319,Souvigné,890,862,28
75,79,217903202,79320,Surin,671,659,12
75,79,217903228,79322,Le Tallud,2048,1989,59
75,79,217903269,79326,Thénezay,1435,1408,27
75,79,200084267,79329,Thouars,14225,13917,308
75,79,217903319,79331,Tourtenay,133,127,6
75,79,217903327,79332,Trayes,126,122,4
75,79,200082642,79334,Val-du-Mignon,1098,1077,21
75,79,217903350,79335,Vallans,810,790,20
75,79,217903368,79336,Vançais,231,229,2
75,79,217903376,79337,Le Vanneau-Irleau,888,864,24
75,79,217903384,79338,Vanzay,258,258,0
75,79,217903392,79339,Vasles,1705,1676,29
75,79,217903400,79340,Vausseroux,328,322,6
75,79,217903418,79341,Vautebis,121,118,3
75,79,217903426,79342,Vernoux-en-Gâtine,586,573,13
75,79,217903434,79343,Vernoux-sur-Boutonne,211,209,2
75,79,217903459,79345,Verruyes,919,896,23
75,79,217903467,79346,Le Vert,130,125,5
75,79,217903475,79347,Viennay,1128,1107,21
75,79,217903483,79348,Villefollet,219,216,3
75,79,217903491,79349,Villemain,148,146,2
75,79,217903509,79350,Villiers-en-Bois,121,118,3
75,79,217903517,79351,Villiers-en-Plaine,1829,1798,31
75,79,217903525,79352,Villiers-sur-Chizé,161,155,6
75,79,217903541,79354,Vouhé,369,359,10
75,79,217903558,79355,Vouillé,3468,3369,99
75,79,217903574,79357,Xaintray,239,237,2
32,80,218000016,80001,Abbeville,23318,22895,423
32,80,218000024,80002,Ablaincourt-Pressoir,270,267,3
32,80,218000032,80003,Acheux-en-Amiénois,584,573,11
32,80,218000040,80004,Acheux-en-Vimeu,505,502,3
32,80,218000057,80005,Agenville,83,81,2
32,80,218000065,80006,Agenvillers,267,263,4
32,80,218000073,80008,Aigneville,913,899,14
32,80,218000081,80009,Ailly-le-Haut-Clocher,1026,1002,24
32,80,218000099,80010,Ailly-sur-Noye,2817,2778,39
32,80,218000107,80011,Ailly-sur-Somme,2940,2914,26
32,80,218000115,80013,Airaines,2361,2331,30
32,80,218000123,80014,Aizecourt-le-Bas,57,57,0
32,80,218000131,80015,Aizecourt-le-Haut,67,65,2
32,80,218000149,80016,Albert,9983,9814,169
32,80,218000156,80017,Allaines,435,430,5
32,80,218000164,80018,Allenay,254,249,5
32,80,218000172,80019,Allery,806,792,14
32,80,218000180,80020,Allonville,792,774,18
32,80,218000198,80021,Amiens,136808,134167,2641
32,80,218000206,80022,Andainville,270,267,3
32,80,218000214,80023,Andechy,287,283,4
32,80,218000222,80024,Argoeuves,552,546,6
32,80,218000230,80025,Argoules,332,329,3
32,80,218000248,80026,Arguel,31,30,1
32,80,218000255,80027,Armancourt,30,30,0
32,80,218000263,80028,Arquèves,154,153,1
32,80,218000271,80029,Arrest,851,828,23
32,80,218000289,80030,Arry,228,220,8
32,80,218000297,80031,Arvillers,782,773,9
32,80,218000305,80032,Assainvillers,116,114,2
32,80,218000313,80033,Assevillers,310,307,3
32,80,218000321,80034,Athies,603,596,7
32,80,218000339,80035,Aubercourt,77,77,0
32,80,218000347,80036,Aubigny,548,544,4
32,80,218000354,80037,Aubvillers,160,159,1
32,80,218000362,80038,Auchonvillers,137,136,1
32,80,218000370,80039,Ault,1399,1383,16
32,80,218000388,80040,Aumâtre,177,172,5
32,80,218000396,80041,Aumont,150,147,3
32,80,218000404,80042,Autheux,124,123,1
32,80,218000412,80043,Authie,276,265,11
32,80,218000420,80044,Authieule,412,406,6
32,80,218000438,80045,Authuille,163,161,2
32,80,218000446,80046,Avelesges,54,54,0
32,80,218000453,80047,Aveluy,533,528,5
32,80,218000461,80048,Avesnes-Chaussoy,67,64,3
32,80,218000479,80049,Ayencourt,161,155,6
32,80,218000487,80050,Bacouel-sur-Selle,487,477,10
32,80,218000495,80051,Bailleul,256,253,3
32,80,218000503,80052,Baizieux,225,222,3
32,80,218000511,80053,Balâtre,70,69,1
32,80,218000529,80054,Barleux,237,232,5
32,80,218000537,80055,Barly,165,164,1
32,80,218000545,80056,Bavelincourt,94,93,1
32,80,218000552,80057,Bayencourt,79,76,3
32,80,218000560,80058,Bayonvillers,334,330,4
32,80,218000578,80059,Bazentin,78,77,1
32,80,218000586,80060,Béalcourt,105,105,0
32,80,218000594,80061,Beaucamps-le-Jeune,186,183,3
32,80,218000602,80062,Beaucamps-le-Vieux,1470,1452,18
32,80,218000610,80063,Beauchamps,988,973,15
32,80,218000628,80064,Beaucourt-en-Santerre,171,168,3
32,80,218000636,80065,Beaucourt-sur-l'Ancre,91,88,3
32,80,218000644,80066,Beaucourt-sur-l'Hallue,278,272,6
32,80,218000651,80067,Beaufort-en-Santerre,193,191,2
32,80,218000669,80068,Beaumetz,221,220,1
32,80,218000677,80069,Beaumont-Hamel,204,204,0
32,80,218000685,80070,Beauquesne,1390,1337,53
32,80,218000693,80071,Beauval,2028,2007,21
32,80,218000701,80073,Bécordel-Bécourt,157,155,2
32,80,218000719,80074,Becquigny,130,129,1
32,80,218000727,80076,Béhen,527,524,3
32,80,218000735,80077,Béhencourt,320,317,3
32,80,218000743,80078,Bellancourt,528,517,11
32,80,218000750,80079,Belleuse,314,310,4
32,80,218000768,80080,Belloy-en-Santerre,153,148,5
32,80,218000776,80081,Belloy-Saint-Léonard,91,89,2
32,80,218000784,80082,Belloy-sur-Somme,744,735,9
32,80,218000792,80083,Bergicourt,142,138,4
32,80,218000800,80084,Bermesnil,213,209,4
32,80,218000818,80085,Bernâtre,39,37,2
32,80,218000826,80086,Bernaville,1069,1054,15
32,80,218000834,80087,Bernay-en-Ponthieu,246,240,6
32,80,218000842,80088,Bernes,357,355,2
32,80,218000859,80089,Berneuil,264,263,1
32,80,218000867,80090,Berny-en-Santerre,154,151,3
32,80,218000875,80092,Bertangles,754,747,7
32,80,218000883,80093,Berteaucourt-les-Dames,1084,1074,10
32,80,218000891,80094,Berteaucourt-lès-Thennes,465,458,7
32,80,218000909,80095,Bertrancourt,216,213,3
32,80,218000917,80096,Béthencourt-sur-Mer,944,927,17
32,80,218000925,80097,Béthencourt-sur-Somme,131,128,3
32,80,218000933,80098,Bettembos,110,107,3
32,80,218000941,80099,Bettencourt-Rivière,227,222,5
32,80,218000958,80100,Bettencourt-Saint-Ouen,623,619,4
32,80,218000966,80101,Beuvraignes,869,863,6
32,80,218000974,80102,Biaches,392,384,8
32,80,218000982,80103,Biarre,63,63,0
32,80,218000990,80104,Biencourt,140,137,3
32,80,218001006,80105,Billancourt,173,171,2
32,80,218001014,80106,Blangy-sous-Poix,176,173,3
32,80,218001022,80107,Blangy-Tronville,640,629,11
32,80,218001030,80108,Boisbergues,71,71,0
32,80,218001048,80109,Le Boisle,337,333,4
32,80,218001055,80110,Boismont,490,474,16
32,80,218001063,80112,Bonnay,242,241,1
32,80,218001071,80113,Bonneville,344,337,7
32,80,218001089,80114,Bosquel,347,341,6
32,80,218001097,80115,Bouchavesnes-Bergen,285,284,1
32,80,218001105,80116,Bouchoir,265,262,3
32,80,218001113,80117,Bouchon,164,159,5
32,80,218001121,80118,Boufflers,119,118,1
32,80,218001139,80119,Bougainville,417,409,8
32,80,218001162,80120,Bouillancourt-en-Séry,544,533,11
32,80,218001170,80121,Bouillancourt-la-Bataille,155,152,3
32,80,218001188,80122,Bouquemaison,493,490,3
32,80,218001147,80123,Bourdon,381,373,8
32,80,218001154,80124,Bourseville,722,708,14
32,80,218001196,80125,Boussicourt,86,86,0
32,80,218007839,80126,Bouttencourt,941,928,13
32,80,218001204,80127,Bouvaincourt-sur-Bresle,842,833,9
32,80,218001212,80128,Bouvincourt-en-Vermandois,147,144,3
32,80,218001220,80129,Bouzincourt,552,539,13
32,80,218001238,80130,Bovelles,428,422,6
32,80,218001246,80131,Boves,3386,3335,51
32,80,218001253,80132,Braches,219,216,3
32,80,218001261,80133,Brailly-Cornehotte,233,230,3
32,80,218001279,80134,Brassy,83,81,2
32,80,218001287,80135,Bray-lès-Mareuil,250,244,6
32,80,218001295,80136,Bray-sur-Somme,1258,1247,11
32,80,218001303,80137,Breilly,762,758,4
32,80,218001311,80138,Bresle,124,123,1
32,80,218001329,80139,Breuil,44,44,0
32,80,218001337,80140,Brévillers,112,110,2
32,80,218001345,80141,Brie,325,324,1
32,80,218001352,80142,Briquemesnil-Floxicourt,339,335,4
32,80,218001360,80143,Brocourt,104,103,1
32,80,218001378,80144,Brouchy,497,491,6
32,80,218001386,80145,Brucamps,140,139,1
32,80,218001394,80146,Brutelles,210,204,6
32,80,218001402,80147,Buigny-l'Abbé,340,333,7
32,80,218001410,80148,Buigny-lès-Gamaches,403,397,6
32,80,218001428,80149,Buigny-Saint-Maclou,538,527,11
32,80,218001436,80150,Buire-Courcelles,224,217,7
32,80,218001444,80151,Buire-sur-l'Ancre,308,304,4
32,80,218001451,80152,Bus-la-Mésière,148,147,1
32,80,218001469,80153,Bus-lès-Artois,133,133,0
32,80,218001477,80154,Bussu,221,214,7
32,80,218001485,80155,Bussus-Bussuel,302,297,5
32,80,218001493,80156,Bussy-lès-Daours,411,408,3
32,80,218001501,80157,Bussy-lès-Poix,99,94,5
32,80,218001519,80158,Buverchy,52,52,0
32,80,218001527,80159,Cachy,285,279,6
32,80,218001535,80160,Cagny,1228,1208,20
32,80,218001543,80161,Cahon,215,208,7
32,80,218001550,80162,Caix,715,701,14
32,80,218001568,80163,Cambron,786,774,12
32,80,218001576,80164,Camon,4494,4441,53
32,80,218001584,80165,Camps-en-Amiénois,190,187,3
32,80,218001592,80166,Canaples,707,703,4
32,80,218001600,80167,Canchy,345,334,11
32,80,218001618,80168,Candas,1103,1086,17
32,80,218001626,80169,Cannessières,64,64,0
32,80,218001634,80170,Cantigny,111,110,1
32,80,218001642,80171,Caours,619,598,21
32,80,218001659,80172,Cappy,553,548,5
32,80,218001667,80173,Cardonnette,537,530,7
32,80,218001675,80174,Le Cardonnois,79,76,3
32,80,218001691,80176,Carrépuis,271,267,4
32,80,218001709,80177,Cartigny,726,704,22
32,80,218001717,80179,Caulières,226,222,4
32,80,218001725,80180,Cavillon,102,100,2
32,80,218001733,80181,Cayeux-en-Santerre,122,122,0
32,80,218001741,80182,Cayeux-sur-Mer,2443,2411,32
32,80,218001758,80183,Cerisy-Buleux,272,267,5
32,80,218001766,80184,Cerisy,540,535,5
32,80,218001774,80185,Champien,295,285,10
32,80,218001782,80186,Chaulnes,2024,1997,27
32,80,218001790,80187,La Chaussée-Tirancourt,674,664,10
32,80,218001808,80188,Chaussoy-Epagny,596,589,7
32,80,218001816,80189,La Chavatte,73,72,1
32,80,218001824,80190,Chépy,1249,1231,18
32,80,218001832,80191,Chilly,175,170,5
32,80,218001840,80192,Chipilly,168,166,2
32,80,218001857,80193,Chirmont,148,145,3
32,80,218001865,80194,Chuignes,143,142,1
32,80,218001873,80195,Chuignolles,150,148,2
32,80,218001881,80196,Citerne,255,247,8
32,80,218001899,80197,Cizancourt,29,29,0
32,80,218001907,80198,Clairy-Saulchoix,382,379,3
32,80,218001915,80199,Cléry-sur-Somme,533,523,10
32,80,218001923,80200,Cocquerel,221,219,2
32,80,218001931,80201,Coigneux,51,49,2
32,80,218001949,80202,Coisy,381,378,3
32,80,218001956,80203,Colincamps,89,87,2
32,80,218001964,80204,Combles,750,739,11
32,80,218001972,80205,Condé-Folie,911,900,11
32,80,218001980,80206,Contalmaison,120,118,2
32,80,218001998,80207,Contay,350,346,4
32,80,218002004,80208,Conteville,225,222,3
32,80,218002020,80210,Contre,151,144,7
32,80,218002038,80211,Conty,1865,1815,50
32,80,218002046,80212,Corbie,6356,6276,80
32,80,218002053,80213,Cottenchy,744,573,171
32,80,218002061,80214,Coullemelle,315,314,1
32,80,218002079,80215,Coulonvillers,224,216,8
32,80,218002087,80216,Courcelette,156,154,2
32,80,218002095,80217,Courcelles-au-Bois,72,72,0
32,80,218002103,80218,Courcelles-sous-Moyencourt,150,147,3
32,80,218002111,80219,Courcelles-sous-Thoix,68,67,1
32,80,218002129,80220,Courtemanche,102,99,3
32,80,218002137,80221,Cramont,308,303,5
32,80,218002145,80222,Crécy-en-Ponthieu,1392,1366,26
32,80,218002152,80223,Crémery,137,137,0
32,80,218002160,80224,Cressy-Omencourt,125,124,1
32,80,218002178,80225,Creuse,197,193,4
32,80,218002186,80226,Croix-Moligneaux,274,269,5
32,80,218002194,80227,Croixrault,459,449,10
32,80,218002202,80228,Le Crotoy,2014,1979,35
32,80,218002210,80229,Crouy-Saint-Pierre,354,351,3
32,80,218002228,80230,Curchy,311,303,8
32,80,218002236,80231,Curlu,175,173,2
32,80,218002244,80232,Damery,238,233,5
32,80,218002251,80233,Dancourt-Popincourt,157,154,3
32,80,218002269,80234,Daours,788,773,15
32,80,218002277,80235,Dargnies,1203,1184,19
32,80,218002285,80236,Davenescourt,571,566,5
32,80,218002293,80237,Démuin,535,525,10
32,80,218002301,80238,Dernancourt,561,549,12
32,80,218002319,80239,Devise,57,55,2
32,80,218002327,80240,Doingt,1431,1388,43
32,80,218002335,80241,Domart-en-Ponthieu,1070,1059,11
32,80,218002343,80242,Domart-sur-la-Luce,416,407,9
32,80,218002350,80243,Domesmont,43,43,0
32,80,218002368,80244,Dominois,176,173,3
32,80,218002376,80245,Domléger-Longvillers,306,303,3
32,80,218002384,80246,Dommartin,351,346,5
32,80,218002392,80247,Dompierre-Becquincourt,724,718,6
32,80,218002400,80248,Dompierre-sur-Authie,434,427,7
32,80,218002418,80249,Domqueur,319,310,9
32,80,218002426,80250,Domvast,352,348,4
32,80,218002434,80251,Doudelainville,367,359,8
32,80,218002442,80252,Douilly,252,251,1
32,80,218002459,80253,Doullens,6042,5870,172
32,80,218002467,80256,Dreuil-lès-Amiens,1629,1620,9
32,80,218002475,80258,Driencourt,88,85,3
32,80,218002483,80259,Dromesnil,87,86,1
32,80,218002491,80260,Drucat,955,931,24
32,80,218002509,80261,Dury,1510,1452,58
32,80,218002517,80262,Eaucourt-sur-Somme,389,376,13
32,80,218002525,80263,L'Échelle-Saint-Aurin,50,48,2
32,80,218002533,80264,Éclusier-Vaux,118,85,33
32,80,218002541,80265,Embreville,570,563,7
32,80,218002558,80266,Englebelmer,311,311,0
32,80,218002566,80267,Ennemain,274,269,5
32,80,218002574,80268,Épagne-Épagnette,539,525,14
32,80,218002582,80269,Épaumesnil,114,112,2
32,80,218002590,80270,Épécamps,6,6,0
32,80,218002608,80271,Épehy,1140,1125,15
32,80,218002616,80272,Épénancourt,126,124,2
32,80,218002624,80273,Éplessier,352,347,5
32,80,218002632,80274,Eppeville,1791,1766,25
32,80,218002640,80275,Équancourt,299,297,2
32,80,218002657,80276,Équennes-Éramecourt,294,287,7
32,80,218002665,80278,Erches,191,189,2
32,80,218002673,80279,Ercheu,771,761,10
32,80,218002681,80280,Ercourt,124,122,2
32,80,218002699,80281,Ergnies,175,173,2
32,80,218002707,80282,Érondelle,517,513,4
32,80,218002715,80283,Esclainvillers,164,164,0
32,80,218002723,80284,Esmery-Hallon,763,730,33
32,80,218002731,80285,Essertaux,264,261,3
32,80,218002749,80287,Estréboeuf,243,239,4
32,80,218002756,80288,Estrées-Deniécourt,345,344,1
32,80,218002764,80290,Estrées-lès-Crécy,397,391,6
32,80,218002780,80291,Estrées-sur-Noye,271,268,3
32,80,218002798,80292,Étalon,139,133,6
32,80,218002806,80293,Ételfay,357,354,3
32,80,218002814,80294,Éterpigny,165,162,3
32,80,200064830,80295,Étinehem-Méricourt,603,593,10
32,80,218002830,80296,L'Étoile,1186,1175,11
32,80,218002848,80297,Étréjust,41,40,1
32,80,218002855,80298,Étricourt-Manancourt,531,528,3
32,80,218002863,80299,La Faloise,239,238,1
32,80,218002871,80300,Falvy,159,159,0
32,80,218002889,80301,Famechon,280,278,2
32,80,218002897,80302,Faverolles,174,171,3
32,80,218002905,80303,Favières,463,457,6
32,80,218002913,80304,Fay,100,98,2
32,80,218002921,80305,Ferrières,483,472,11
32,80,218002939,80306,Fescamps,135,130,5
32,80,218002947,80307,Feuillères,158,156,2
32,80,218002954,80308,Feuquières-en-Vimeu,2509,2466,43
32,80,218002962,80310,Fienvillers,681,678,3
32,80,218002988,80311,Fignières,154,150,4
32,80,218002996,80312,Fins,281,280,1
32,80,218003002,80313,Flaucourt,296,291,5
32,80,218003010,80314,Flers,204,201,3
32,80,218003028,80315,Flers-sur-Noye,517,507,10
32,80,218003036,80316,Flesselles,2017,1993,24
32,80,218003044,80317,Fleury,212,209,3
32,80,218003051,80318,Flixecourt,3324,3249,75
32,80,218003069,80319,Fluy,338,333,5
32,80,218003077,80320,Folies,158,157,1
32,80,218003085,80321,Folleville,143,141,2
32,80,218003093,80322,Fonches-Fonchette,171,171,0
32,80,218003101,80324,Fontaine-le-Sec,144,140,4
32,80,218003119,80325,Fontaine-lès-Cappy,53,52,1
32,80,218003127,80326,Fontaine-sous-Montdidier,107,105,2
32,80,218003135,80327,Fontaine-sur-Maye,162,158,4
32,80,218003143,80328,Fontaine-sur-Somme,525,518,7
32,80,218003150,80329,Forceville,176,174,2
32,80,218003168,80330,Forceville-en-Vimeu,242,237,5
32,80,218003176,80331,Forest-l'Abbaye,324,311,13
32,80,218003184,80332,Forest-Montiers,403,395,8
32,80,218003192,80333,Fort-Mahon-Plage,1311,1297,14
32,80,218003200,80334,Fossemanant,101,98,3
32,80,218003218,80335,Foucaucourt-en-Santerre,243,240,3
32,80,218003226,80336,Foucaucourt-Hors-Nesle,83,80,3
32,80,218003234,80337,Fouencamps,204,201,3
32,80,218003242,80338,Fouilloy,1832,1815,17
32,80,218003259,80339,Fouquescourt,156,152,4
32,80,218003267,80340,Fourcigny,202,200,2
32,80,218003275,80341,Fourdrinoy,400,393,7
32,80,218003283,80342,Framerville-Rainecourt,463,455,8
32,80,218003291,80343,Framicourt,169,167,2
32,80,218003309,80344,Francières,186,178,8
32,80,218003317,80345,Franleu,523,519,4
32,80,218003325,80346,Franqueville,165,164,1
32,80,218003333,80347,Fransart,161,159,2
32,80,218003341,80348,Fransu,187,183,4
32,80,218003358,80349,Fransures,134,132,2
32,80,218003366,80350,Franvillers,526,522,4
32,80,218003374,80351,Fréchencourt,261,259,2
32,80,218003382,80352,Frémontiers,161,160,1
32,80,218003390,80353,Fresnes-Mazancourt,158,157,1
32,80,218003408,80354,Fresnes-Tilloloy,207,204,3
32,80,218003416,80355,Fresneville,103,101,2
32,80,218003424,80356,Fresnoy-Andainville,101,92,9
32,80,218003432,80357,Fresnoy-au-Val,236,230,6
32,80,218003440,80358,Fresnoy-en-Chaussée,140,138,2
32,80,218003457,80359,Fresnoy-lès-Roye,293,284,9
32,80,218003465,80360,Fressenneville,2207,2168,39
32,80,218003473,80361,Frettecuisse,77,73,4
32,80,218003481,80362,Frettemeule,307,300,7
32,80,218003499,80364,Friaucourt,709,697,12
32,80,218003507,80365,Fricamps,186,183,3
32,80,218003515,80366,Fricourt,496,492,4
32,80,218003523,80367,Frise,183,178,5
32,80,218003531,80368,Friville-Escarbotin,4589,4492,97
32,80,200007102,80369,Frohen-sur-Authie,244,237,7
32,80,218003564,80371,Froyelles,98,94,4
32,80,218003572,80372,Frucourt,125,122,3
32,80,218003580,80373,Gamaches,2540,2461,79
32,80,218003598,80374,Gapennes,281,278,3
32,80,218003606,80375,Gauville,346,339,7
32,80,218003614,80376,Gentelles,652,646,6
32,80,218003622,80377,Gézaincourt,404,399,5
32,80,218003630,80378,Ginchy,69,68,1
32,80,218003648,80379,Glisy,839,838,1
32,80,218003655,80380,Gorenflos,243,238,5
32,80,218003663,80381,Gorges,39,38,1
32,80,218003671,80383,Goyencourt,93,93,0
32,80,218003689,80384,Grandcourt,178,177,1
32,80,218003697,80385,Grand-Laviers,480,465,15
32,80,218003705,80386,Gratibus,181,178,3
32,80,218003713,80387,Grattepanche,328,323,5
32,80,218003721,80388,Grébault-Mesnil,212,210,2
32,80,218003747,80390,Grivesnes,414,411,3
32,80,218003754,80391,Grivillers,90,90,0
32,80,218003762,80392,Grouches-Luchuel,586,572,14
32,80,218003770,80393,Gruny,317,311,6
32,80,218003788,80395,Guerbigny,280,275,5
32,80,218003796,80396,Gueschart,374,371,3
32,80,218003804,80397,Gueudecourt,96,92,4
32,80,218003812,80399,Guignemicourt,406,403,3
32,80,218003820,80400,Guillaucourt,405,400,5
32,80,218003838,80401,Guillemont,127,126,1
32,80,218003846,80402,Guizancourt,139,138,1
32,80,218003853,80403,Guyencourt-sur-Noye,177,176,1
32,80,218003861,80404,Guyencourt-Saulcourt,145,142,3
32,80,218003879,80405,Hailles,424,421,3
32,80,218003887,80406,Hallencourt,1310,1295,15
32,80,218003895,80407,Hallivillers,145,139,6
32,80,218003903,80408,Halloy-lès-Pernois,331,330,1
32,80,218003911,80409,Hallu,152,148,4
32,80,218003929,80410,Ham,4595,4510,85
32,80,218003937,80411,Le Hamel,494,488,6
32,80,218003945,80412,Hamelet,644,638,6
32,80,218003952,80413,Hancourt,90,89,1
32,80,218003960,80414,Hangard,125,122,3
32,80,218003978,80415,Hangest-en-Santerre,1018,1010,8
32,80,218003986,80416,Hangest-sur-Somme,777,768,9
32,80,218003994,80417,Harbonnières,1654,1642,12
32,80,218004000,80418,Hardecourt-aux-Bois,85,85,0
32,80,218004026,80420,Harponville,176,175,1
32,80,218004034,80421,Hattencourt,300,296,4
32,80,218004042,80422,Hautvillers-Ouville,584,574,10
32,80,218004059,80423,Havernas,382,377,5
32,80,218004067,80424,Hébécourt,558,540,18
32,80,218004075,80425,Hédauville,112,111,1
32,80,218004083,80426,Heilly,444,436,8
32,80,218004091,80427,Hem-Hardinval,386,379,7
32,80,218004109,80428,Hem-Monacu,134,132,2
32,80,218004117,80429,Hénencourt,194,193,1
32,80,218004125,80430,Herbécourt,198,191,7
32,80,218004133,80431,Hérissart,726,717,9
32,80,218004141,80432,Herleville,194,193,1
32,80,218004158,80433,Herly,43,43,0
32,80,218004166,80434,Hervilly,196,192,4
32,80,218004174,80435,Hesbécourt,57,57,0
32,80,218004182,80436,Hescamps,538,525,13
32,80,218004190,80437,Heucourt-Croquoison,113,109,4
32,80,218004208,80438,Heudicourt,514,508,6
32,80,218004216,80439,Heuzecourt,164,163,1
32,80,218004224,80440,Hiermont,155,152,3
32,80,200085850,80442,Hombleux,1169,1158,11
32,80,218004240,80443,Hornoy-le-Bourg,1705,1679,26
32,80,218004257,80444,Huchenneville,682,668,14
32,80,218004265,80445,Humbercourt,269,266,3
32,80,218004273,80446,Huppy,763,745,18
32,80,218004299,80449,Ignaucourt,67,65,2
32,80,218004307,80450,Inval-Boiron,115,113,2
32,80,218004315,80451,Irles,126,126,0
32,80,218004323,80452,Jumel,529,526,3
32,80,218004331,80453,Laboissière-en-Santerre,140,140,0
32,80,218004349,80455,Lachapelle,94,92,2
32,80,218004356,80456,Lafresguimont-Saint-Martin,565,555,10
32,80,218004364,80458,Lahoussoye,460,450,10
32,80,218004372,80459,Laleu,104,104,0
32,80,218004380,80460,Lamaronde,67,66,1
32,80,218004398,80461,Lamotte-Brebière,216,212,4
32,80,218004406,80462,Lamotte-Buleux,359,348,11
32,80,218004414,80463,Lamotte-Warfusée,716,706,10
32,80,218004422,80464,Lanchères,934,920,14
32,80,218004430,80465,Languevoisin-Quiquery,198,194,4
32,80,218004448,80466,Lanches-Saint-Hilaire,135,132,3
32,80,218004455,80467,Laucourt,191,190,1
32,80,218004463,80468,Laviéville,172,169,3
32,80,218004471,80469,Lawarde-Mauger-l'Hortoy,161,160,1
32,80,218004489,80470,Léalvillers,165,163,2
32,80,218004497,80472,Lesboeufs,173,168,5
32,80,218004505,80473,Liancourt-Fosse,294,292,2
32,80,218004513,80474,Licourt,404,401,3
32,80,218004521,80475,Liéramont,222,215,7
32,80,218004539,80476,Liercourt,363,359,4
32,80,218004547,80477,Ligescourt,224,221,3
32,80,218004554,80478,Lignières,147,145,2
32,80,218004562,80479,Lignières-Châtelain,348,343,5
32,80,218004570,80480,Lignières-en-Vimeu,115,113,2
32,80,218004588,80481,Lihons,461,456,5
32,80,218004596,80482,Limeux,142,140,2
32,80,218004604,80484,Liomer,392,387,5
32,80,200085736,80485,Ô-de-Selle,1178,1168,10
32,80,218004620,80486,Long,625,618,7
32,80,218004638,80487,Longavesnes,79,77,2
32,80,218004646,80488,Longpré-les-Corps-Saints,1578,1550,28
32,80,218004653,80489,Longueau,5859,5815,44
32,80,218004661,80490,Longueval,281,272,9
32,80,218004679,80491,Longuevillette,76,75,1
32,80,218004687,80493,Louvencourt,302,297,5
32,80,218004695,80494,Louvrechy,202,199,3
32,80,218004703,80495,Lucheux,519,515,4
32,80,218004711,80496,Machiel,153,152,1
32,80,218004729,80497,Machy,123,118,5
32,80,218004737,80498,Mailly-Maillet,648,643,5
32,80,218004745,80499,Mailly-Raineval,308,302,6
32,80,218004752,80500,Maisnières,521,513,8
32,80,218004760,80501,Maison-Ponthieu,288,284,4
32,80,218004778,80502,Maison-Roland,102,100,2
32,80,218004786,80503,Maizicourt,188,186,2
32,80,218004794,80504,Malpart,76,76,0
32,80,200084119,80505,Carnoy-Mametz,297,293,4
32,80,218004810,80507,Marcelcave,1294,1275,19
32,80,218004828,80508,Marché-Allouarde,49,49,0
32,80,200082915,80509,Marchélepot-Misery,598,592,6
32,80,218004844,80511,Marestmontiers,111,110,1
32,80,218004851,80512,Mareuil-Caubert,842,832,10
32,80,218004869,80513,Maricourt,181,178,3
32,80,218004877,80514,Marieux,133,132,1
32,80,218004885,80515,Marlers,148,146,2
32,80,218004893,80516,Marquaix,192,191,1
32,80,218004901,80517,Marquivillers,197,194,3
32,80,218004919,80518,Martainneville,430,427,3
32,80,218004927,80519,Matigny,502,495,7
32,80,218004935,80520,Maucourt,191,188,3
32,80,218004943,80521,Maurepas,215,215,0
32,80,218004950,80522,Le Mazis,109,107,2
32,80,218004968,80523,Méaulte,1284,1262,22
32,80,218004976,80524,Méharicourt,583,576,7
32,80,218004984,80525,Meigneux,182,179,3
32,80,218004992,80526,Le Meillard,156,153,3
32,80,218005007,80527,Méneslies,310,302,8
32,80,218005015,80528,Méréaucourt,9,9,0
32,80,218005023,80529,Mérélessart,196,192,4
32,80,218005031,80530,Méricourt-l'Abbé,608,604,4
32,80,218005049,80531,Méricourt-en-Vimeu,102,102,0
32,80,218005064,80533,Mers-les-Bains,2632,2573,59
32,80,218005072,80535,Le Mesge,158,153,5
32,80,218005080,80536,Mesnil-Bruntel,290,287,3
32,80,218005098,80537,Mesnil-Domqueur,88,88,0
32,80,218005106,80538,Mesnil-en-Arrouaise,119,117,2
32,80,218005114,80540,Mesnil-Martinsart,238,234,4
32,80,218005122,80541,Mesnil-Saint-Georges,203,200,3
32,80,218005130,80542,Mesnil-Saint-Nicaise,562,556,6
32,80,218005148,80543,Métigny,120,117,3
32,80,218005155,80544,Mézerolles,186,183,3
32,80,218005163,80545,Mézières-en-Santerre,547,540,7
32,80,218005171,80546,Miannay,605,594,11
32,80,218005189,80547,Millencourt,210,206,4
32,80,218005197,80548,Millencourt-en-Ponthieu,354,352,2
32,80,218005205,80549,Miraumont,664,649,15
32,80,218005213,80550,Mirvaux,131,127,4
32,80,218005239,80552,Moislains,1151,1129,22
32,80,218005247,80553,Molliens-au-Bois,342,333,9
32,80,218005254,80554,Molliens-Dreuil,973,961,12
32,80,218005262,80555,Monchy-Lagache,612,593,19
32,80,218007847,80556,Mons-Boubert,574,561,13
32,80,218005270,80557,Estrées-Mons,599,588,11
32,80,218005288,80558,Monsures,222,219,3
32,80,218005296,80559,Montagne-Fayel,145,142,3
32,80,218005304,80560,Montauban-de-Picardie,215,214,1
32,80,218005312,80561,Montdidier,6152,6051,101
32,80,218005320,80562,Montigny-sur-l'Hallue,208,206,2
32,80,218005338,80563,Montigny-les-Jongleurs,99,98,1
32,80,218005346,80565,Montonvillers,85,83,2
32,80,218005528,80566,Fieffes-Montrelet,347,340,7
32,80,218005353,80568,Morchain,349,345,4
32,80,218005361,80569,Morcourt,331,328,3
32,80,218005379,80570,Moreuil,4022,3996,26
32,80,218005387,80571,Morisel,496,486,10
32,80,218005395,80572,Morlancourt,371,369,2
32,80,218005403,80573,Morvillers-Saint-Saturnin,398,389,9
32,80,218005411,80574,Mouflers,96,95,1
32,80,218005429,80575,Mouflières,86,78,8
32,80,218005437,80576,Moyencourt,323,323,0
32,80,218005445,80577,Moyencourt-lès-Poix,179,177,2
32,80,218005452,80578,Moyenneville,728,718,10
32,80,218005460,80579,Muille-Villette,841,831,10
32,80,218005478,80580,Nampont,257,255,2
32,80,218005486,80582,Namps-Maisnil,1024,1010,14
32,80,218005494,80583,Nampty,296,289,7
32,80,218005502,80584,Naours,1082,1072,10
32,80,218005510,80585,Nesle,2344,2314,30
32,80,218005536,80586,Nesle-l'Hôpital,162,162,0
32,80,218005544,80587,Neslette,86,83,3
32,80,218005551,80588,Neufmoulin,367,359,8
32,80,218005569,80589,Neuilly-le-Dien,100,100,0
32,80,218005577,80590,Neuilly-l'Hôpital,334,322,12
32,80,218005585,80591,Neuville-au-Bois,151,149,2
32,80,218005593,80592,Neuville-Coppegueule,516,509,7
32,80,218005601,80593,La Neuville-lès-Bray,256,253,3
32,80,218005627,80595,La Neuville-Sire-Bernard,312,311,1
32,80,218005635,80596,Neuvillette,227,218,9
32,80,218005643,80597,Nibas,864,844,20
32,80,218005650,80598,Nouvion,1269,1231,38
32,80,218005668,80599,Noyelles-en-Chaussée,244,242,2
32,80,218005676,80600,Noyelles-sur-Mer,672,663,9
32,80,218005684,80601,Nurlu,369,365,4
32,80,218005692,80602,Occoches,133,130,3
32,80,218005700,80603,Ochancourt,333,329,4
32,80,218005718,80604,Offignies,86,83,3
32,80,218005726,80605,Offoy,206,204,2
32,80,218005734,80606,Oisemont,1183,1137,46
32,80,218005742,80607,Oissy,214,209,5
32,80,218005767,80609,Oneux,430,424,6
32,80,218005775,80611,Oresmaux,956,942,14
32,80,218005783,80613,Oust-Marest,634,618,16
32,80,218005791,80614,Outrebois,321,315,6
32,80,218005809,80615,Ovillers-la-Boisselle,436,433,3
32,80,218005817,80616,Pargny,197,196,1
32,80,218005825,80617,Parvillers-le-Quesnoy,236,233,3
32,80,218005833,80618,Pendé,1063,1049,14
32,80,218005841,80619,Pernois,732,724,8
32,80,218005858,80620,Péronne,7628,7444,184
32,80,200062602,80621,Hypercourt,726,715,11
32,80,218005874,80622,Picquigny,1311,1297,14
32,80,218005882,80623,Piennes-Onvillers,380,373,7
32,80,218005890,80624,Pierregot,290,285,5
32,80,200084671,80625,Trois-Rivières,1522,1505,17
32,80,218005916,80626,Pissy,293,291,2
32,80,218005924,80627,Plachy-Buyon,836,816,20
32,80,218005932,80628,Le Plessier-Rozainvillers,791,788,3
32,80,218005940,80629,Poeuilly,109,107,2
32,80,218005957,80630,Poix-de-Picardie,2370,2332,38
32,80,218005965,80631,Ponches-Estruval,101,98,3
32,80,218005973,80632,Pont-de-Metz,2411,2375,36
32,80,218005981,80633,Ponthoile,615,606,9
32,80,218005999,80634,Pont-Noyelles,831,814,17
32,80,218006005,80635,Pont-Remy,1478,1460,18
32,80,218006013,80637,Port-le-Grand,290,286,4
32,80,218006021,80638,Potte,116,110,6
32,80,218006039,80639,Poulainville,1312,1290,22
32,80,218007854,80640,Pozières,265,265,0
32,80,218006047,80642,Prouville,330,328,2
32,80,218006054,80643,Prouzel,568,562,6
32,80,218006062,80644,Proyart,743,739,4
32,80,218006070,80645,Puchevillers,559,556,3
32,80,218006088,80646,Punchy,84,83,1
32,80,218006096,80647,Puzeaux,292,289,3
32,80,218006104,80648,Pys,123,123,0
32,80,218006112,80649,Quend,1299,1272,27
32,80,218006120,80650,Querrieu,645,629,16
32,80,218006138,80651,Le Quesne,266,263,3
32,80,218006146,80652,Le Quesnel,787,778,9
32,80,218006153,80654,Quesnoy-le-Montant,553,535,18
32,80,218006161,80655,Quesnoy-sur-Airaines,428,421,7
32,80,218006179,80656,Quevauvillers,1111,1103,8
32,80,218006187,80657,Quiry-le-Sec,319,317,2
32,80,218006195,80658,Quivières,146,143,3
32,80,218006203,80659,Raincheval,277,271,6
32,80,218006211,80661,Rainneville,1047,1035,12
32,80,218006229,80662,Ramburelles,283,276,7
32,80,218006237,80663,Rambures,359,352,7
32,80,218006245,80664,Rancourt,194,191,3
32,80,218006252,80665,Regnière-Écluse,125,122,3
32,80,218006260,80666,Remaisnil,31,31,0
32,80,218006278,80667,Remaugies,135,133,2
32,80,218006286,80668,Remiencourt,173,170,3
32,80,218006294,80669,Rethonvillers,349,343,6
32,80,218006302,80670,Revelles,501,493,8
32,80,218006310,80671,Ribeaucourt,238,231,7
32,80,218006328,80672,Ribemont-sur-Ancre,644,633,11
32,80,218006336,80673,Riencourt,180,178,2
32,80,218006344,80674,Rivery,3656,3623,33
32,80,218006351,80675,Rogy,136,132,4
32,80,218006369,80676,Roiglise,160,153,7
32,80,218006377,80677,Roisel,1593,1575,18
32,80,218006385,80678,Rollot,787,768,19
32,80,218006393,80679,Ronssoy,591,586,5
32,80,218006401,80680,Rosières-en-Santerre,3031,3005,26
32,80,218006419,80681,Rouvrel,318,310,8
32,80,218006427,80682,Rouvroy-en-Santerre,219,213,6
32,80,218006435,80683,Rouy-le-Grand,102,102,0
32,80,218006443,80684,Rouy-le-Petit,112,108,4
32,80,218006450,80685,Roye,5758,5703,55
32,80,218006468,80686,Rubempré,738,729,9
32,80,218006476,80687,Rubescourt,135,133,2
32,80,218006484,80688,Rue,3205,3115,90
32,80,218006492,80690,Rumigny,652,644,8
32,80,218006500,80691,Saigneville,359,347,12
32,80,218006518,80692,Sailly-Flibeaucourt,1041,1024,17
32,80,218006526,80693,Sailly-Laurette,330,329,1
32,80,218006534,80694,Sailly-le-Sec,355,350,5
32,80,218006542,80695,Sailly-Saillisel,490,484,6
32,80,218006559,80696,Sains-en-Amiénois,1245,1213,32
32,80,218006567,80697,Saint-Acheul,34,34,0
32,80,218006575,80698,Saint-Aubin-Montenoy,222,218,4
32,80,218006583,80699,Saint-Aubin-Rivière,115,113,2
32,80,218006591,80700,Saint-Blimont,894,878,16
32,80,218006609,80701,Saint-Christ-Briost,439,429,10
32,80,218006617,80702,Saint-Fuscien,1383,1355,28
32,80,218006625,80703,Saint-Germain-sur-Bresle,215,210,5
32,80,218006633,80704,Saint-Gratien,388,383,5
32,80,218006641,80705,Saint-Léger-lès-Authie,80,79,1
32,80,218006658,80706,Saint-Léger-lès-Domart,1855,1840,15
32,80,218006666,80707,Saint-Léger-sur-Bresle,80,77,3
32,80,218006674,80708,Saint-Mard,157,156,1
32,80,218006682,80709,Saint-Maulvis,279,272,7
32,80,218006690,80710,Saint-Maxent,401,395,6
32,80,218006708,80711,Saint-Ouen,1802,1788,14
32,80,218006716,80713,Saint-Quentin-en-Tourmont,286,281,5
32,80,218006724,80714,Saint-Quentin-la-Motte-Croix-au-Bailly,1308,1275,33
32,80,218006732,80716,Saint-Riquier,1291,1260,31
32,80,218006740,80717,Saint-Sauflieu,993,987,6
32,80,218006757,80718,Saint-Sauveur,1337,1321,16
32,80,218006765,80719,Sainte-Segrée,56,51,5
32,80,218006773,80721,Saint-Valery-sur-Somme,2474,2435,39
32,80,218006781,80722,Saint-Vaast-en-Chaussée,492,485,7
32,80,218006799,80723,Saisseval,248,244,4
32,80,218006807,80724,Saleux,2816,2787,29
32,80,218006815,80725,Salouël,4066,4011,55
32,80,218006823,80726,Sancourt,269,265,4
32,80,218006831,80728,Saulchoy-sous-Poix,76,76,0
32,80,218006849,80729,Sauvillers-Mongival,182,182,0
32,80,218006856,80730,Saveuse,1076,1067,9
32,80,218006864,80732,Senarpont,642,627,15
32,80,218006872,80733,Senlis-le-Sec,316,313,3
32,80,218006880,80734,Sentelie,211,208,3
32,80,218006898,80735,Seux,169,167,2
32,80,218006906,80736,Sorel-en-Vimeu,222,217,5
32,80,218006914,80737,Sorel,162,161,1
32,80,218006922,80738,Soues,129,126,3
32,80,218006930,80740,Sourdon,351,349,2
32,80,218006948,80741,Soyécourt,195,191,4
32,80,218006955,80742,Surcamps,71,69,2
32,80,218006963,80743,Suzanne,197,193,4
32,80,218006971,80744,Tailly,58,56,2
32,80,218006989,80746,Talmas,1096,1074,22
32,80,218006997,80747,Templeux-la-Fosse,138,135,3
32,80,218007003,80748,Templeux-le-Guérard,195,192,3
32,80,218007011,80749,Terramesnil,325,321,4
32,80,218007029,80750,Tertry,146,145,1
32,80,218007037,80751,Thennes,588,582,6
32,80,218007045,80752,Thézy-Glimont,683,675,8
32,80,218007052,80753,Thiepval,126,124,2
32,80,218007060,80754,Thieulloy-l'Abbaye,403,394,9
32,80,218007078,80755,Thieulloy-la-Ville,146,145,1
32,80,218007086,80756,Thièvres,64,64,0
32,80,218007094,80757,Thoix,146,144,2
32,80,218007102,80758,Thory,209,208,1
32,80,218007110,80759,Tilloloy,355,346,9
32,80,218007128,80760,Tilloy-Floriville,379,370,9
32,80,218007144,80762,Tincourt-Boucly,347,343,4
32,80,218007151,80763,Le Titre,360,352,8
32,80,218007169,80764,Toeufles,306,299,7
32,80,218007177,80765,Tours-en-Vimeu,816,806,10
32,80,218007185,80766,Toutencourt,439,434,5
32,80,218007193,80767,Le Translay,253,248,5
32,80,218007201,80769,Treux,224,224,0
32,80,218007219,80770,Tully,549,540,9
32,80,218007227,80771,Ugny-l'Équipée,30,30,0
32,80,218007243,80773,Vadencourt,106,106,0
32,80,218007250,80774,Vaire-sous-Corbie,293,290,3
32,80,218007268,80775,Valines,631,626,5
32,80,218007276,80776,Varennes,219,218,1
32,80,218007284,80777,Vauchelles-lès-Authie,139,138,1
32,80,218007292,80778,Vauchelles-lès-Domart,129,125,4
32,80,218007300,80779,Vauchelles-les-Quesnoy,860,835,25
32,80,218007318,80780,Vaudricourt,416,411,5
32,80,218007326,80781,Vauvillers,225,220,5
32,80,218007334,80782,Vaux-en-Amiénois,431,424,7
32,80,218007342,80783,Vaux-Marquenneville,83,82,1
32,80,218007359,80784,Vaux-sur-Somme,297,295,2
32,80,218007367,80785,Vecquemont,551,542,9
32,80,218007375,80786,Velennes,149,146,3
32,80,218007383,80787,Vercourt,97,96,1
32,80,218007391,80788,Vergies,177,175,2
32,80,218007409,80789,Vermandovillers,157,157,0
32,80,218007417,80790,Verpillières,171,168,3
32,80,218007425,80791,Vers-sur-Selle,780,775,5
32,80,218007433,80792,La Vicogne,250,246,4
32,80,218007441,80793,Vignacourt,2359,2323,36
32,80,218007458,80794,Villecourt,54,54,0
32,80,218007466,80795,Ville-le-Marclet,508,466,42
32,80,218007474,80796,Villeroy,183,178,5
32,80,218007482,80797,Villers-aux-Érables,142,139,3
32,80,218007490,80798,Villers-Bocage,1488,1435,53
32,80,218007508,80799,Villers-Bretonneux,4693,4637,56
32,80,218007516,80800,Villers-Campsart,146,139,7
32,80,218007524,80801,Villers-Carbonnel,316,312,4
32,80,218007532,80802,Villers-Faucon,563,554,9
32,80,218007540,80803,Villers-lès-Roye,276,276,0
32,80,218007557,80804,Villers-sous-Ailly,186,181,5
32,80,218007565,80805,Villers-Tournelle,160,154,6
32,80,218007573,80806,Villers-sur-Authie,477,469,8
32,80,218007581,80807,Ville-sur-Ancre,264,261,3
32,80,218007599,80808,Vironchaux,510,501,9
32,80,218007607,80809,Vismes,487,476,11
32,80,218007615,80810,Vitz-sur-Authie,136,135,1
32,80,218007623,80811,Voyennes,593,586,7
32,80,218007631,80812,Vraignes-en-Vermandois,139,137,2
32,80,218007649,80813,Vraignes-lès-Hornoy,98,96,2
32,80,218007656,80814,Vrély,461,452,9
32,80,218007664,80815,Vron,859,834,25
32,80,218007672,80819,Wargnies,85,83,2
32,80,218007680,80820,Warloy-Baillon,764,750,14
32,80,218007698,80821,Warlus,223,221,2
32,80,218007706,80822,Warsy,141,139,2
32,80,218007714,80823,Warvillers,135,126,9
32,80,218007722,80824,Wiencourt-l'Équipée,267,264,3
32,80,218007730,80825,Wiry-au-Mont,113,112,1
32,80,218007748,80826,Woignarue,797,779,18
32,80,218007755,80827,Woincourt,1238,1224,14
32,80,218007763,80828,Woirel,61,60,1
32,80,218007771,80829,Y,92,90,2
32,80,218007789,80830,Yaucourt-Bussus,249,245,4
32,80,218007797,80832,Yvrench,309,305,4
32,80,218007805,80833,Yvrencheux,126,124,2
32,80,218007813,80834,Yzengremer,554,512,42
32,80,218007821,80835,Yzeux,270,270,0
32,80,218008365,80836,Yonval,236,226,10
76,81,218100014,81001,Aguts,239,230,9
76,81,218100022,81002,Aiguefonde,2564,2507,57
76,81,218100030,81003,Alban,960,925,35
76,81,218100048,81004,Albi,50783,49094,1689
76,81,218100055,81005,Albine,520,515,5
76,81,218100063,81006,Algans,195,193,2
76,81,218100071,81007,Alos,99,97,2
76,81,218100089,81008,Almayrac,301,296,5
76,81,218100097,81009,Amarens,69,69,0
76,81,218100105,81010,Ambialet,475,468,7
76,81,218100113,81011,Ambres,1063,1023,40
76,81,218100121,81012,Andillac,121,120,1
76,81,218100139,81013,Andouque,416,408,8
76,81,218100147,81014,Anglès,519,507,12
76,81,218100154,81015,Appelle,75,74,1
76,81,218100162,81016,Arfons,174,167,7
76,81,218100170,81017,Arifat,151,149,2
76,81,218100188,81018,Arthès,2569,2517,52
76,81,218100196,81019,Assac,150,146,4
76,81,218100204,81020,Aussac,280,268,12
76,81,218100212,81021,Aussillon,5929,5795,134
76,81,218100220,81022,Bannières,209,206,3
76,81,218100238,81023,Barre,210,208,2
76,81,218100246,81024,Beauvais-sur-Tescou,374,367,7
76,81,218100253,81025,Belcastel,255,246,9
76,81,200054583,81026,Bellegarde-Marsal,707,700,7
76,81,218100279,81027,Belleserre,157,155,2
76,81,218100287,81028,Berlats,102,101,1
76,81,218100295,81029,Bernac,188,183,5
76,81,218100303,81030,Bertre,112,111,1
76,81,218100311,81031,Le Bez,865,848,17
76,81,218100329,81032,Blan,1141,1123,18
76,81,218100337,81033,Blaye-les-Mines,3112,2925,187
76,81,218100345,81034,Boissezon,388,381,7
76,81,218100352,81035,Bournazel,233,226,7
76,81,218100360,81036,Bout-du-Pont-de-Larn,1296,1272,24
76,81,218100378,81037,Brassac,1329,1297,32
76,81,218100386,81038,Brens,2433,2367,66
76,81,218100394,81039,Briatexte,2047,2011,36
76,81,218100402,81040,Brousse,438,431,7
76,81,218100410,81041,Broze,117,116,1
76,81,218100428,81042,Burlats,2057,2014,43
76,81,218100436,81043,Busque,740,728,12
76,81,218100444,81044,Cabanès,317,312,5
76,81,218100451,81045,Les Cabannes,376,367,9
76,81,218100469,81046,Cadalen,1573,1528,45
76,81,218100477,81047,Cadix,227,220,7
76,81,218100485,81048,Cagnac-les-Mines,2611,2580,31
76,81,218100493,81049,Cahuzac,360,357,3
76,81,218100501,81050,Cambon-lès-Lavaur,358,347,11
76,81,218100519,81051,Cahuzac-sur-Vère,1183,1164,19
76,81,218100527,81052,Cambon,2183,2126,57
76,81,218100535,81053,Cambounès,337,334,3
76,81,218100543,81054,Cambounet-sur-le-Sor,969,943,26
76,81,218100550,81055,Les Cammazes,370,366,4
76,81,218100568,81056,Campagnac,160,157,3
76,81,218100584,81058,Carbes,240,233,7
76,81,218100592,81059,Carlus,678,663,15
76,81,218100600,81060,Carmaux,10036,9870,166
76,81,218100618,81061,Castanet,196,194,2
76,81,200055895,81062,Fontrieu,947,927,20
76,81,218100634,81063,Castelnau-de-Lévis,1654,1619,35
76,81,218100642,81064,Castelnau-de-Montmiral,1071,1046,25
76,81,218100659,81065,Castres,43833,42394,1439
76,81,218100667,81066,Caucalières,289,283,6
76,81,218100675,81067,Cestayrols,487,471,16
76,81,218100683,81068,Combefa,172,168,4
76,81,218100691,81069,Cordes-sur-Ciel,856,817,39
76,81,218100709,81070,Coufouleux,3027,2971,56
76,81,218100717,81071,Courris,82,79,3
76,81,218100725,81072,Crespin,125,123,2
76,81,218100733,81073,Crespinet,181,180,1
76,81,218100741,81074,Cunac,1676,1614,62
76,81,218100758,81075,Cuq,512,501,11
76,81,218100766,81076,Cuq-Toulza,721,702,19
76,81,218100774,81077,Curvalle,402,393,9
76,81,218100782,81078,Damiatte,1055,1040,15
76,81,218100790,81079,Dénat,842,809,33
76,81,218100808,81080,Donnazac,69,67,2
76,81,218100816,81081,Dourgne,1342,1307,35
76,81,218100824,81082,Le Dourn,116,113,3
76,81,218100832,81083,Durfort,245,244,1
76,81,218100840,81084,Escoussens,642,621,21
76,81,218100857,81085,Lacapelle-Escroux,45,44,1
76,81,218100865,81086,Espérausses,176,173,3
76,81,218100873,81087,Fayssac,374,364,10
76,81,218100881,81088,Fauch,580,570,10
76,81,218100899,81089,Faussergues,139,134,5
76,81,218100907,81090,Fénols,258,253,5
76,81,218100923,81092,Fiac,941,926,15
76,81,218100931,81093,Florentin,741,693,48
76,81,218100949,81094,Fraissines,97,93,4
76,81,218100956,81095,Frausseilles,85,84,1
76,81,218100964,81096,Le Fraysse,424,419,5
76,81,218100972,81097,Fréjairolles,1369,1334,35
76,81,218100980,81098,Fréjeville,739,719,20
76,81,218100998,81099,Gaillac,15572,15245,327
76,81,218101004,81100,Garrevaques,411,401,10
76,81,218101012,81101,Le Garric,1290,1272,18
76,81,218101020,81102,Garrigues,293,287,6
76,81,218101038,81103,Gijounet,142,135,7
76,81,218101046,81104,Giroussens,1541,1504,37
76,81,218101053,81105,Graulhet,13153,12914,239
76,81,218101061,81106,Grazac,636,625,11
76,81,218101087,81108,Itzac,177,176,1
76,81,218101095,81109,Jonquières,450,443,7
76,81,218101103,81110,Jouqueviel,102,98,4
76,81,218101111,81111,Labarthe-Bleys,76,76,0
76,81,218101129,81112,Labastide-de-Lévis,974,950,24
76,81,218101145,81114,Labastide-Gabausse,532,521,11
76,81,218101152,81115,Labastide-Rouairoux,1438,1413,25
76,81,218101160,81116,Labastide-Saint-Georges,1991,1944,47
76,81,218101178,81117,Labessière-Candeil,780,758,22
76,81,218101186,81118,Laboulbène,162,158,4
76,81,218101194,81119,Laboutarie,494,489,5
76,81,218101202,81120,Labruguière,6624,6510,114
76,81,218101210,81121,Lacabarède,292,292,0
76,81,218101228,81122,Lacapelle-Pinet,80,77,3
76,81,218101236,81123,Lacapelle-Ségalar,96,93,3
76,81,218101244,81124,Lacaune,2543,2466,77
76,81,218101251,81125,Lacaze,320,313,7
76,81,218101269,81126,Lacougotte-Cadoul,191,183,8
76,81,218101277,81127,Lacroisille,113,106,7
76,81,218101285,81128,Lacrouzette,1609,1573,36
76,81,218101293,81129,Lagardiolle,234,229,5
76,81,218101301,81130,Lagarrigue,1838,1802,36
76,81,218101319,81131,Lagrave,2292,2247,45
76,81,200009595,81132,Guitalens-L'Albarède,847,835,12
76,81,218101335,81133,Lamillarié,512,499,13
76,81,218101343,81134,Lamontélarié,57,57,0
76,81,218101350,81135,Laparrouquial,95,95,0
76,81,218101368,81136,Larroque,152,149,3
76,81,218101376,81137,Lasfaillades,88,87,1
76,81,218101384,81138,Lasgraisses,567,558,9
76,81,218101392,81139,Lautrec,1756,1706,50
76,81,218101400,81140,Lavaur,11214,10820,394
76,81,218101418,81141,Lédas-et-Penthiès,160,154,6
76,81,218101426,81142,Lempaut,908,894,14
76,81,218101434,81143,Lescout,770,757,13
76,81,218101442,81144,Lescure-d'Albigeois,4670,4577,93
76,81,218101459,81145,Lisle-sur-Tarn,4776,4693,83
76,81,218101467,81146,Livers-Cazelles,242,237,5
76,81,218101475,81147,Lombers,1151,1122,29
76,81,218101483,81148,Loubers,82,81,1
76,81,218101491,81149,Loupiac,442,427,15
76,81,218101509,81150,Lugan,440,427,13
76,81,218101517,81151,Magrin,133,127,6
76,81,218101525,81152,Mailhoc,323,320,3
76,81,218101541,81154,Marnaves,79,78,1
76,81,218101566,81156,Marssac-sur-Tarn,3522,3439,83
76,81,218101574,81157,Marzens,323,312,11
76,81,218101582,81158,Le Masnau-Massuguiès,265,259,6
76,81,218101590,81159,Massac-Séran,451,432,19
76,81,218101608,81160,Massaguel,363,355,8
76,81,218101616,81161,Massals,113,112,1
76,81,218101624,81162,Maurens-Scopont,151,149,2
76,81,218101632,81163,Mazamet,10361,9953,408
76,81,218101640,81164,Mézens,526,516,10
76,81,218101657,81165,Milhars,245,242,3
76,81,218101665,81166,Milhavet,97,94,3
76,81,218101673,81167,Miolles,106,106,0
76,81,218101681,81168,Mirandol-Bourgnounac,1058,1041,17
76,81,218101699,81169,Missècle,100,99,1
76,81,218101707,81170,Monestiés,1389,1368,21
76,81,218101715,81171,Montans,1566,1534,32
76,81,218101723,81172,Montauriol,60,60,0
76,81,218101731,81173,Montcabrier,331,324,7
76,81,218101749,81174,Montdragon,630,620,10
76,81,218101756,81175,Montdurausse,430,425,5
76,81,218101764,81176,Montels,109,104,5
76,81,218101772,81177,Montfa,501,484,17
76,81,218101780,81178,Montgaillard,372,359,13
76,81,218101798,81179,Montgey,286,278,8
76,81,218101806,81180,Montirat,258,255,3
76,81,218101814,81181,Montpinier,192,189,3
76,81,218101822,81182,Montredon-Labessonnié,2060,2018,42
76,81,218101830,81183,Mont-Roc,194,187,7
76,81,218101848,81184,Montrosier,35,35,0
76,81,218101855,81185,Montvalen,243,239,4
76,81,218101863,81186,Moularès,261,257,4
76,81,218101871,81187,Moulayrès,217,214,3
76,81,218101889,81188,Moulin-Mage,319,316,3
76,81,218101897,81189,Mouzens,130,128,2
76,81,218101905,81190,Mouzieys-Teulet,558,548,10
76,81,218101913,81191,Mouzieys-Panens,235,234,1
76,81,218101921,81192,Murat-sur-Vèbre,879,867,12
76,81,218101939,81193,Nages,342,338,4
76,81,218101954,81195,Navès,712,689,23
76,81,218101962,81196,Noailhac,872,851,21
76,81,218101970,81197,Noailles,216,212,4
76,81,218101988,81198,Orban,334,330,4
76,81,218101996,81199,Padiès,181,178,3
76,81,218102002,81200,Palleville,493,440,53
76,81,218102010,81201,Pampelonne,900,880,20
76,81,218102028,81202,Parisot,982,963,19
76,81,218102036,81203,Paulinet,555,541,14
76,81,218102044,81204,Payrin-Augmontel,2219,2181,38
76,81,218102051,81205,Péchaudier,196,190,6
76,81,218102069,81206,Penne,605,587,18
76,81,218102077,81207,Peyregoux,108,79,29
76,81,218102085,81208,Peyrole,598,582,16
76,81,218102093,81209,Pont-de-Larn,2859,2781,78
76,81,218102101,81210,Poudis,271,264,7
76,81,218102119,81211,Poulan-Pouzols,504,494,10
76,81,218102127,81212,Prades,127,123,4
76,81,218102135,81213,Pratviel,93,91,2
76,81,218102143,81214,Puéchoursi,101,100,1
76,81,218102150,81215,Puybegon,654,644,10
76,81,218102168,81216,Puycalvel,213,210,3
76,81,218102176,81217,Puycelsi,463,452,11
76,81,200063360,81218,Puygouzon,3616,3534,82
76,81,218102192,81219,Puylaurens,3266,3194,72
76,81,218102200,81220,Rabastens,5895,5748,147
76,81,218102218,81221,Rayssac,235,234,1
76,81,218102226,81222,Réalmont,3558,3501,57
76,81,218102234,81223,Le Rialet,58,57,1
76,81,218102242,81224,Le Riols,101,100,1
76,81,218102259,81225,Rivières,1102,1072,30
76,81,218102275,81227,Roquecourbe,2225,2185,40
76,81,218102283,81228,Roquemaure,478,468,10
76,81,218102291,81229,Roquevidal,134,130,4
76,81,218102309,81230,Rosières,738,725,13
76,81,218102317,81231,Rouairoux,390,383,7
76,81,218102325,81232,Rouffiac,640,626,14
76,81,200085322,81233,Terre-de-Bancalié,1758,1730,28
76,81,218102341,81234,Roussayrolles,90,87,3
76,81,218102358,81235,Saint-Affrique-les-Montagnes,749,733,16
76,81,218102366,81236,Saint-Agnan,285,276,9
76,81,218102374,81237,Saint-Amancet,188,185,3
76,81,218102382,81238,Saint-Amans-Soult,1637,1514,123
76,81,218102390,81239,Saint-Amans-Valtoret,877,865,12
76,81,218102408,81240,Saint-André,106,102,4
76,81,218102424,81242,Saint-Avit,267,266,1
76,81,218102432,81243,Saint-Beauzile,134,132,2
76,81,218102440,81244,Saint-Benoît-de-Carmaux,2090,2058,32
76,81,218102457,81245,Saint-Christophe,128,122,6
76,81,218102465,81246,Sainte-Cécile-du-Cayrou,111,109,2
76,81,218102473,81247,Saint-Cirgue,211,208,3
76,81,218102481,81248,Saint-Gauzens,919,899,20
76,81,218102499,81249,Sainte-Gemme,916,899,17
76,81,218102507,81250,Saint-Genest-de-Contest,289,281,8
76,81,218102515,81251,Saint-Germain-des-Prés,956,928,28
76,81,218102523,81252,Saint-Germier,148,147,1
76,81,218102531,81253,Saint-Grégoire,463,456,7
76,81,218102549,81254,Saint-Jean-de-Marcel,384,380,4
76,81,218102556,81255,Saint-Jean-de-Rives,539,525,14
76,81,218102564,81256,Saint-Jean-de-Vals,83,79,4
76,81,218102572,81257,Saint-Juéry,6732,6627,105
76,81,218102580,81258,Saint-Julien-du-Puy,456,443,13
76,81,218102598,81259,Saint-Julien-Gaulène,225,224,1
76,81,218102614,81261,Saint-Lieux-lès-Lavaur,1176,1157,19
76,81,218102622,81262,Saint-Marcel-Campes,213,211,2
76,81,218102630,81263,Saint-Martin-Laguépie,401,391,10
76,81,218102648,81264,Saint-Michel-Labadié,91,89,2
76,81,218102655,81265,Saint-Michel-de-Vax,80,79,1
76,81,218102663,81266,Saint-Paul-Cap-de-Joux,1095,1067,28
76,81,218102671,81267,Saint-Pierre-de-Trivisy,625,614,11
76,81,218102689,81268,Saint-Salvi-de-Carcavès,76,72,4
76,81,218102697,81269,Saint-Salvy-de-la-Balme,513,507,6
76,81,218102705,81270,Saint-Sernin-lès-Lavaur,171,168,3
76,81,218102713,81271,Saint-Sulpice-la-Pointe,9751,9480,271
76,81,218102721,81272,Saint-Urcisse,220,219,1
76,81,218102739,81273,Saïx,3703,3630,73
76,81,218102747,81274,Saliès,850,832,18
76,81,218102754,81275,Salles,196,194,2
76,81,218102762,81276,Salvagnac,1261,1242,19
76,81,218102770,81277,Saussenac,621,611,10
76,81,218102788,81278,Sauveterre,171,169,2
76,81,218102796,81279,La Sauzière-Saint-Jean,269,260,9
76,81,218102804,81280,Le Ségur,268,261,7
76,81,218102812,81281,Sémalens,2060,2006,54
76,81,218102820,81282,Senaux,34,34,0
76,81,218102838,81283,Senouillac,1157,1123,34
76,81,218102846,81284,Le Sequestre,1981,1951,30
76,81,218102853,81285,Sérénac,494,491,3
76,81,218102861,81286,Serviès,619,599,20
76,81,218102879,81287,Sieurac,273,271,2
76,81,218102887,81288,Sorèze,3003,2938,65
76,81,218102895,81289,Soual,2665,2627,38
76,81,218102903,81290,Souel,167,166,1
76,81,218102911,81291,Taïx,512,506,6
76,81,218102929,81292,Tanus,558,539,19
76,81,218102937,81293,Tauriac,366,363,3
76,81,218102945,81294,Técou,1062,1034,28
76,81,218102952,81295,Teillet,444,438,6
76,81,218102978,81297,Terssac,1251,1220,31
76,81,218102986,81298,Teulat,489,476,13
76,81,218102994,81299,Teyssode,394,378,16
76,81,218103000,81300,Tonnac,100,98,2
76,81,218103026,81302,Tréban,57,56,1
76,81,218103034,81303,Trébas,415,411,4
76,81,218103042,81304,Trévien,193,190,3
76,81,218103059,81305,Vabre,749,731,18
76,81,218103067,81306,Valderiès,857,834,23
76,81,218103075,81307,Valdurenque,880,862,18
76,81,218103083,81308,Valence-d'Albigeois,1323,1295,28
76,81,218103091,81309,Vaour,311,296,15
76,81,218103109,81310,Veilhes,159,157,2
76,81,218103117,81311,Vénès,751,732,19
76,81,218103125,81312,Verdalle,1186,1015,171
76,81,218103133,81313,Le Verdier,234,227,7
76,81,218103141,81314,Viane,571,533,38
76,81,218103158,81315,Vielmur-sur-Agout,1448,1401,47
76,81,218103166,81316,Vieux,230,227,3
76,81,218103174,81317,Villefranche-d'Albigeois,1264,1244,20
76,81,218103182,81318,Villeneuve-lès-Lavaur,144,142,2
76,81,218103190,81319,Villeneuve-sur-Vère,529,515,14
76,81,218103208,81320,Vindrac-Alayrac,151,147,4
76,81,218103216,81321,Le Vintrou,92,91,1
76,81,218103224,81322,Virac,257,251,6
76,81,218103232,81323,Viterbe,366,360,6
76,81,218103240,81324,Viviers-lès-Lavaur,244,239,5
76,81,218103257,81325,Viviers-lès-Montagnes,2026,1976,50
76,81,218103265,81326,Sainte-Croix,408,399,9
76,82,218200012,82001,Albefeuille-Lagarde,626,614,12
76,82,218200020,82002,Albias,3395,3337,58
76,82,218200038,82003,Angeville,252,246,6
76,82,218200046,82004,Asques,136,136,0
76,82,218200053,82005,Aucamville,1550,1531,19
76,82,218200061,82006,Auterive,80,78,2
76,82,218200079,82007,Auty,147,146,1
76,82,218200087,82008,Auvillar,951,910,41
76,82,218200095,82009,Balignac,41,39,2
76,82,218200103,82010,Bardigues,247,242,5
76,82,218200111,82011,Barry-d'Islemade,956,936,20
76,82,218200129,82012,Les Barthes,579,571,8
76,82,218200137,82013,Beaumont-de-Lomagne,3951,3778,173
76,82,218200145,82014,Beaupuy,270,262,8
76,82,218200152,82015,Belbèze-en-Lomagne,164,160,4
76,82,218200160,82016,Belvèze,219,217,2
76,82,218200178,82017,Bessens,1503,1478,25
76,82,218200186,82018,Bioule,1192,1164,28
76,82,218200194,82019,Boudou,768,750,18
76,82,218200202,82020,Bouillac,601,588,13
76,82,218200210,82021,Bouloc-en-Quercy,195,192,3
76,82,218200228,82022,Bourg-de-Visa,389,380,9
76,82,218200236,82023,Bourret,992,981,11
76,82,218200244,82024,Brassac,252,249,3
76,82,218200251,82025,Bressols,3804,3700,104
76,82,218200269,82026,Bruniquel,625,614,11
76,82,218200277,82027,Campsas,1452,1429,23
76,82,218200285,82028,Canals,817,806,11
76,82,218200293,82029,Castanet,280,277,3
76,82,218200301,82030,Castelferrus,502,491,11
76,82,218200319,82031,Castelmayran,1229,1212,17
76,82,218200327,82032,Castelsagrat,553,540,13
76,82,218200335,82033,Castelsarrasin,14404,14131,273
76,82,218200343,82034,Castéra-Bouzet,110,107,3
76,82,218200350,82035,Caumont,353,344,9
76,82,218200368,82036,Le Causé,139,134,5
76,82,218200376,82037,Caussade,7022,6819,203
76,82,218200384,82038,Caylus,1519,1489,30
76,82,218200392,82039,Cayrac,585,563,22
76,82,218200400,82040,Cayriech,289,280,9
76,82,218200418,82041,Cazals,239,236,3
76,82,218200426,82042,Cazes-Mondenard,1219,1203,16
76,82,218200434,82043,Comberouger,271,269,2
76,82,218200442,82044,Corbarieu,1750,1697,53
76,82,218200459,82045,Cordes-Tolosannes,363,357,6
76,82,218200467,82046,Coutures,115,115,0
76,82,218200475,82047,Cumont,51,51,0
76,82,218200483,82048,Dieupentale,1639,1625,14
76,82,218200491,82049,Donzac,1043,1032,11
76,82,218200509,82050,Dunes,1223,1200,23
76,82,218200517,82051,Durfort-Lacapelette,931,841,90
76,82,218200525,82052,Escatalens,1221,1115,106
76,82,218200533,82053,Escazeaux,290,287,3
76,82,218200541,82054,Espalais,393,386,7
76,82,218200558,82055,Esparsac,264,256,8
76,82,218200566,82056,Espinas,188,185,3
76,82,218200574,82057,Fabas,683,668,15
76,82,218200582,82058,Fajolles,103,101,2
76,82,218200590,82059,Faudoas,301,291,10
76,82,218200608,82060,Fauroux,194,190,4
76,82,218200616,82061,Féneyrols,141,139,2
76,82,218200624,82062,Finhan,1544,1522,22
76,82,218200632,82063,Garganvillar,696,681,15
76,82,218200640,82064,Gariès,125,125,0
76,82,218200657,82065,Gasques,417,407,10
76,82,218200665,82066,Génébrières,622,609,13
76,82,218200673,82067,Gensac,107,106,1
76,82,218200681,82068,Gimat,249,243,6
76,82,218200699,82069,Ginals,206,200,6
76,82,218200707,82070,Glatens,73,71,2
76,82,218200715,82071,Goas,39,37,2
76,82,218200723,82072,Golfech,1025,1013,12
76,82,218200731,82073,Goudourville,971,948,23
76,82,218200749,82074,Gramont,136,131,5
76,82,218200756,82075,Grisolles,4268,4187,81
76,82,218200764,82076,L'Honor-de-Cos,1632,1600,32
76,82,218200772,82077,Labarthe,406,400,6
76,82,218200780,82078,Labastide-de-Penne,128,128,0
76,82,218200798,82079,Labastide-Saint-Pierre,3881,3803,78
76,82,218200806,82080,Labastide-du-Temple,1175,1148,27
76,82,218200814,82081,Labourgade,186,183,3
76,82,218200822,82082,Lacapelle-Livron,201,195,6
76,82,218200830,82083,Lachapelle,119,118,1
76,82,218200848,82084,Lacour,171,169,2
76,82,218200855,82085,Lacourt-Saint-Pierre,1272,1261,11
76,82,218200863,82086,Lafitte,228,225,3
76,82,218200871,82087,Lafrançaise,2904,2843,61
76,82,218200889,82088,Laguépie,626,620,6
76,82,218200897,82089,Lamagistère,1202,1182,20
76,82,218200905,82090,Lamothe-Capdeville,1082,1054,28
76,82,218200913,82091,Lamothe-Cumont,128,125,3
76,82,218200921,82092,Lapenche,293,289,4
76,82,218200939,82093,Larrazet,710,702,8
76,82,218200947,82094,Lauzerte,1471,1453,18
76,82,218200954,82095,Lavaurette,230,217,13
76,82,218200962,82096,La Ville-Dieu-du-Temple,3188,3140,48
76,82,218200970,82097,Lavit,1643,1625,18
76,82,218200988,82098,Léojac,1291,1262,29
76,82,218200996,82099,Lizac,547,539,8
76,82,218201002,82100,Loze,133,126,7
76,82,218201010,82101,Malause,1236,1219,17
76,82,218201028,82102,Mansonville,306,302,4
76,82,218201036,82103,Marignac,111,105,6
76,82,218201044,82104,Marsac,189,183,6
76,82,218201051,82105,Mas-Grenier,1364,1344,20
76,82,218201069,82106,Maubec,138,137,1
76,82,218201077,82107,Maumusson,50,48,2
76,82,218201085,82108,Meauzac,1415,1385,30
76,82,218201093,82109,Merles,217,204,13
76,82,218201101,82110,Mirabel,1054,1036,18
76,82,218201119,82111,Miramont-de-Quercy,319,313,6
76,82,218201127,82112,Moissac,14074,13738,336
76,82,218201135,82113,Molières,1229,1215,14
76,82,218201143,82114,Monbéqui,653,647,6
76,82,218201150,82115,Monclar-de-Quercy,2051,2014,37
76,82,218201168,82116,Montagudet,197,193,4
76,82,218201176,82117,Montaigu-de-Quercy,1324,1300,24
76,82,218201184,82118,Montaïn,98,97,1
76,82,218201192,82119,Montalzat,675,657,18
76,82,218201200,82120,Montastruc,297,292,5
76,82,218201218,82121,Montauban,63158,61677,1481
76,82,218201226,82122,Montbarla,189,186,3
76,82,218201234,82123,Montbartier,1576,1558,18
76,82,218201242,82124,Montbeton,4328,4238,90
76,82,218201259,82125,Montech,6799,6669,130
76,82,218201267,82126,Monteils,1470,1366,104
76,82,218201275,82127,Montesquieu,772,754,18
76,82,218201283,82128,Montfermier,109,106,3
76,82,218201291,82129,Montgaillard,153,149,4
76,82,218201309,82130,Montjoi,168,167,1
76,82,218201317,82131,Montpezat-de-Quercy,1640,1600,40
76,82,218201325,82132,Montricoux,1202,1175,27
76,82,218201333,82133,Mouillac,91,90,1
76,82,218201341,82134,Nègrepelisse,5821,5740,81
76,82,218201358,82135,Nohic,1350,1332,18
76,82,218201366,82136,Orgueil,1744,1720,24
76,82,218201374,82137,Parisot,566,555,11
76,82,218201382,82138,Perville,169,167,2
76,82,218201390,82139,Le Pin,124,121,3
76,82,218201408,82140,Piquecos,456,453,3
76,82,218201416,82141,Pommevic,555,551,4
76,82,218201424,82142,Pompignan,1656,1632,24
76,82,218201432,82143,Poupas,86,86,0
76,82,218201440,82144,Puycornet,766,755,11
76,82,218201457,82145,Puygaillard-de-Quercy,381,373,8
76,82,218201465,82146,Puygaillard-de-Lomagne,60,58,2
76,82,218201473,82147,Puylagarde,342,332,10
76,82,218201481,82148,Puylaroque,714,689,25
76,82,218201499,82149,Réalville,1897,1865,32
76,82,218201507,82150,Reyniès,897,874,23
76,82,218201515,82151,Roquecor,407,401,6
76,82,218201523,82152,Saint-Aignan,407,396,11
76,82,218201531,82153,Saint-Amans-du-Pech,227,226,1
76,82,218201549,82154,Saint-Amans-de-Pellagal,214,209,5
76,82,218201556,82155,Saint-Antonin-Noble-Val,1921,1884,37
76,82,218201564,82156,Saint-Arroumex,151,147,4
76,82,218201572,82157,Saint-Beauzeil,102,101,1
76,82,218201580,82158,Saint-Cirice,148,142,6
76,82,218201598,82159,Saint-Cirq,582,565,17
76,82,218201606,82160,Saint-Clair,268,260,8
76,82,218201614,82161,Saint-Étienne-de-Tulmont,4045,3965,80
76,82,218201622,82162,Saint-Georges,274,267,7
76,82,218201630,82163,Saint-Jean-du-Bouzet,52,51,1
76,82,218201648,82164,Sainte-Juliette,128,125,3
76,82,218201655,82165,Saint-Loup,539,535,4
76,82,218201663,82166,Saint-Michel,287,284,3
76,82,218201671,82167,Saint-Nauphary,1949,1907,42
76,82,218201689,82168,Saint-Nazaire-de-Valentane,322,319,3
76,82,218201697,82169,Saint-Nicolas-de-la-Grave,2327,2298,29
76,82,218201705,82170,Saint-Paul-d'Espis,577,560,17
76,82,218201713,82171,Saint-Porquier,1410,1384,26
76,82,218201721,82172,Saint-Projet,282,274,8
76,82,218201739,82173,Saint-Sardos,1181,1166,15
76,82,218201747,82174,Saint-Vincent-d'Autéjac,288,286,2
76,82,218201754,82175,Saint-Vincent-Lespinasse,281,277,4
76,82,218201762,82176,La Salvetat-Belmontet,910,896,14
76,82,218201770,82177,Sauveterre,159,157,2
76,82,218201788,82178,Savenès,832,815,17
76,82,218201796,82179,Septfonds,2311,2261,50
76,82,218201804,82180,Sérignac,526,518,8
76,82,218201812,82181,Sistels,209,205,4
76,82,218201820,82182,Touffailles,339,336,3
76,82,218201838,82183,Tréjouls,247,237,10
76,82,218201846,82184,Vaïssac,940,930,10
76,82,218201853,82185,Valeilles,257,251,6
76,82,218201861,82186,Valence,5381,5233,148
76,82,218201879,82187,Varen,664,654,10
76,82,218201887,82188,Varennes,651,637,14
76,82,218201895,82189,Vazerac,762,748,14
76,82,218201903,82190,Verdun-sur-Garonne,4900,4831,69
76,82,218201911,82191,Verfeil,430,426,4
76,82,218201929,82192,Verlhac-Tescou,554,541,13
76,82,218201937,82193,Vigueron,140,137,3
76,82,218201945,82194,Villebrumier,1393,1359,34
76,82,218201952,82195,Villemade,809,796,13
93,83,218300010,83001,Les Adrets-de-l'Estérel,2877,2803,74
93,83,218300028,83002,Aiguines,276,271,5
93,83,218300036,83003,Ampus,926,903,23
93,83,218300044,83004,Les Arcs,7471,7292,179
93,83,218300051,83005,Artignosc-sur-Verdon,291,285,6
93,83,218300069,83006,Artigues,291,283,8
93,83,218300077,83007,Aups,2342,2303,39
93,83,218300085,83008,Bagnols-en-Forêt,2948,2889,59
93,83,218300093,83009,Bandol,8483,8359,124
93,83,218300101,83010,Bargème,229,228,1
93,83,218300119,83011,Bargemon,1383,1367,16
93,83,218300127,83012,Barjols,3056,3017,39
93,83,218300135,83013,La Bastide,206,205,1
93,83,218300143,83014,Baudinard-sur-Verdon,250,241,9
93,83,218300150,83015,Bauduen,323,319,4
93,83,218300168,83016,Le Beausset,9983,9802,181
93,83,218300176,83017,Belgentier,2456,2411,45
93,83,218300184,83018,Besse-sur-Issole,3122,3066,56
93,83,218300192,83019,Bormes-les-Mimosas,8277,8162,115
93,83,218300200,83020,Le Bourguet,43,42,1
93,83,218300218,83021,Bras,2674,2625,49
93,83,218300226,83022,Brenon,23,23,0
93,83,218300234,83023,Brignoles,17964,17652,312
93,83,218300259,83025,Brue-Auriac,1463,1440,23
93,83,218300267,83026,Cabasse,1970,1934,36
93,83,218300275,83027,La Cadière-d'Azur,5647,5548,99
93,83,218300283,83028,Callas,1998,1961,37
93,83,218300291,83029,Callian,3567,3498,69
93,83,218300309,83030,Camps-la-Source,1940,1893,47
93,83,218300317,83031,Le Cannet-des-Maures,4386,4325,61
93,83,218300325,83032,Carcès,3470,3388,82
93,83,218300333,83033,Carnoules,3623,3587,36
93,83,218300341,83034,Carqueiranne,9627,9462,165
93,83,218300358,83035,Le Castellet,4633,4578,55
93,83,218300366,83036,Cavalaire-sur-Mer,7735,7642,93
93,83,218300374,83037,La Celle,1604,1536,68
93,83,218300382,83038,Châteaudouble,494,479,15
93,83,218300390,83039,Châteauvert,152,147,5
93,83,218300408,83040,Châteauvieux,78,77,1
93,83,218300416,83041,Claviers,730,720,10
93,83,218300424,83042,Cogolin,12007,11794,213
93,83,218300432,83043,Collobrières,1943,1855,88
93,83,218300440,83044,Comps-sur-Artuby,341,336,5
93,83,218300457,83045,Correns,915,902,13
93,83,218300465,83046,Cotignac,2145,2105,40
93,83,218300473,83047,La Crau,19481,19052,429
93,83,218300481,83048,La Croix-Valmer,3873,3780,93
93,83,218300499,83049,Cuers,12433,12298,135
93,83,218300507,83050,Draguignan,40362,39434,928
93,83,218300515,83051,Entrecasteaux,1145,1122,23
93,83,218300523,83052,Esparron,375,370,5
93,83,218300531,83053,Évenos,2457,2407,50
93,83,218300549,83054,La Farlède,9725,9605,120
93,83,218300556,83055,Fayence,5857,5770,87
93,83,218300564,83056,Figanières,2678,2623,55
93,83,218300572,83057,Flassans-sur-Issole,3650,3582,68
93,83,218300580,83058,Flayosc,4298,4195,103
93,83,218300598,83059,Forcalqueiret,3222,3185,37
93,83,218300606,83060,Fox-Amphoux,478,471,7
93,83,218300614,83061,Fréjus,56598,55750,848
93,83,218300622,83062,La Garde,25876,25563,313
93,83,218300630,83063,La Garde-Freinet,1871,1827,44
93,83,218300648,83064,Garéoult,5406,5307,99
93,83,218300655,83065,Gassin,2699,2642,57
93,83,218300663,83066,Ginasservis,1960,1930,30
93,83,218300671,83067,Gonfaron,4410,4352,58
93,83,218300689,83068,Grimaud,4671,4607,64
93,83,218300697,83069,Hyères,55528,54615,913
93,83,218300705,83070,Le Lavandou,6048,5980,68
93,83,218300713,83071,La Londe-les-Maures,11643,11493,150
93,83,218300721,83072,Lorgues,9589,9280,309
93,83,218300739,83073,Le Luc,11166,11058,108
93,83,218300747,83074,La Martre,211,210,1
93,83,218300754,83075,Les Mayons,632,625,7
93,83,218300762,83076,Mazaugues,885,873,12
93,83,218300770,83077,Méounes-lès-Montrieux,2246,2226,20
93,83,218300788,83078,Moissac-Bellevue,302,297,5
93,83,218300796,83079,La Môle,1498,1473,25
93,83,218300804,83080,Mons,817,802,15
93,83,218300812,83081,Montauroux,6730,6599,131
93,83,218300820,83082,Montferrat,1600,1591,9
93,83,218300838,83083,Montfort-sur-Argens,1483,1456,27
93,83,218300846,83084,Montmeyan,558,554,4
93,83,218300853,83085,La Motte,2944,2886,58
93,83,218300861,83086,Le Muy,9717,9468,249
93,83,218300879,83087,Nans-les-Pins,5002,4916,86
93,83,218300887,83088,Néoules,2956,2887,69
93,83,218300895,83089,Ollières,671,647,24
93,83,218300903,83090,Ollioules,14260,13991,269
93,83,218300911,83091,Pierrefeu-du-Var,6188,6083,105
93,83,218300929,83092,Pignans,4705,4658,47
93,83,218300937,83093,Plan-d'Aups-Sainte-Baume,2262,2235,27
93,83,218300945,83094,Le Plan-de-la-Tour,3100,3046,54
93,83,218300952,83095,Pontevès,746,727,19
93,83,218300960,83096,Pourcieux,1590,1570,20
93,83,218300978,83097,Pourrières,5431,5327,104
93,83,218300986,83098,Le Pradet,10656,10496,160
93,83,218300994,83099,Puget-sur-Argens,8173,8061,112
93,83,218301000,83100,Puget-Ville,4456,4409,47
93,83,218301018,83101,Ramatuelle,2071,2037,34
93,83,218301026,83102,Régusse,2607,2562,45
93,83,218301034,83103,Le Revest-les-Eaux,4071,4011,60
93,83,218301042,83104,Rians,4384,4301,83
93,83,218301059,83105,Riboux,51,51,0
93,83,218301067,83106,Rocbaron,5396,5323,73
93,83,218301075,83107,Roquebrune-sur-Argens,14522,14335,187
93,83,218301083,83108,La Roquebrussanne,2224,2184,40
93,83,218301091,83109,La Roque-Esclapon,250,248,2
93,83,218301109,83110,Rougiers,1699,1672,27
93,83,218301117,83111,Sainte-Anastasie-sur-Issole,2128,2102,26
93,83,218301125,83112,Saint-Cyr-sur-Mer,12303,12058,245
93,83,218301133,83113,Saint-Julien,2442,2401,41
93,83,218301141,83114,Saint-Martin-de-Pallières,251,247,4
93,83,218301158,83115,Sainte-Maxime,14954,14750,204
93,83,218301166,83116,Saint-Maximin-la-Sainte-Baume,18006,17468,538
93,83,218301174,83117,Saint-Paul-en-Forêt,1813,1770,43
93,83,218301182,83118,Saint-Raphaël,36460,35881,579
93,83,218301190,83119,Saint-Tropez,3669,3600,69
93,83,218301208,83120,Saint-Zacharie,6058,5985,73
93,83,218301216,83121,Salernes,3848,3771,77
93,83,218301224,83122,Les Salles-sur-Verdon,232,229,3
93,83,218301232,83123,Sanary-sur-Mer,17440,17173,267
93,83,218301240,83124,Seillans,2707,2674,33
93,83,218301257,83125,Seillons-Source-d'Argens,2565,2526,39
93,83,218301265,83126,La Seyne-sur-Mer,62999,62232,767
93,83,218301273,83127,Signes,3038,2992,46
93,83,218301281,83128,Sillans-la-Cascade,811,762,49
93,83,218301299,83129,Six-Fours-les-Plages,35890,35339,551
93,83,218301307,83130,Solliès-Pont,12158,11974,184
93,83,218301315,83131,Solliès-Toucas,5975,5867,108
93,83,218301323,83132,Solliès-Ville,2569,2523,46
93,83,218301331,83133,Tanneron,1707,1674,33
93,83,218301349,83134,Taradeau,1822,1791,31
93,83,218301356,83135,Tavernes,1444,1425,19
93,83,218301364,83136,Le Thoronet,2647,2598,49
93,83,218301372,83137,Toulon,181506,179659,1847
93,83,218301380,83138,Tourrettes,2928,2874,54
93,83,218301398,83139,Tourtour,601,587,14
93,83,218301406,83140,Tourves,5176,5101,75
93,83,218301414,83141,Trans-en-Provence,6119,5983,136
93,83,218301422,83142,Trigance,211,206,5
93,83,218301430,83143,Le Val,4380,4287,93
93,83,218301448,83144,La Valette-du-Var,24377,24114,263
93,83,218301455,83145,Varages,1180,1165,15
93,83,218301463,83146,La Verdière,1650,1628,22
93,83,218301471,83147,Vérignon,9,9,0
93,83,218301489,83148,Vidauban,12849,12693,156
93,83,218301497,83149,Villecroze,1511,1483,28
93,83,218301505,83150,Vinon-sur-Verdon,4381,4280,101
93,83,218301513,83151,Vins-sur-Caramy,952,937,15
93,83,218301521,83152,Rayol-Canadel-sur-Mer,659,646,13
93,83,218301539,83153,Saint-Mandrier-sur-Mer,6170,6100,70
93,83,218301547,83154,Saint-Antonin-du-Var,749,735,14
93,84,218400018,84001,Althen-des-Paluds,2869,2824,45
93,84,218400026,84002,Ansouis,1082,1058,24
93,84,218400034,84003,Apt,11116,10889,227
93,84,218400042,84004,Aubignan,5920,5825,95
93,84,218400059,84005,Aurel,192,190,2
93,84,218400067,84006,Auribeau,75,71,4
93,84,218400075,84007,Avignon,92277,90597,1680
93,84,218400083,84008,Le Barroux,688,653,35
93,84,218400091,84009,La Bastide-des-Jourdans,1748,1652,96
93,84,218400109,84010,La Bastidonne,907,883,24
93,84,218400117,84011,Le Beaucet,364,355,9
93,84,218400125,84012,Beaumes-de-Venise,2426,2379,47
93,84,218400133,84013,Beaumettes,297,293,4
93,84,218400141,84014,Beaumont-de-Pertuis,1146,1129,17
93,84,218400158,84015,Beaumont-du-Ventoux,309,304,5
93,84,218400166,84016,Bédarrides,5432,5358,74
93,84,218400174,84017,Bédoin,3157,3091,66
93,84,218400182,84018,Blauvac,545,535,10
93,84,218400190,84019,Bollène,14043,13830,213
93,84,218400208,84020,Bonnieux,1215,1190,25
93,84,218400216,84021,Brantes,89,89,0
93,84,218400224,84022,Buisson,278,267,11
93,84,218400232,84023,Buoux,99,96,3
93,84,218400240,84024,Cabrières-d'Aigues,973,959,14
93,84,218400257,84025,Cabrières-d'Avignon,1883,1845,38
93,84,218400265,84026,Cadenet,4297,4219,78
93,84,218400273,84027,Caderousse,2688,2639,49
93,84,218400281,84028,Cairanne,1110,1090,20
93,84,218400299,84029,Camaret-sur-Aigues,4636,4544,92
93,84,218400307,84030,Caromb,3505,3448,57
93,84,218400315,84031,Carpentras,30564,29865,699
93,84,218400323,84032,Caseneuve,511,503,8
93,84,218400331,84033,Castellet-en-Luberon,115,114,1
93,84,218400349,84034,Caumont-sur-Durance,5197,5094,103
93,84,218400356,84035,Cavaillon,26206,25832,374
93,84,218400364,84036,Châteauneuf-de-Gadagne,3452,3379,73
93,84,218400372,84037,Châteauneuf-du-Pape,2090,2061,29
93,84,218400380,84038,Cheval-Blanc,4373,4300,73
93,84,218400398,84039,Courthézon,6127,6049,78
93,84,218400406,84040,Crestet,441,425,16
93,84,218400414,84041,Crillon-le-Brave,492,479,13
93,84,218400422,84042,Cucuron,1810,1777,33
93,84,218400430,84043,Entraigues-sur-la-Sorgue,8729,8605,124
93,84,218400448,84044,Entrechaux,1171,1138,33
93,84,218400455,84045,Faucon,460,449,11
93,84,218400463,84046,Flassan,484,471,13
93,84,218400471,84047,Gargas,3115,3058,57
93,84,218400489,84048,Gignac,74,73,1
93,84,218400497,84049,Gigondas,443,432,11
93,84,218400505,84050,Gordes,1700,1666,34
93,84,218400513,84051,Goult,1118,1092,26
93,84,218400521,84052,Grambois,1253,1225,28
93,84,218400539,84053,Grillon,1788,1757,31
93,84,218400547,84054,L'Isle-sur-la-Sorgue,20531,20029,502
93,84,218400554,84055,Jonquerettes,1608,1571,37
93,84,218400562,84056,Jonquières,5452,5384,68
93,84,218400570,84057,Joucas,355,351,4
93,84,218400588,84058,Lacoste,432,424,8
93,84,218400596,84059,Lafare,123,122,1
93,84,218400604,84060,Lagarde-d'Apt,31,30,1
93,84,218400612,84061,Lagarde-Paréol,337,325,12
93,84,218400620,84062,Lagnes,1671,1638,33
93,84,218400638,84063,Lamotte-du-Rhône,395,394,1
93,84,218400646,84064,Lapalud,3921,3842,79
93,84,218400653,84065,Lauris,3961,3890,71
93,84,218400661,84066,Lioux,293,289,4
93,84,218400679,84067,Loriol-du-Comtat,2541,2488,53
93,84,218400687,84068,Lourmarin,1063,1042,21
93,84,218400695,84069,Malaucène,2794,2736,58
93,84,218400703,84070,Malemort-du-Comtat,1943,1919,24
93,84,218400711,84071,Maubec,1961,1914,47
93,84,218400729,84072,Mazan,6395,6235,160
93,84,218400737,84073,Ménerbes,1014,992,22
93,84,218400745,84074,Mérindol,2270,2232,38
93,84,218400752,84075,Méthamis,454,446,8
93,84,218400760,84076,Mirabeau,1431,1389,42
93,84,218400778,84077,Modène,474,467,7
93,84,218400786,84078,Mondragon,3771,3708,63
93,84,218400794,84079,Monieux,286,279,7
93,84,218400802,84080,Monteux,13206,12979,227
93,84,218400810,84081,Morières-lès-Avignon,8978,8848,130
93,84,218400828,84082,Mormoiron,1916,1869,47
93,84,218400836,84083,Mornas,2497,2450,47
93,84,218400844,84084,La Motte-d'Aigues,1419,1378,41
93,84,218400851,84085,Murs,424,418,6
93,84,218400869,84086,Oppède,1321,1292,29
93,84,218400877,84087,Orange,29103,28454,649
93,84,218400885,84088,Pernes-les-Fontaines,10578,10294,284
93,84,218400893,84089,Pertuis,20767,20498,269
93,84,218400901,84090,Peypin-d'Aigues,687,673,14
93,84,218400919,84091,Piolenc,5560,5465,95
93,84,218400927,84092,Le Pontet,17146,17018,128
93,84,218400935,84093,Puget,874,852,22
93,84,218400943,84094,Puyméras,594,583,11
93,84,218400950,84095,Puyvert,836,823,13
93,84,218400968,84096,Rasteau,815,795,20
93,84,218400976,84097,Richerenches,617,536,81
93,84,218400984,84098,Roaix,635,626,9
93,84,218400992,84099,Robion,4773,4688,85
93,84,218401008,84100,La Roque-Alric,54,54,0
93,84,218401016,84101,La Roque-sur-Pernes,430,417,13
93,84,218401024,84102,Roussillon,1321,1290,31
93,84,218401032,84103,Rustrel,690,670,20
93,84,218401040,84104,Sablet,1415,1381,34
93,84,218401057,84105,Saignon,947,925,22
93,84,218401065,84106,Sainte-Cécile-les-Vignes,2686,2634,52
93,84,218401073,84107,Saint-Christol,1449,1429,20
93,84,218401081,84108,Saint-Didier,2097,2060,37
93,84,218401099,84109,Saint-Hippolyte-le-Graveyron,178,169,9
93,84,218401107,84110,Saint-Léger-du-Ventoux,31,31,0
93,84,218401115,84111,Saint-Marcellin-lès-Vaison,346,335,11
93,84,218401123,84112,Saint-Martin-de-Castillon,708,702,6
93,84,218401131,84113,Saint-Martin-de-la-Brasque,839,822,17
93,84,218401149,84114,Saint-Pantaléon,197,194,3
93,84,218401156,84115,Saint-Pierre-de-Vassols,513,501,12
93,84,218401164,84116,Saint-Romain-en-Viennois,820,808,12
93,84,218401172,84117,Saint-Roman-de-Malegarde,340,333,7
93,84,218401180,84118,Saint-Saturnin-lès-Apt,2985,2910,75
93,84,218401198,84119,Saint-Saturnin-lès-Avignon,5109,5027,82
93,84,218401206,84120,Saint-Trinit,121,120,1
93,84,218401214,84121,Sannes,278,278,0
93,84,218401222,84122,Sarrians,6114,6030,84
93,84,218401230,84123,Sault,1378,1356,22
93,84,218401248,84124,Saumane-de-Vaucluse,941,926,15
93,84,218401255,84125,Savoillan,59,59,0
93,84,218401263,84126,Séguret,847,830,17
93,84,218401271,84127,Sérignan-du-Comtat,2934,2856,78
93,84,218401289,84128,Sivergues,47,46,1
93,84,218401297,84129,Sorgues,19176,18930,246
93,84,218401305,84130,Suzette,114,111,3
93,84,218401313,84131,Taillades,1957,1917,40
93,84,218401321,84132,Le Thor,9063,8883,180
93,84,218401339,84133,La Tour-d'Aigues,4466,4327,139
93,84,218401347,84134,Travaillan,725,712,13
93,84,218401354,84135,Uchaux,1724,1674,50
93,84,218401362,84136,Vacqueyras,1237,1206,31
93,84,218401370,84137,Vaison-la-Romaine,6019,5892,127
93,84,218401388,84138,Valréas,9616,9381,235
93,84,218401396,84139,Fontaine-de-Vaucluse,589,573,16
93,84,218401404,84140,Vaugines,572,553,19
93,84,218401412,84141,Vedène,11780,11423,357
93,84,218401420,84142,Velleron,3101,3030,71
93,84,218401438,84143,Venasque,1054,1032,22
93,84,218401446,84144,Viens,651,635,16
93,84,218401453,84145,Villars,793,779,14
93,84,218401461,84146,Villedieu,497,483,14
93,84,218401479,84147,Villelaure,3377,3295,82
93,84,218401487,84148,Villes-sur-Auzon,1305,1273,32
93,84,218401495,84149,Violès,1756,1727,29
93,84,218401503,84150,Visan,1962,1929,33
93,84,218401511,84151,Vitrolles-en-Lubéron,169,162,7
52,85,200096832,85001,L'Aiguillon-la-Presqu'île,2789,2745,44
52,85,218500023,85002,L'Aiguillon-sur-Vie,2091,2067,24
52,85,218500031,85003,Aizenay,10270,10067,203
52,85,218500049,85004,Angles,2941,2905,36
52,85,218500056,85005,Antigny,1072,1051,21
52,85,218500064,85006,Apremont,1880,1867,13
52,85,200057792,85008,Aubigny-Les Clouzeaux,7146,7040,106
52,85,200063956,85009,Auchay-sur-Vendée,1170,1149,21
52,85,218500106,85010,Avrillé,1442,1424,18
52,85,218500114,85011,Barbâtre,1771,1721,50
52,85,218500122,85012,La Barre-de-Monts,2280,2240,40
52,85,218500130,85013,Bazoges-en-Paillers,1509,1481,28
52,85,218500148,85014,Bazoges-en-Pareds,1172,1145,27
52,85,218500155,85015,Beaufou,1588,1565,23
52,85,218500163,85016,Beaulieu-sous-la-Roche,2305,2275,30
52,85,218500171,85017,Beaurepaire,2495,2446,49
52,85,218500189,85018,Beauvoir-sur-Mer,3950,3887,63
52,85,200057701,85019,Bellevigny,6320,6193,127
52,85,218500205,85020,Benet,4124,4047,77
52,85,218500213,85021,La Bernardière,1911,1877,34
52,85,218500221,85022,Le Bernard,1284,1266,18
52,85,218500239,85023,Bessay,449,440,9
52,85,218500247,85024,Bois-de-Céné,2132,2103,29
52,85,218500254,85025,La Boissière-de-Montaigu,2328,2276,52
52,85,218500262,85026,La Boissière-des-Landes,1451,1432,19
52,85,218500288,85028,Bouillé-Courdault,603,593,10
52,85,218500296,85029,Bouin,2190,2155,35
52,85,218500312,85031,Le Boupère,3275,3208,67
52,85,218500338,85033,Bourneau,746,728,18
52,85,218500346,85034,Bournezeau,3529,3431,98
52,85,218500353,85035,Bretignolles-sur-Mer,5180,5093,87
52,85,218500361,85036,La Bretonnière-la-Claye,595,578,17
52,85,218500387,85038,Les Brouzils,2927,2883,44
52,85,218500395,85039,La Bruffière,4136,4074,62
52,85,218500403,85040,La Caillère-Saint-Hilaire,1133,1113,20
52,85,218500411,85041,Cezais,308,296,12
52,85,218500429,85042,Chaillé-les-Marais,1908,1884,24
52,85,218500452,85045,La Chaize-Giraud,1109,1095,14
52,85,218500460,85046,La Chaize-le-Vicomte,3897,3838,59
52,85,218500478,85047,Challans,22690,21900,790
52,85,218500494,85049,Champagné-les-Marais,1818,1797,21
52,85,218500502,85050,Le Champ-Saint-Père,1874,1852,22
52,85,218500510,85051,Chantonnay,8927,8434,493
52,85,218500544,85054,La Chapelle-Hermier,972,961,11
52,85,218500551,85055,La Chapelle-Palluau,1019,992,27
52,85,218500569,85056,La Chapelle-Thémer,398,389,9
52,85,218500585,85058,Chasnais,778,757,21
52,85,218500593,85059,La Châtaigneraie,2638,2601,37
52,85,218500619,85061,Château-Guibert,1540,1506,34
52,85,218500627,85062,Châteauneuf,1138,1118,20
52,85,218500643,85064,Chauché,2520,2485,35
52,85,218500650,85065,Chavagnes-en-Paillers,3674,3572,102
52,85,218500668,85066,Chavagnes-les-Redoux,846,829,17
52,85,218500676,85067,Cheffois,1023,1002,21
52,85,218500700,85070,Coëx,3377,3339,38
52,85,218500718,85071,Commequiers,3716,3657,59
52,85,218500726,85072,La Copechagnière,1057,1046,11
52,85,218500734,85073,Corpe,1033,1015,18
52,85,218500742,85074,La Couture,228,225,3
52,85,218500767,85076,Cugand,3721,3633,88
52,85,218500775,85077,Curzon,531,523,8
52,85,218500783,85078,Damvix,752,735,17
52,85,200057677,85080,Doix lès Fontaines,1773,1740,33
52,85,218500817,85081,Dompierre-sur-Yon,4511,4394,117
52,85,218500825,85082,Les Epesses,2997,2941,56
52,85,218500833,85083,L'Épine,1683,1644,39
52,85,200054260,85084,Essarts en Bocage,9464,9300,164
52,85,218500866,85086,Falleron,1682,1667,15
52,85,218500874,85087,Faymoreau,201,197,4
52,85,218500882,85088,Le Fenouiller,5025,4897,128
52,85,218500890,85089,La Ferrière,5520,5363,157
52,85,200059079,85090,Sèvremont,6672,6417,255
52,85,218500924,85092,Fontenay-le-Comte,13828,13138,690
52,85,218500932,85093,Fougeré,1250,1230,20
52,85,218500940,85094,Foussais-Payré,1205,1173,32
52,85,218500957,85095,Froidfond,1989,1969,20
52,85,218500965,85096,La Garnache,5326,5220,106
52,85,218500973,85097,La Gaubretière,3183,3117,66
52,85,218500981,85098,La Genétouze,2016,1977,39
52,85,218500999,85099,Le Girouard,1141,1120,21
52,85,218501005,85100,Givrand,2288,2236,52
52,85,218501013,85101,Le Givre,492,487,5
52,85,218501021,85102,Grand'Landes,708,700,8
52,85,218501039,85103,Grosbreuil,2264,2225,39
52,85,218501047,85104,Grues,906,897,9
52,85,218501054,85105,Le Gué-de-Velluire,543,527,16
52,85,218501062,85106,La Guérinière,1367,1331,36
52,85,218501088,85108,L'Herbergement,3454,3344,110
52,85,218501096,85109,Les Herbiers,16801,16266,535
52,85,218501104,85110,L'Hermenault,936,923,13
52,85,218501112,85111,L'Île-d'Elle,1529,1506,23
52,85,218501120,85112,L'Île-d'Olonne,2885,2826,59
52,85,218501138,85113,L'Île-d'Yeu,5008,4870,138
52,85,218501146,85114,Jard-sur-Mer,2701,2670,31
52,85,218501153,85115,La Jaudonnière,612,600,12
52,85,218501161,85116,La Jonchère,471,463,8
52,85,218501179,85117,Lairoux,625,616,9
52,85,218501187,85118,Landeronde,2382,2336,46
52,85,218501195,85119,Les Landes-Genusson,2473,2431,42
52,85,218501203,85120,Landevieille,1517,1479,38
52,85,218501211,85121,Le Langon,1031,1012,19
52,85,218501237,85123,Liez,288,284,4
52,85,218501252,85125,Loge-Fougereuse,406,402,4
52,85,218501260,85126,Longèves,1384,1334,50
52,85,218501278,85127,Longeville-sur-Mer,2437,2412,25
52,85,218501286,85128,Luçon,9918,9541,377
52,85,218501294,85129,Les Lucs-sur-Boulogne,3654,3580,74
52,85,218501302,85130,Maché,1620,1601,19
52,85,218501310,85131,Les Magnils-Reigniers,1523,1484,39
52,85,218501328,85132,Maillé,762,751,11
52,85,218501336,85133,Maillezais,929,906,23
52,85,218501344,85134,Mallièvre,251,242,9
52,85,218501351,85135,Mareuil-sur-Lay-Dissais,2910,2789,121
52,85,218501369,85136,Marillet,123,123,0
52,85,218501377,85137,Marsais-Sainte-Radégonde,486,472,14
52,85,218501385,85138,Martinet,1195,1183,12
52,85,218501393,85139,Le Mazeau,458,443,15
52,85,218501401,85140,La Meilleraie-Tillay,1529,1498,31
52,85,218501419,85141,Menomblet,689,677,12
52,85,218501427,85142,La Merlatière,1028,1013,15
52,85,218501435,85143,Mervent,1075,1057,18
52,85,218501443,85144,Mesnard-la-Barotière,1565,1538,27
52,85,218501450,85145,Monsireigne,984,967,17
52,85,200081115,85146,Montaigu-Vendée,21206,20578,628
52,85,218501476,85147,Montournais,1680,1630,50
52,85,218501484,85148,Montreuil,845,822,23
52,85,218501492,85149,Moreilles,415,410,5
52,85,218501518,85151,Mortagne-sur-Sèvre,6199,6063,136
52,85,200065795,85152,Les Achards,5445,5331,114
52,85,218501534,85153,Mouchamps,2966,2923,43
52,85,200057628,85154,Mouilleron-Saint-Germain,1876,1786,90
52,85,218501559,85155,Mouilleron-le-Captif,5121,4996,125
52,85,218501567,85156,Moutiers-les-Mauxfaits,2293,2255,38
52,85,218501575,85157,Moutiers-sur-le-Lay,794,782,12
52,85,218501583,85158,Mouzeuil-Saint-Martin,1216,1190,26
52,85,218501591,85159,Nalliers,2366,2333,33
52,85,218501609,85160,Nesmy,3005,2961,44
52,85,218501617,85161,Nieul-le-Dolent,2561,2525,36
52,85,200085546,85162,Rives-d'Autise,2143,2082,61
52,85,218501633,85163,Noirmoutier-en-l'Île,4588,4486,102
52,85,218501641,85164,Notre-Dame-de-Monts,2206,2158,48
52,85,218501674,85167,L'Orbrie,805,788,17
52,85,218501690,85169,Palluau,1123,1106,17
52,85,218501716,85171,Péault,634,611,23
52,85,218501724,85172,Le Perrier,2102,2068,34
52,85,218501740,85174,Petosse,699,681,18
52,85,218501757,85175,Les Pineaux,663,658,5
52,85,218501765,85176,Pissotte,1199,1164,35
52,85,200082147,85177,Les Velluire-sur-Vendée,1408,1377,31
52,85,218501781,85178,Le Poiré-sur-Vie,8886,8616,270
52,85,218501799,85179,Poiroux,1204,1192,12
52,85,218501815,85181,Pouillé,658,641,17
52,85,218501823,85182,Pouzauges,5764,5565,199
52,85,218501849,85184,Puy-de-Serre,331,324,7
52,85,218501856,85185,Puyravault,659,653,6
52,85,218501864,85186,La Rabatelière,1024,1007,17
52,85,218501872,85187,Réaumur,877,862,15
52,85,218501880,85188,La Réorthe,1128,1114,14
52,85,218501898,85189,Notre-Dame-de-Riez,2207,2162,45
52,85,218501906,85190,Rocheservière,3530,3467,63
52,85,218501914,85191,La Roche-sur-Yon,58168,55213,2955
52,85,218501922,85192,Rochetrejoux,1003,986,17
52,85,218501930,85193,Rosnay,669,652,17
52,85,200082139,85194,Les Sables-d'Olonne,48401,46941,1460
52,85,218501963,85196,Saint-André-Goule-d'Oie,1932,1916,16
52,85,200058386,85197,Montréverd,3850,3790,60
52,85,218501989,85198,Saint-Aubin-des-Ormeaux,1387,1369,18
52,85,218501997,85199,Saint-Aubin-la-Plaine,546,542,4
52,85,218502003,85200,Saint-Avaugourd-des-Landes,1124,1106,18
52,85,218502011,85201,Saint-Benoist-sur-Mer,506,500,6
52,85,218502029,85202,Sainte-Cécile,1701,1588,113
52,85,218502045,85204,Saint-Christophe-du-Ligneron,2664,2620,44
52,85,218502052,85205,Saint-Cyr-des-Gâts,547,539,8
52,85,218502060,85206,Saint-Cyr-en-Talmondais,415,402,13
52,85,218502078,85207,Saint-Denis-du-Payré,400,391,9
52,85,218502086,85208,Saint-Denis-la-Chevasse,2432,2392,40
52,85,218502094,85209,Saint-Étienne-de-Brillouet,643,632,11
52,85,218502102,85210,Saint-Étienne-du-Bois,2168,2144,24
52,85,218502110,85211,Sainte-Flaive-des-Loups,2514,2490,24
52,85,200059962,85213,Rives de l'Yon,4410,4238,172
52,85,218502144,85214,Sainte-Foy,2470,2422,48
52,85,218502151,85215,Saint-Fulgent,3976,3839,137
52,85,218502169,85216,Sainte-Gemme-la-Plaine,2291,2077,214
52,85,218502185,85218,Saint-Georges-de-Pointindoux,1735,1721,14
52,85,218502201,85220,Saint-Germain-de-Prinçay,1626,1600,26
52,85,218502219,85221,Saint-Gervais,2732,2694,38
52,85,218502227,85222,Saint-Gilles-Croix-de-Vie,8170,7922,248
52,85,218502235,85223,Sainte-Hermine,3008,2949,59
52,85,218502268,85226,Saint-Hilaire-de-Riez,12382,12137,245
52,85,218502276,85227,Saint-Hilaire-des-Loges,1963,1911,52
52,85,218502292,85229,Saint-Hilaire-de-Voust,592,580,12
52,85,218502318,85231,Saint-Hilaire-la-Forêt,814,799,15
52,85,218502326,85232,Saint-Hilaire-le-Vouhis,1118,1094,24
52,85,218502334,85233,Saint-Jean-de-Beugné,623,613,10
52,85,218502342,85234,Saint-Jean-de-Monts,8954,8725,229
52,85,218502359,85235,Saint-Juire-Champgillon,441,428,13
52,85,218502367,85236,Saint-Julien-des-Landes,1951,1926,25
52,85,218502375,85237,Saint-Laurent-de-la-Salle,399,389,10
52,85,218502383,85238,Saint-Laurent-sur-Sèvre,4167,3724,443
52,85,218502391,85239,Saint-Maixent-sur-Vie,1154,1149,5
52,85,218502409,85240,Saint-Malô-du-Bois,1669,1616,53
52,85,218502425,85242,Saint-Mars-la-Réorthe,1029,1009,20
52,85,218502433,85243,Brem-sur-Mer,2903,2855,48
52,85,218502441,85244,Saint-Martin-de-Fraigneau,878,820,58
52,85,218502458,85245,Saint-Martin-des-Fontaines,172,170,2
52,85,218502466,85246,Saint-Martin-des-Noyers,2551,2512,39
52,85,218502474,85247,Saint-Martin-des-Tilleuls,1113,1095,18
52,85,218502482,85248,Saint-Martin-Lars-en-Sainte-Hermine,432,420,12
52,85,218502508,85250,Saint-Mathurin,2374,2340,34
52,85,218502516,85251,Saint-Maurice-des-Noues,647,628,19
52,85,218502524,85252,Saint-Maurice-le-Girard,618,594,24
52,85,218502540,85254,Saint-Mesmin,1793,1750,43
52,85,218502557,85255,Saint-Michel-en-l'Herm,2419,2339,80
52,85,218502565,85256,Saint-Michel-le-Cloucq,1315,1283,32
52,85,218502599,85259,Saint-Paul-en-Pareds,1359,1324,35
52,85,218502607,85260,Saint-Paul-Mont-Penit,841,831,10
52,85,218502615,85261,Sainte-Pexine,296,284,12
52,85,218502623,85262,Saint-Philbert-de-Bouaine,3605,3565,40
52,85,218502649,85264,Saint-Pierre-du-Chemin,1348,1330,18
52,85,218502656,85265,Saint-Pierre-le-Vieux,951,930,21
52,85,218502664,85266,Saint-Prouant,1709,1680,29
52,85,218502672,85267,Sainte-Radégonde-des-Noyers,973,952,21
52,85,218502680,85268,Saint-Révérend,1503,1472,31
52,85,218502698,85269,Saint-Sigismond,428,421,7
52,85,218502714,85271,Saint-Sulpice-en-Pareds,448,435,13
52,85,218502730,85273,Saint-Urbain,1951,1916,35
52,85,218502748,85274,Saint-Valérien,546,533,13
52,85,218502763,85276,Saint-Vincent-Sterlanges,759,746,13
52,85,218502771,85277,Saint-Vincent-sur-Graon,1579,1554,25
52,85,218502789,85278,Saint-Vincent-sur-Jard,1345,1324,21
52,85,218502805,85280,Sallertaine,3304,3232,72
52,85,218502813,85281,Sérigné,1030,999,31
52,85,218502821,85282,Sigournais,928,914,14
52,85,218502847,85284,Soullans,4392,4297,95
52,85,218502854,85285,Le Tablier,763,748,15
52,85,218502862,85286,La Taillée,556,551,5
52,85,218502870,85287,Tallud-Sainte-Gemme,461,453,8
52,85,218502888,85288,Talmont-Saint-Hilaire,8119,7933,186
52,85,200099489,85289,Terval,2215,2170,45
52,85,218502904,85290,Thiré,557,544,13
52,85,218502912,85291,Thorigny,1254,1235,19
52,85,218502920,85292,Thouarsais-Bouildroux,787,778,9
52,85,218502938,85293,Tiffauges,1619,1581,38
52,85,218502946,85294,La Tranche-sur-Mer,3040,2980,60
52,85,218502953,85295,Treize-Septiers,3362,3281,81
52,85,218502961,85296,Treize-Vents,1271,1247,24
52,85,218502979,85297,Triaize,1023,1011,12
52,85,218502987,85298,Vairé,1835,1814,21
52,85,218503001,85300,Venansault,4878,4698,180
52,85,218503019,85301,Vendrennes,1825,1779,46
52,85,200085009,85302,Chanverrie,5603,5468,135
52,85,218503035,85303,Vix,1849,1821,28
52,85,218503043,85304,Vouillé-les-Marais,765,755,10
52,85,218503050,85305,Vouvant,912,846,66
52,85,218503068,85306,Xanton-Chassenon,742,733,9
75,86,218600013,86001,Adriers,719,711,8
75,86,218600021,86002,Amberre,589,575,14
75,86,218600039,86003,Anché,347,340,7
75,86,218600047,86004,Angles-sur-l'Anglin,358,345,13
75,86,218600054,86005,Angliers,634,612,22
75,86,218600062,86006,Antigny,558,541,17
75,86,218600070,86007,Antran,1190,1157,33
75,86,218600088,86008,Arçay,344,337,7
75,86,218600096,86009,Archigny,1078,1063,15
75,86,218600104,86010,Aslonnes,1136,1115,21
75,86,218600112,86011,Asnières-sur-Blour,184,180,4
75,86,218600120,86012,Asnois,157,153,4
75,86,218600138,86013,Aulnay,99,96,3
75,86,218600146,86014,Availles-en-Châtellerault,1780,1740,40
75,86,218600153,86015,Availles-Limouzine,1262,1237,25
75,86,218600161,86016,Avanton,2252,2213,39
75,86,218600179,86017,Ayron,1112,1096,16
75,86,218600187,86018,Basses,324,322,2
75,86,200064533,86019,Beaumont Saint-Cyr,2994,2954,40
75,86,218600203,86020,Bellefonds,256,252,4
75,86,218600229,86022,Berrie,258,254,4
75,86,218600237,86023,Berthegon,273,267,6
75,86,218600245,86024,Béruges,1586,1561,25
75,86,218600252,86025,Béthines,480,475,5
75,86,218600260,86026,Beuxes,548,543,5
75,86,218600278,86027,Biard,1898,1860,38
75,86,218600286,86028,Bignoux,1090,1072,18
75,86,218600294,86029,Blanzay,812,789,23
75,86,218600310,86031,Bonnes,1739,1715,24
75,86,218600328,86032,Bonneuil-Matours,2184,2091,93
75,86,218600344,86034,Bouresse,620,607,13
75,86,218600351,86035,Bourg-Archambault,181,180,1
75,86,218600369,86036,Bournand,917,897,20
75,86,218600377,86037,Brigueil-le-Chantre,498,491,7
75,86,218600385,86038,Brion,223,215,8
75,86,218600393,86039,Brux,750,740,10
75,86,218600401,86040,La Bussière,321,310,11
75,86,218600419,86041,Buxerolles,10127,10001,126
75,86,218600427,86042,Buxeuil,924,913,11
75,86,218600443,86044,Ceaux-en-Loudun,557,546,11
75,86,218600450,86045,Celle-Lévescault,1369,1352,17
75,86,218600468,86046,Cenon-sur-Vienne,1746,1720,26
75,86,218600476,86047,Cernay,502,488,14
75,86,218600484,86048,Chabournay,1206,1188,18
75,86,218600492,86049,Chalais,510,494,16
75,86,218600500,86050,Chalandray,857,844,13
75,86,218600518,86051,Champagné-le-Sec,204,202,2
75,86,218600526,86052,Champagné-Saint-Hilaire,1011,992,19
75,86,200063428,86053,Champigny en Rochereau,1983,1938,45
75,86,218600542,86054,Champniers,359,353,6
75,86,218600559,86055,La Chapelle-Bâton,363,354,9
75,86,218600583,86058,La Chapelle-Moulière,748,728,20
75,86,218600591,86059,Chapelle-Viviers,594,590,4
75,86,218600617,86061,Charroux,1119,1099,20
75,86,218600625,86062,Chasseneuil-du-Poitou,4748,4699,49
75,86,218600633,86063,Chatain,250,247,3
75,86,218600641,86064,Château-Garnier,622,612,10
75,86,218600658,86065,Château-Larcher,1065,1048,17
75,86,218600666,86066,Châtellerault,32345,31573,772
75,86,218600682,86068,Chaunay,1237,1216,21
75,86,218600690,86069,La Chaussée,183,182,1
75,86,218600708,86070,Chauvigny,7198,7084,114
75,86,218600724,86072,Chenevelles,462,451,11
75,86,218600732,86073,Cherves,534,523,11
75,86,218600740,86074,Chiré-en-Montreuil,936,921,15
75,86,218600757,86075,Chouppes,777,766,11
75,86,218600765,86076,Cissé,2898,2849,49
75,86,218600773,86077,Civaux,1225,1208,17
75,86,218600781,86078,Civray,2708,2574,134
75,86,218600799,86079,La Roche-Rigault,595,559,36
75,86,218600807,86080,Cloué,501,496,5
75,86,218600815,86081,Colombiers,1456,1428,28
75,86,200084861,86082,Valence-en-Poitou,4541,4412,129
75,86,218600831,86083,Coulombiers,1144,1131,13
75,86,218600849,86084,Coulonges,238,234,4
75,86,218600856,86085,Coussay,256,248,8
75,86,218600864,86086,Coussay-les-Bois,946,929,17
75,86,218600872,86087,Craon,186,183,3
75,86,218600880,86088,Croutelle,902,889,13
75,86,218600898,86089,Cuhon,395,389,6
75,86,218600906,86090,Curçay-sur-Dive,218,217,1
75,86,218600914,86091,Curzay-sur-Vonne,390,383,7
75,86,218600922,86092,Dangé-Saint-Romain,3018,2963,55
75,86,218600930,86093,Dercé,162,159,3
75,86,218600948,86094,Dienné,593,581,12
75,86,218600955,86095,Dissay,3314,3264,50
75,86,218600963,86096,Doussay,668,660,8
75,86,218600971,86097,La Ferrière-Airoux,336,331,5
75,86,218600989,86098,Fleix,146,144,2
75,86,218600997,86099,Fleuré,1059,1051,8
75,86,218601003,86100,Fontaine-le-Comte,4046,3971,75
75,86,218601029,86102,Frozes,601,593,8
75,86,218601037,86103,Gençay,1807,1743,64
75,86,218601045,86104,Genouillé,499,494,5
75,86,218601052,86105,Gizay,364,363,1
75,86,218601060,86106,Glénouze,98,96,2
75,86,218601078,86107,Gouex,475,467,8
75,86,218601086,86108,La Grimaudière,412,405,7
75,86,218601094,86109,Guesnes,227,219,8
75,86,218601102,86110,Haims,234,230,4
75,86,218601110,86111,Ingrandes,1792,1724,68
75,86,218601128,86112,L'Isle-Jourdain,1180,1169,11
75,86,218601136,86113,Iteuil,3029,2974,55
75,86,218601144,86114,Jardres,1298,1269,29
75,86,200063493,86115,Jaunay-Marigny,7919,7664,255
75,86,218601169,86116,Jazeneuil,810,788,22
75,86,218601177,86117,Jouhet,533,526,7
75,86,218601185,86118,Journet,380,371,9
75,86,218601193,86119,Joussé,306,305,1
75,86,218601201,86120,Lathus-Saint-Rémy,1232,1217,15
75,86,218601219,86121,Latillé,1489,1460,29
75,86,218601227,86122,Lauthiers,69,67,2
75,86,200082766,86123,Boivre-la-Vallée,3131,3079,52
75,86,218601243,86124,Lavoux,1198,1183,15
75,86,218601250,86125,Leigné-les-Bois,608,595,13
75,86,218601268,86126,Leignes-sur-Fontaine,660,647,13
75,86,218601276,86127,Leigné-sur-Usseau,465,462,3
75,86,218601284,86128,Lencloître,2513,2474,39
75,86,218601292,86129,Lésigny,530,522,8
75,86,218601300,86130,Leugny,381,378,3
75,86,218601318,86131,Lhommaizé,916,892,24
75,86,218601326,86132,Liglet,312,309,3
75,86,218601334,86133,Ligugé,3452,3394,58
75,86,218601342,86134,Linazay,219,219,0
75,86,218601359,86135,Liniers,591,577,14
75,86,218601367,86136,Lizant,395,387,8
75,86,218601375,86137,Loudun,7052,6702,350
75,86,218601383,86138,Luchapt,254,251,3
75,86,218601391,86139,Lusignan,2680,2622,58
75,86,218601409,86140,Lussac-les-Châteaux,2318,2271,47
75,86,218601417,86141,Magné,686,672,14
75,86,218601425,86142,Maillé,652,640,12
75,86,218601433,86143,Mairé,179,175,4
75,86,218601441,86144,Maisonneuve,329,322,7
75,86,218601458,86145,Marçay,1218,1192,26
75,86,218601474,86147,Marigny-Chemereau,612,604,8
75,86,218601482,86148,Marnay,725,713,12
75,86,218601490,86149,Martaizé,381,371,10
75,86,218601508,86150,Massognes,276,269,7
75,86,218601516,86151,Maulay,179,172,7
75,86,218601524,86152,Mauprévoir,594,579,15
75,86,218601532,86153,Mazerolles,878,865,13
75,86,218601540,86154,Mazeuil,259,257,2
75,86,218601565,86156,Messemé,244,239,5
75,86,218601573,86157,Mignaloux-Beauvoir,5209,5031,178
75,86,218601581,86158,Migné-Auxances,6298,6183,115
75,86,218601599,86159,Millac,528,524,4
75,86,218601607,86160,Mirebeau,2180,2147,33
75,86,218601615,86161,Moncontour,1011,993,18
75,86,218601623,86162,Mondion,113,112,1
75,86,218601631,86163,Montamisé,3752,3685,67
75,86,218601649,86164,Monthoiron,672,667,5
75,86,218601656,86165,Montmorillon,6372,5914,458
75,86,218601672,86167,Monts-sur-Guesnes,922,916,6
75,86,218601698,86169,Morton,364,359,5
75,86,218601706,86170,Moulismes,379,367,12
75,86,218601714,86171,Moussac,451,437,14
75,86,218601722,86172,Mouterre-sur-Blourde,164,160,4
75,86,218601730,86173,Mouterre-Silly,672,659,13
75,86,218601748,86174,Naintré,6049,5933,116
75,86,218601755,86175,Nalliers,320,308,12
75,86,218601763,86176,Nérignac,128,123,5
75,86,218601771,86177,Neuville-de-Poitou,5459,5376,83
75,86,218601789,86178,Nieuil-l'Espoir,2816,2777,39
75,86,218601805,86180,Nouaillé-Maupertuis,2947,2895,52
75,86,218601813,86181,Nueil-sous-Faye,221,212,9
75,86,218601821,86182,Orches,370,362,8
75,86,218601839,86183,Les Ormes,1631,1611,20
75,86,218601847,86184,Ouzilly,961,949,12
75,86,218601862,86186,Oyré,974,956,18
75,86,218601870,86187,Paizay-le-Sec,474,461,13
75,86,218601896,86189,Payroux,474,468,6
75,86,218601904,86190,Persac,733,720,13
75,86,218601912,86191,Pindray,251,246,5
75,86,218601920,86192,Plaisance,179,176,3
75,86,218601938,86193,Pleumartin,1215,1203,12
75,86,218601946,86194,Poitiers,92296,90033,2263
75,86,218601953,86195,Port-de-Piles,570,563,7
75,86,218601961,86196,Pouançay,237,233,4
75,86,218601979,86197,Pouant,430,418,12
75,86,218601987,86198,Pouillé,718,709,9
75,86,218602001,86200,Pressac,573,561,12
75,86,218602019,86201,Prinçay,211,209,2
75,86,218602027,86202,La Puye,609,600,9
75,86,218602035,86203,Queaux,560,549,11
75,86,218602043,86204,Quinçay,2187,2132,55
75,86,218602050,86205,Ranton,207,204,3
75,86,218602068,86206,Raslay,141,137,4
75,86,218602076,86207,La Roche-Posay,1601,1569,32
75,86,218602092,86209,Roches-Prémarie-Andillé,2105,2071,34
75,86,218602100,86210,Roiffé,770,750,20
75,86,218602118,86211,Romagne,968,869,99
75,86,218602134,86213,Rouillé,2685,2498,187
75,86,218602142,86214,Saint-Benoît,7503,7308,195
75,86,218602175,86217,Saint-Christophe,295,284,11
75,86,218602183,86218,Saint-Clair,206,198,8
75,86,218602209,86220,Saint-Gaudent,321,313,8
75,86,218602217,86221,Saint-Genest-d'Ambière,1218,1197,21
75,86,218602225,86222,Saint-Georges-lès-Baillargeaux,4320,4265,55
75,86,218602233,86223,Saint-Germain,928,904,24
75,86,218602241,86224,Saint-Gervais-les-Trois-Clochers,1364,1333,31
75,86,218602258,86225,Saint-Jean-de-Sauves,1391,1369,22
75,86,218602266,86226,Saint-Julien-l'Ars,2888,2838,50
75,86,218602274,86227,Saint-Laon,139,135,4
75,86,218602282,86228,Saint-Laurent-de-Jourdes,202,199,3
75,86,218602290,86229,Saint-Léger-de-Montbrillais,345,340,5
75,86,218602308,86230,Saint-Léomer,173,170,3
75,86,218602316,86231,Saint-Macoux,498,481,17
75,86,218602332,86233,Valdivienne,2795,2753,42
75,86,218602340,86234,Saint-Martin-l'Ars,386,383,3
75,86,218602357,86235,Saint-Maurice-la-Clouère,1341,1305,36
75,86,218602365,86236,Saint-Pierre-de-Maillé,900,885,15
75,86,218602373,86237,Saint-Pierre-d'Exideuil,788,768,20
75,86,218602399,86239,Sainte-Radégonde,176,176,0
75,86,218602415,86241,Saint-Rémy-sur-Creuse,418,412,6
75,86,218602423,86242,Saint-Romain,400,393,7
75,86,218602449,86244,Saint-Sauvant,1297,1268,29
75,86,200054831,86245,Senillé-Saint-Sauveur,1795,1754,41
75,86,218602464,86246,Saint-Savin,833,817,16
75,86,218602472,86247,Saint-Saviol,548,535,13
75,86,218602480,86248,Saint-Secondin,553,536,17
75,86,218602498,86249,Saires,126,125,1
75,86,218602506,86250,Saix,294,289,5
75,86,218602522,86252,Sammarçolles,667,650,17
75,86,218602530,86253,Sanxay,560,549,11
75,86,218602548,86254,Saulgé,1011,1001,10
75,86,218602555,86255,Savigné,1328,1303,25
75,86,218602563,86256,Savigny-Lévescault,1233,1208,25
75,86,218602571,86257,Savigny-sous-Faye,374,369,5
75,86,218602589,86258,Scorbé-Clairvaux,2255,2209,46
75,86,218602605,86260,Sérigny,314,313,1
75,86,218602613,86261,Sèvres-Anxaumont,2332,2256,76
75,86,218602621,86262,Sillars,597,582,15
75,86,218602639,86263,Smarves,2957,2910,47
75,86,218602647,86264,Sommières-du-Clain,763,746,17
75,86,218602654,86265,Sossais,430,423,7
75,86,218602662,86266,Surin,137,136,1
75,86,218602688,86268,Tercé,1139,1124,15
75,86,218602696,86269,Ternay,193,190,3
75,86,218602704,86270,Thollet,158,155,3
75,86,218602712,86271,Thurageau,802,787,15
75,86,218602720,86272,Thuré,2989,2843,146
75,86,218602738,86273,La Trimouille,881,859,22
75,86,218602746,86274,Les Trois-Moutiers,1116,1091,25
75,86,218602753,86275,Usseau,609,600,9
75,86,218602761,86276,Usson-du-Poitou,1267,1245,22
75,86,218602795,86279,Vaux-sur-Vienne,552,540,12
75,86,218602803,86280,Vellèches,361,355,6
75,86,200082675,86281,Saint-Martin-la-Pallu,5680,5594,86
75,86,218602845,86284,Vernon,729,717,12
75,86,218602852,86285,Verrières,976,951,25
75,86,218602860,86286,Verrue,391,387,4
75,86,218602878,86287,Vézières,363,357,6
75,86,218602886,86288,Vicq-sur-Gartempe,634,625,9
75,86,218602894,86289,Le Vigeant,697,667,30
75,86,218602902,86290,La Villedieu-du-Clain,1569,1536,33
75,86,218602910,86291,Villemort,109,102,7
75,86,218602928,86292,Villiers,951,933,18
75,86,218602936,86293,Vivonne,4510,4437,73
75,86,218602944,86294,Vouillé,3751,3677,74
75,86,218602951,86295,Voulême,396,391,5
75,86,218602969,86296,Voulon,479,470,9
75,86,218602977,86297,Vouneuil-sous-Biard,6286,6142,144
75,86,218602985,86298,Vouneuil-sur-Vienne,2329,2284,45
75,86,218602993,86299,Vouzailles,581,572,9
75,86,218603009,86300,Yversay,622,617,5
75,87,218700102,87001,Aixe-sur-Vienne,5887,5809,78
75,87,218700201,87002,Ambazac,5625,5556,69
75,87,218700300,87003,Arnac-la-Poste,953,928,25
75,87,218700409,87004,Augne,116,114,2
75,87,218700508,87005,Aureil,1029,1009,20
75,87,218700607,87006,Azat-le-Ris,240,240,0
75,87,218700706,87007,Balledent,198,196,2
75,87,218700805,87008,La Bazeuge,148,148,0
75,87,218700904,87009,Beaumont-du-Lac,146,141,5
75,87,218701100,87011,Bellac,3744,3619,125
75,87,218701209,87012,Berneuil,445,440,5
75,87,218701308,87013,Bersac-sur-Rivalier,674,658,16
75,87,218701407,87014,Bessines-sur-Gartempe,2844,2787,57
75,87,218701506,87015,Beynac,782,711,71
75,87,218701605,87016,Les Billanges,292,287,5
75,87,218701704,87017,Blanzac,510,500,10
75,87,218701803,87018,Blond,717,693,24
75,87,218701902,87019,Boisseuil,2988,2925,63
75,87,218702009,87020,Bonnac-la-Côte,1682,1655,27
75,87,218702108,87021,Bosmie-l'Aiguille,2645,2612,33
75,87,218702207,87022,Breuilaufa,118,117,1
75,87,218702306,87023,Le Buis,191,187,4
75,87,218702405,87024,Bujaleuf,842,833,9
75,87,218702504,87025,Burgnac,865,853,12
75,87,218702702,87027,Bussière-Galant,1283,1268,15
75,87,200083657,87028,Val-d'Oire-et-Gartempe,1690,1669,21
75,87,218702900,87029,Les Cars,631,620,11
75,87,218703007,87030,Chaillac-sur-Vienne,1277,1254,23
75,87,218703106,87031,Le Chalard,311,307,4
75,87,218703205,87032,Châlus,1678,1647,31
75,87,218703304,87033,Chamboret,804,795,9
75,87,218703403,87034,Champagnac-la-Rivière,576,568,8
75,87,218703502,87035,Champnétery,529,520,9
75,87,218703601,87036,Champsac,684,674,10
75,87,218703700,87037,La Chapelle-Montbrandeix,265,263,2
75,87,218703809,87038,Chaptelat,2110,2093,17
75,87,218703908,87039,Château-Chervix,811,798,13
75,87,218704005,87040,Châteauneuf-la-Forêt,1542,1524,18
75,87,218704104,87041,Châteauponsac,2057,2036,21
75,87,218704203,87042,Le Châtenet-en-Dognon,390,384,6
75,87,218704302,87043,Cheissoux,218,217,1
75,87,218704401,87044,Chéronnac,322,317,5
75,87,218704500,87045,Cieux,1024,1002,22
75,87,218704609,87046,Cognac-la-Forêt,1199,1191,8
75,87,218704708,87047,Compreignac,1883,1867,16
75,87,218704807,87048,Condat-sur-Vienne,5184,5117,67
75,87,218704906,87049,Coussac-Bonneval,1329,1302,27
75,87,218705002,87050,Couzeix,9772,9612,160
75,87,218705101,87051,La Croisille-sur-Briance,624,613,11
75,87,218705200,87052,La Croix-sur-Gartempe,177,174,3
75,87,218705309,87053,Cromac,241,239,2
75,87,218705408,87054,Cussac,1199,1184,15
75,87,218705606,87056,Dinsac,270,265,5
75,87,218705705,87057,Dompierre-les-Églises,376,371,5
75,87,218705804,87058,Domps,104,101,3
75,87,218705903,87059,Le Dorat,1594,1535,59
75,87,218706000,87060,Dournazac,678,669,9
75,87,218706109,87061,Droux,351,346,5
75,87,218706208,87062,Eybouleuf,475,467,8
75,87,218706307,87063,Eyjeaux,1333,1313,20
75,87,218706406,87064,Eymoutiers,2107,2087,20
75,87,218706505,87065,Feytiat,6191,6120,71
75,87,218706604,87066,Flavignac,1083,1070,13
75,87,218706703,87067,Folles,464,456,8
75,87,218706802,87068,Fromental,532,516,16
75,87,218706901,87069,Gajoubert,146,145,1
75,87,218707008,87070,La Geneytouse,995,979,16
75,87,218707107,87071,Glandon,803,790,13
75,87,218707206,87072,Glanges,517,507,10
75,87,218707305,87073,Gorre,398,389,9
75,87,218707404,87074,Les Grands-Chézeaux,246,240,6
75,87,218707503,87075,Isle,8005,7869,136
75,87,218707602,87076,Jabreilles-les-Bordes,239,236,3
75,87,218707701,87077,Janailhac,537,528,9
75,87,218707800,87078,Javerdat,698,693,5
75,87,218707909,87079,La Jonchère-Saint-Maurice,839,826,13
75,87,218708006,87080,Jouac,179,176,3
75,87,218708105,87081,Jourgnac,1118,1104,14
75,87,218708204,87082,Ladignac-le-Long,1168,1156,12
75,87,218708303,87083,Laurière,537,530,7
75,87,218708402,87084,Lavignac,168,164,4
75,87,218708501,87085,Limoges,132768,130592,2176
75,87,218708600,87086,Linards,1033,1016,17
75,87,218708709,87087,Lussac-les-Églises,469,466,3
75,87,218708808,87088,Magnac-Bourg,1133,1114,19
75,87,218708907,87089,Magnac-Laval,1871,1705,166
75,87,218709004,87090,Mailhac-sur-Benaize,268,263,5
75,87,218709103,87091,Maisonnais-sur-Tardoire,389,382,7
75,87,218709202,87092,Marval,501,495,6
75,87,218709301,87093,Masléon,285,282,3
75,87,218709400,87094,Meilhac,526,522,4
75,87,218709509,87095,Meuzac,745,731,14
75,87,218709608,87096,La Meyze,863,843,20
75,87,200054195,87097,Val d'Issoire,1025,1013,12
75,87,218709905,87099,Moissannes,348,332,16
75,87,218710002,87100,Montrol-Sénard,262,260,2
75,87,218710101,87101,Mortemart,124,123,1
75,87,218710309,87103,Nantiat,1626,1604,22
75,87,218710408,87104,Nedde,458,454,4
75,87,218710507,87105,Neuvic-Entier,923,907,16
75,87,218710606,87106,Nexon,2556,2511,45
75,87,218710705,87107,Nieul,1646,1629,17
75,87,218710804,87108,Nouic,459,451,8
75,87,218710903,87109,Oradour-Saint-Genest,362,328,34
75,87,218711000,87110,Oradour-sur-Glane,2499,2478,21
75,87,218711109,87111,Oradour-sur-Vayres,1554,1527,27
75,87,218711208,87112,Pageas,605,597,8
75,87,218711307,87113,Le Palais-sur-Vienne,6066,6008,58
75,87,218711406,87114,Panazol,11185,11002,183
75,87,218711505,87115,Pensol,176,174,2
75,87,218711604,87116,Peyrat-de-Bellac,1065,1049,16
75,87,218711703,87117,Peyrat-le-Château,1044,1029,15
75,87,218711802,87118,Peyrilhac,1325,1307,18
75,87,218711901,87119,Pierre-Buffière,1174,1163,11
75,87,218712008,87120,La Porcherie,516,505,11
75,87,218712107,87121,Rancon,492,482,10
75,87,218712206,87122,Razès,1181,1169,12
75,87,218712305,87123,Rempnat,148,148,0
75,87,218712404,87124,Rilhac-Lastours,376,373,3
75,87,218712503,87125,Rilhac-Rancon,4725,4655,70
75,87,218712602,87126,Rochechouart,3772,3725,47
75,87,218712701,87127,La Roche-l'Abeille,611,597,14
75,87,200085025,87128,Saint-Pardoux-le-Lac,1345,1330,15
75,87,218712909,87129,Royères,958,951,7
75,87,218713006,87130,Roziers-Saint-Georges,168,168,0
75,87,218713105,87131,Saillat-sur-Vienne,810,799,11
75,87,218713204,87132,Saint-Amand-le-Petit,114,110,4
75,87,218713303,87133,Saint-Amand-Magnazeix,488,484,4
75,87,218713402,87134,Sainte-Anne-Saint-Priest,151,148,3
75,87,218713501,87135,Saint-Auvent,976,958,18
75,87,218713709,87137,Saint-Bazile,140,138,2
75,87,218713808,87138,Saint-Bonnet-Briance,573,560,13
75,87,218713907,87139,Saint-Bonnet-de-Bellac,460,453,7
75,87,218714004,87140,Saint-Brice-sur-Vienne,1695,1665,30
75,87,218714103,87141,Saint-Cyr,689,679,10
75,87,218714202,87142,Saint-Denis-des-Murs,549,543,6
75,87,218714301,87143,Saint-Gence,2247,2218,29
75,87,218714400,87144,Saint-Genest-sur-Roselle,529,524,5
75,87,218714509,87145,Saint-Georges-les-Landes,236,235,1
75,87,218714608,87146,Saint-Germain-les-Belles,1164,1152,12
75,87,218714707,87147,Saint-Gilles-les-Forêts,48,46,2
75,87,218714806,87148,Saint-Hilaire-Bonneval,1007,996,11
75,87,218714905,87149,Saint-Hilaire-la-Treille,368,364,4
75,87,218715001,87150,Saint-Hilaire-les-Places,845,831,14
75,87,218715100,87151,Saint-Jean-Ligoure,502,494,8
75,87,218715209,87152,Saint-Jouvent,1682,1658,24
75,87,218715308,87153,Saint-Julien-le-Petit,292,292,0
75,87,218715407,87154,Saint-Junien,11600,11295,305
75,87,218715506,87155,Saint-Junien-les-Combes,188,181,7
75,87,218715605,87156,Saint-Just-le-Martel,2740,2693,47
75,87,218715704,87157,Saint-Laurent-les-Églises,862,829,33
75,87,218715803,87158,Saint-Laurent-sur-Gorre,1423,1409,14
75,87,218715902,87159,Saint-Léger-la-Montagne,353,351,2
75,87,218716009,87160,Saint-Léger-Magnazeix,501,497,4
75,87,218716108,87161,Saint-Léonard-de-Noblat,4468,4357,111
75,87,218716207,87162,Sainte-Marie-de-Vaux,204,202,2
75,87,218716306,87163,Saint-Martial-sur-Isop,143,140,3
75,87,218716405,87164,Saint-Martin-de-Jussac,577,567,10
75,87,218716504,87165,Saint-Martin-le-Mault,142,141,1
75,87,218716603,87166,Saint-Martin-le-Vieux,924,913,11
75,87,218716702,87167,Saint-Martin-Terressus,558,553,5
75,87,218716801,87168,Saint-Mathieu,1091,1077,14
75,87,218716900,87169,Saint-Maurice-les-Brousses,1072,1048,24
75,87,218717007,87170,Saint-Méard,361,356,5
75,87,218717205,87172,Saint-Ouen-sur-Gartempe,222,217,5
75,87,218717403,87174,Saint-Paul,1245,1222,23
75,87,218717601,87176,Saint-Priest-Ligoure,680,675,5
75,87,218717700,87177,Saint-Priest-sous-Aixe,1827,1809,18
75,87,218717809,87178,Saint-Priest-Taurion,2927,2895,32
75,87,218717908,87179,Saint-Sornin-la-Marche,233,233,0
75,87,218718005,87180,Saint-Sornin-Leulac,574,571,3
75,87,218718104,87181,Saint-Sulpice-Laurière,836,819,17
75,87,218718203,87182,Saint-Sulpice-les-Feuilles,1223,1206,17
75,87,218718302,87183,Saint-Sylvestre,932,920,12
75,87,218718500,87185,Saint-Victurnien,1789,1764,25
75,87,218718609,87186,Saint-Vitte-sur-Briance,325,321,4
75,87,218718708,87187,Saint-Yrieix-la-Perche,7147,6778,369
75,87,218718807,87188,Saint-Yrieix-sous-Aixe,438,435,3
75,87,218718906,87189,Les Salles-Lavauguyon,146,145,1
75,87,218719003,87190,Sauviat-sur-Vige,863,856,7
75,87,218719102,87191,Séreilhac,2029,2010,19
75,87,218719201,87192,Solignac,1599,1576,23
75,87,218719300,87193,Surdoux,47,44,3
75,87,218719409,87194,Sussac,350,347,3
75,87,218719508,87195,Tersannes,134,133,1
75,87,218719706,87197,Thouron,576,567,9
75,87,218719805,87198,Vaulry,414,408,6
75,87,218719904,87199,Vayres,731,725,6
75,87,218720001,87200,Verneuil-Moustiers,129,129,0
75,87,218720100,87201,Verneuil-sur-Vienne,5101,4886,215
75,87,218720209,87202,Veyrac,2167,2132,35
75,87,218720308,87203,Vicq-sur-Breuilh,1356,1327,29
75,87,218720407,87204,Videix,207,203,4
75,87,218720506,87205,Le Vigen,2309,2271,38
75,87,218720605,87206,Villefavard,163,162,1
44,88,218800019,88001,Les Ableuvenettes,56,56,0
44,88,218800027,88002,Ahéville,76,73,3
44,88,218800035,88003,Aingeville,63,62,1
44,88,218800043,88004,Ainvelle,135,129,6
44,88,218800050,88005,Allarmont,204,200,4
44,88,218800068,88006,Ambacourt,290,282,8
44,88,218800076,88007,Ameuvelle,49,48,1
44,88,218800084,88008,Anglemont,172,169,3
44,88,218800092,88009,Anould,3409,3339,70
44,88,218800100,88010,Aouze,202,202,0
44,88,218800118,88011,Arches,1677,1628,49
44,88,218800126,88012,Archettes,1116,1104,12
44,88,218800134,88013,Aroffe,89,89,0
44,88,218800142,88014,Arrentès-de-Corcieux,189,184,5
44,88,218800159,88015,Attignéville,205,202,3
44,88,218800167,88016,Attigny,212,203,9
44,88,218800175,88017,Aulnois,174,168,6
44,88,218800191,88019,Autigny-la-Tour,148,145,3
44,88,218800209,88020,Autreville,195,190,5
44,88,218800217,88021,Autrey,292,280,12
44,88,218800225,88022,Auzainvilliers,246,240,6
44,88,218800233,88023,Avillers,83,83,0
44,88,218800241,88024,Avrainville,124,124,0
44,88,218800258,88025,Avranville,72,69,3
44,88,218800266,88026,Aydoilles,1054,1006,48
44,88,218800274,88027,Badménil-aux-Bois,150,144,6
44,88,218800282,88028,La Baffe,712,618,94
44,88,200069326,88029,La Vôge-les-Bains,1712,1589,123
44,88,218800308,88030,Bainville-aux-Saules,151,151,0
44,88,218800316,88031,Balléville,102,98,4
44,88,218800324,88032,Ban-de-Laveline,1227,1193,34
44,88,218800332,88033,Ban-de-Sapt,358,351,7
44,88,218800357,88035,Barbey-Seroux,148,143,5
44,88,218800365,88036,Barville,92,91,1
44,88,218800373,88037,Basse-sur-le-Rupt,904,877,27
44,88,218800381,88038,Battexey,36,36,0
44,88,218800399,88039,Baudricourt,344,337,7
44,88,218800407,88040,Bayecourt,251,246,5
44,88,218800415,88041,Bazegney,115,107,8
44,88,218800423,88042,Bazien,80,79,1
44,88,218800431,88043,Bazoilles-et-Ménil,112,109,3
44,88,218800449,88044,Bazoilles-sur-Meuse,621,605,16
44,88,218800456,88045,Beaufremont,88,88,0
44,88,218800464,88046,Beauménil,132,131,1
44,88,218800472,88047,Begnécourt,155,148,7
44,88,218800480,88048,Bellefontaine,1001,975,26
44,88,218800498,88049,Belmont-lès-Darney,114,112,2
44,88,218800506,88050,Belmont-sur-Buttant,307,302,5
44,88,218800514,88051,Belmont-sur-Vair,131,130,1
44,88,218800522,88052,Belrupt,96,94,2
44,88,218800530,88053,Belval,157,155,2
44,88,218800548,88054,Bertrimoutier,316,306,10
44,88,218800555,88055,Bettegney-Saint-Brice,161,161,0
44,88,218800563,88056,Bettoncourt,98,96,2
44,88,218800571,88057,Le Beulay,94,92,2
44,88,218800589,88058,Biécourt,99,94,5
44,88,218800597,88059,Biffontaine,406,395,11
44,88,218800605,88060,Blémerey,35,34,1
44,88,218800613,88061,Bleurville,307,294,13
44,88,218800621,88062,Blevaincourt,95,93,2
44,88,218800639,88063,Bocquegney,141,135,6
44,88,218800647,88064,Bois-de-Champ,106,106,0
44,88,218800654,88065,Bonvillet,286,281,5
44,88,218800662,88066,Boulaincourt,70,66,4
44,88,218800688,88068,La Bourgonce,923,903,20
44,88,218800696,88069,Bouxières-aux-Bois,142,136,6
44,88,218800704,88070,Bouxurulles,177,176,1
44,88,218800712,88071,Bouzemont,53,52,1
44,88,218800738,88073,Brantigny,212,209,3
44,88,218800746,88074,Brechainville,60,60,0
44,88,218800753,88075,La Bresse,4289,4139,150
44,88,218800761,88076,Brouvelieures,435,427,8
44,88,218800779,88077,Brû,581,568,13
44,88,218800787,88078,Bruyères,3069,3028,41
44,88,218800795,88079,Bulgnéville,1640,1537,103
44,88,218800803,88080,Bult,313,310,3
44,88,218800811,88081,Bussang,1361,1339,22
44,88,218800829,88082,Celles-sur-Plaine,790,773,17
44,88,218800837,88083,Certilleux,223,213,10
44,88,218800845,88084,Chamagne,462,458,4
44,88,218800852,88085,Champdray,193,191,2
44,88,218800860,88086,Champ-le-Duc,528,505,23
44,88,218800878,88087,Chantraine,3285,3190,95
44,88,218800886,88088,La Chapelle-aux-Bois,680,674,6
44,88,218800894,88089,La Chapelle-devant-Bruyères,568,555,13
44,88,218800902,88090,Charmes,4677,4625,52
44,88,218800910,88091,Charmois-devant-Bruyères,393,384,9
44,88,218800928,88092,Charmois-l'Orgueilleux,595,586,9
44,88,218800936,88093,Châtas,40,39,1
44,88,218800944,88094,Châtel-sur-Moselle,1766,1718,48
44,88,218800951,88095,Châtenois,1745,1719,26
44,88,218800969,88096,Châtillon-sur-Saône,117,110,7
44,88,218800977,88097,Chauffecourt,42,42,0
44,88,218800985,88098,Chaumousey,917,893,24
44,88,218800993,88099,Chavelot,1386,1364,22
44,88,218801009,88100,Chef-Haut,49,47,2
44,88,218801017,88101,Cheniménil,1264,1242,22
44,88,218801025,88102,Chermisey,94,93,1
44,88,218801033,88103,Circourt,85,85,0
44,88,218801041,88104,Circourt-sur-Mouzon,193,183,10
44,88,218801058,88105,Claudon,217,213,4
44,88,218805364,88106,Ban-sur-Meurthe-Clefcy,975,952,23
44,88,218801074,88107,Clérey-la-Côte,32,32,0
44,88,218801082,88108,Le Clerjus,494,479,15
44,88,218801090,88109,Cleurie,660,647,13
44,88,218801108,88110,Clézentaine,225,221,4
44,88,218801116,88111,Coinches,356,352,4
44,88,218801132,88113,Combrimont,135,134,1
44,88,218801140,88114,Contrexéville,3315,3105,210
44,88,218801157,88115,Corcieux,1512,1500,12
44,88,218801165,88116,Cornimont,3134,3062,72
44,88,218801173,88117,Courcelles-sous-Châtenois,79,78,1
44,88,218801181,88118,Coussey,728,711,17
44,88,218801199,88119,Crainvilliers,180,178,2
44,88,218801207,88120,La Croix-aux-Mines,487,478,9
44,88,218801215,88121,Damas-aux-Bois,278,272,6
44,88,218801223,88122,Damas-et-Bettegney,374,367,7
44,88,218801231,88123,Damblain,256,251,5
44,88,218801249,88124,Darney,1118,1065,53
44,88,218801256,88125,Darney-aux-Chênes,68,67,1
44,88,218801264,88126,Darnieulles,1400,1369,31
44,88,218801272,88127,Deinvillers,58,56,2
44,88,218801280,88128,Denipaire,255,249,6
44,88,218801298,88129,Derbamont,111,109,2
44,88,218801306,88130,Destord,249,244,5
44,88,218801314,88131,Deycimont,319,306,13
44,88,218801322,88132,Deyvillers,1394,1358,36
44,88,218801330,88133,Dignonville,219,210,9
44,88,218801348,88134,Dinozé,649,633,16
44,88,218801355,88135,Docelles,883,864,19
44,88,218801363,88136,Dogneville,1532,1504,28
44,88,218801371,88137,Dolaincourt,101,101,0
44,88,218801389,88138,Dombasle-devant-Darney,80,78,2
44,88,218801397,88139,Dombasle-en-Xaintois,121,120,1
44,88,218801405,88140,Dombrot-le-Sec,381,367,14
44,88,218801413,88141,Dombrot-sur-Vair,243,241,2
44,88,218801421,88142,Domèvre-sur-Avière,429,420,9
44,88,218801439,88143,Domèvre-sur-Durbion,278,264,14
44,88,218801447,88144,Domèvre-sous-Montfort,58,58,0
44,88,218801454,88145,Domfaing,215,213,2
44,88,218801462,88146,Domjulien,176,174,2
44,88,218801470,88147,Dommartin-aux-Bois,398,389,9
44,88,218801488,88148,Dommartin-lès-Remiremont,1929,1879,50
44,88,218801496,88149,Dommartin-lès-Vallois,53,53,0
44,88,218801504,88150,Dommartin-sur-Vraine,301,295,6
44,88,218801512,88151,Dompaire,1124,1098,26
44,88,218801520,88152,Dompierre,258,244,14
44,88,218801538,88153,Domptail,351,344,7
44,88,218801546,88154,Domrémy-la-Pucelle,90,88,2
44,88,218801553,88155,Domvallier,108,100,8
44,88,218801561,88156,Doncières,140,140,0
44,88,218801579,88157,Dounoux,876,861,15
44,88,218801587,88158,Éloyes,3168,3110,58
44,88,218801595,88159,Entre-deux-Eaux,513,500,13
44,88,218801603,88160,Épinal,33217,31832,1385
44,88,218801611,88161,Escles,428,418,10
44,88,218801629,88162,Esley,188,185,3
44,88,218801637,88163,Essegney,755,746,9
44,88,218801645,88164,Estrennes,98,97,1
44,88,218801652,88165,Étival-Clairefontaine,2617,2558,59
44,88,218801660,88166,Évaux-et-Ménil,364,361,3
44,88,218801678,88167,Faucompierre,234,231,3
44,88,218801686,88168,Fauconcourt,144,142,2
44,88,218801694,88169,Fays,218,212,6
44,88,218801702,88170,Ferdrupt,741,724,17
44,88,218801710,88171,Fignévelle,49,48,1
44,88,218801728,88172,Fiménil,231,227,4
44,88,218801736,88173,Florémont,489,477,12
44,88,218801744,88174,Fomerey,151,147,4
44,88,218801751,88175,Fontenay,480,462,18
44,88,200036390,88176,Fontenoy-le-Château,530,496,34
44,88,218801777,88177,La Forge,527,518,9
44,88,218801785,88178,Les Forges,1880,1811,69
44,88,218801793,88179,Fouchécourt,46,43,3
44,88,218801801,88180,Frain,127,125,2
44,88,218801819,88181,Fraize,2875,2844,31
44,88,218801827,88182,Frapelle,207,198,9
44,88,218801835,88183,Frebécourt,350,343,7
44,88,218801843,88184,Fremifontaine,443,435,8
44,88,218801850,88185,Frenelle-la-Grande,112,108,4
44,88,218801868,88186,Frenelle-la-Petite,47,47,0
44,88,218801876,88187,Frénois,56,53,3
44,88,218801884,88188,Fresse-sur-Moselle,1754,1719,35
44,88,218801892,88189,Fréville,135,131,4
44,88,218801900,88190,Frizon,516,509,7
44,88,218801926,88192,Gelvécourt-et-Adompt,108,107,1
44,88,218801934,88193,Gemaingoutte,147,146,1
44,88,218801942,88194,Gemmelaincourt,147,135,12
44,88,218801959,88195,Gendreville,108,105,3
44,88,218801967,88196,Gérardmer,8442,7822,620
44,88,218801975,88197,Gerbamont,363,352,11
44,88,218801983,88198,Gerbépal,597,580,17
44,88,218801991,88199,Gignéville,78,77,1
44,88,218802007,88200,Gigney,57,56,1
44,88,218802015,88201,Girancourt,909,891,18
44,88,218802023,88202,Gircourt-lès-Viéville,197,194,3
44,88,218802031,88203,Girecourt-sur-Durbion,364,353,11
44,88,218802056,88205,Girmont-Val-d'Ajol,270,253,17
44,88,218802064,88206,Gironcourt-sur-Vraine,898,882,16
44,88,218802080,88208,Godoncourt,119,115,4
44,88,218802098,88209,Golbey,9001,8882,119
44,88,218802106,88210,Gorhey,175,172,3
44,88,218802122,88212,Grand,358,348,10
44,88,218802130,88213,La Grande-Fosse,137,137,0
44,88,218802148,88214,Grandrupt-de-Bains,79,76,3
44,88,218802155,88215,Grandrupt,79,77,2
44,88,218802163,88216,Grandvillers,747,738,9
44,88,200053627,88218,Granges-Aumontzey,2661,2605,56
44,88,218802197,88219,Greux,151,144,7
44,88,218802205,88220,Grignoncourt,48,47,1
44,88,218802213,88221,Gruey-lès-Surance,234,224,10
44,88,218802221,88222,Gugnécourt,277,258,19
44,88,218802239,88223,Gugney-aux-Aulx,169,166,3
44,88,218802247,88224,Hadigny-les-Verrières,391,380,11
44,88,218802254,88225,Hadol,2459,2357,102
44,88,218802262,88226,Hagécourt,131,128,3
44,88,218802270,88227,Hagnéville-et-Roncourt,87,86,1
44,88,218802288,88228,Haillainville,182,178,4
44,88,218802296,88229,Harchéchamp,80,78,2
44,88,218802304,88230,Hardancourt,39,38,1
44,88,218802312,88231,Haréville,494,476,18
44,88,218802320,88232,Harmonville,220,217,3
44,88,218802338,88233,Harol,690,638,52
44,88,218802361,88236,La Haye,131,131,0
44,88,218802379,88237,Hennecourt,368,360,8
44,88,218802387,88238,Hennezel,401,389,12
44,88,218802395,88239,Hergugney,133,130,3
44,88,218802403,88240,Herpelmont,279,278,1
44,88,218802411,88241,Houécourt,449,437,12
44,88,218802429,88242,Houéville,44,43,1
44,88,218802437,88243,Housseras,498,486,12
44,88,218802445,88244,La Houssière,544,527,17
44,88,218802452,88245,Hurbache,316,310,6
44,88,218802460,88246,Hymont,500,488,12
44,88,218802478,88247,Igney,1170,1156,14
44,88,218802486,88248,Isches,177,173,4
44,88,218802494,88249,Jainvillotte,77,74,3
44,88,218802502,88250,Jarménil,486,481,5
44,88,218802510,88251,Jeanménil,1140,1115,25
44,88,218802528,88252,Jésonville,139,138,1
44,88,218802536,88253,Jeuxey,693,680,13
44,88,218802544,88254,Jorxey,84,83,1
44,88,218802551,88255,Jubainville,94,91,3
44,88,218802569,88256,Jussarupt,270,268,2
44,88,218802577,88257,Juvaincourt,183,181,2
44,88,218802585,88258,Lamarche,865,849,16
44,88,218802593,88259,Landaville,307,298,9
44,88,218802601,88260,Langley,153,152,1
44,88,218802619,88261,Laval-sur-Vologne,640,631,9
44,88,218802627,88262,Laveline-devant-Bruyères,591,580,11
44,88,218802635,88263,Laveline-du-Houx,210,204,6
44,88,218802643,88264,Légéville-et-Bonfays,64,61,3
44,88,218802650,88265,Lemmecourt,28,28,0
44,88,218802668,88266,Lépanges-sur-Vologne,843,827,16
44,88,218802676,88267,Lerrain,463,447,16
44,88,218802684,88268,Lesseux,147,139,8
44,88,218802692,88269,Liézey,304,297,7
44,88,218802700,88270,Liffol-le-Grand,2184,2124,60
44,88,218802718,88271,Lignéville,309,302,7
44,88,218802726,88272,Lironcourt,73,73,0
44,88,218802734,88273,Longchamp,461,453,8
44,88,218802742,88274,Longchamp-sous-Châtenois,83,81,2
44,88,218802759,88275,Lubine,244,242,2
44,88,218802767,88276,Lusse,391,376,15
44,88,218802775,88277,Luvigny,116,113,3
44,88,218802783,88278,Maconcourt,71,70,1
44,88,218802791,88279,Madecourt,48,47,1
44,88,218802809,88280,Madegney,143,143,0
44,88,218802817,88281,Madonne-et-Lamerey,419,407,12
44,88,218802833,88283,Malaincourt,81,79,2
44,88,218802841,88284,Mandray,591,580,11
44,88,218802858,88285,Mandres-sur-Vair,567,440,127
44,88,218802866,88286,Marainville-sur-Madon,97,97,0
44,88,218802874,88287,Marey,67,66,1
44,88,218802882,88288,Maroncourt,6,6,0
44,88,218802890,88289,Martigny-les-Bains,873,807,66
44,88,218802908,88290,Martigny-les-Gerbonvaux,113,111,2
44,88,218802916,88291,Martinvelle,135,132,3
44,88,218802924,88292,Mattaincourt,823,799,24
44,88,218802932,88293,Maxey-sur-Meuse,220,216,4
44,88,218802940,88294,Mazeley,264,261,3
44,88,218802957,88295,Mazirot,239,232,7
44,88,218802965,88296,Médonville,61,61,0
44,88,218802973,88297,Méménil,166,162,4
44,88,218802981,88298,Ménarmont,62,62,0
44,88,218802999,88299,Ménil-en-Xaintois,156,154,2
44,88,218803005,88300,Ménil-de-Senones,133,127,6
44,88,218803013,88301,Ménil-sur-Belvitte,303,292,11
44,88,218803021,88302,Le Ménil,1028,1005,23
44,88,218803039,88303,Midrevaux,189,188,1
44,88,218803047,88304,Mirecourt,5292,4819,473
44,88,218803054,88305,Moncel-sur-Vair,197,192,5
44,88,218803062,88306,Le Mont,51,51,0
44,88,218803070,88307,Mont-lès-Lamarche,100,98,2
44,88,218803088,88308,Mont-lès-Neufchâteau,305,300,5
44,88,218803096,88309,Monthureux-le-Sec,168,164,4
44,88,218803104,88310,Monthureux-sur-Saône,914,896,18
44,88,218803112,88311,Montmotier,37,37,0
44,88,218803120,88312,Morelmaison,199,195,4
44,88,218803138,88313,Moriville,430,421,9
44,88,218803146,88314,Morizécourt,103,99,4
44,88,218803153,88315,Mortagne,175,173,2
44,88,218803161,88316,Morville,47,46,1
44,88,218803179,88317,Moussey,566,561,5
44,88,218803187,88318,Moyemont,231,226,5
44,88,218803195,88319,Moyenmoutier,3128,3065,63
44,88,218803203,88320,Nayemont-les-Fosses,809,773,36
44,88,218803211,88321,Neufchâteau,6925,6644,281
44,88,218803229,88322,La Neuveville-devant-Lépanges,522,508,14
44,88,218803245,88324,La Neuveville-sous-Châtenois,387,377,10
44,88,218803252,88325,La Neuveville-sous-Montfort,197,189,8
44,88,218803260,88326,Neuvillers-sur-Fave,365,354,11
44,88,218803278,88327,Nomexy,1977,1955,22
44,88,218803286,88328,Nompatelize,556,533,23
44,88,218803302,88330,Nonville,194,193,1
44,88,218803310,88331,Nonzeville,56,54,2
44,88,218803328,88332,Norroy,219,213,6
44,88,218803336,88333,Nossoncourt,127,126,1
44,88,218803344,88334,Oëlleville,304,297,7
44,88,218803351,88335,Offroicourt,157,154,3
44,88,218803369,88336,Ollainville,75,74,1
44,88,218803385,88338,Ortoncourt,84,84,0
44,88,218803401,88340,Padoux,501,492,9
44,88,218803419,88341,Pair-et-Grandrupt,519,502,17
44,88,218803427,88342,Pallegney,171,168,3
44,88,218803435,88343,Parey-sous-Montfort,167,163,4
44,88,218803443,88344,Pargny-sous-Mureau,186,181,5
44,88,218803450,88345,La Petite-Fosse,74,70,4
44,88,218803468,88346,La Petite-Raon,749,739,10
44,88,218803476,88347,Pierrefitte,118,117,1
44,88,218803484,88348,Pierrepont-sur-l'Arentèle,138,135,3
44,88,218803492,88349,Plainfaing,1647,1627,20
44,88,218803500,88350,Pleuvezain,78,76,2
44,88,218803518,88351,Plombières-les-Bains,1599,1566,33
44,88,218803526,88352,Pompierre,199,194,5
44,88,218803534,88353,Pont-lès-Bonfays,109,106,3
44,88,218803542,88354,Pont-sur-Madon,188,188,0
44,88,218803559,88355,Portieux,1251,1230,21
44,88,218803567,88356,Les Poulières,292,287,5
44,88,218803575,88357,Poussay,696,675,21
44,88,218803583,88358,Pouxeux,2002,1968,34
44,88,218803591,88359,Prey,92,90,2
44,88,218803609,88360,Provenchères-lès-Darney,154,149,5
44,88,200059921,88361,Provenchères-et-Colroy,1443,1328,115
44,88,218803625,88362,Le Puid,115,114,1
44,88,218803633,88363,Punerot,158,153,5
44,88,218803641,88364,Puzieux,150,147,3
44,88,218803658,88365,Racécourt,161,152,9
44,88,218803666,88366,Rainville,294,281,13
44,88,218803674,88367,Rambervillers,5206,5072,134
44,88,218803682,88368,Ramecourt,180,177,3
44,88,218803690,88369,Ramonchamp,2001,1869,132
44,88,218803708,88370,Rancourt,66,66,0
44,88,218803716,88371,Raon-aux-Bois,1254,1221,33
44,88,218803724,88372,Raon-l'Étape,6247,6113,134
44,88,218803732,88373,Raon-sur-Plaine,149,147,2
44,88,218803740,88374,Rapey,23,23,0
44,88,218803757,88375,Raves,483,474,9
44,88,218803765,88376,Rebeuville,288,281,7
44,88,218803773,88377,Regnévelle,124,122,2
44,88,218803781,88378,Regney,101,99,2
44,88,218803799,88379,Rehaincourt,362,356,6
44,88,218803807,88380,Rehaupal,210,208,2
44,88,218803815,88381,Relanges,204,196,8
44,88,218803823,88382,Remicourt,67,66,1
44,88,218803831,88383,Remiremont,8010,7711,299
44,88,218803856,88385,Remoncourt,582,573,9
44,88,218803864,88386,Remomeix,450,446,4
44,88,218803872,88387,Removille,212,209,3
44,88,218803880,88388,Renauvoid,123,120,3
44,88,218803898,88389,Repel,81,81,0
44,88,218803906,88390,Robécourt,113,105,8
44,88,218803914,88391,Rochesson,697,680,17
44,88,218803930,88393,Rollainville,324,315,9
44,88,218803948,88394,Romain-aux-Bois,50,49,1
44,88,218803955,88395,Romont,377,369,8
44,88,218803989,88398,Les Rouges-Eaux,86,82,4
44,88,218803997,88399,Le Roulier,209,206,3
44,88,218804003,88400,Rouvres-en-Xaintois,280,268,12
44,88,218804011,88401,Rouvres-la-Chétive,461,452,9
44,88,218804029,88402,Roville-aux-Chênes,509,370,139
44,88,218804037,88403,Rozerotte,189,187,2
44,88,218804045,88404,Rozières-sur-Mouzon,69,68,1
44,88,218804060,88406,Rugney,132,131,1
44,88,218804078,88407,Ruppes,144,141,3
44,88,218804086,88408,Rupt-sur-Moselle,3602,3536,66
44,88,218804094,88409,Saint-Amé,2199,2161,38
44,88,218804102,88410,Sainte-Barbe,273,271,2
44,88,218804110,88411,Saint-Baslemont,78,77,1
44,88,218804128,88412,Saint-Benoît-la-Chipotte,455,449,6
44,88,218804136,88413,Saint-Dié-des-Vosges,19936,19490,446
44,88,218804151,88415,Saint-Étienne-lès-Remiremont,3903,3827,76
44,88,218804169,88416,Saint-Genest,137,135,2
44,88,218804177,88417,Saint-Gorgon,388,379,9
44,88,218804185,88418,Sainte-Hélène,456,452,4
44,88,218804193,88419,Saint-Jean-d'Ormont,117,117,0
44,88,218804219,88421,Saint-Julien,104,102,2
44,88,218804235,88423,Saint-Léonard,1382,1359,23
44,88,218804243,88424,Sainte-Marguerite,2351,2286,65
44,88,218804250,88425,Saint-Maurice-sur-Mortagne,183,179,4
44,88,218804268,88426,Saint-Maurice-sur-Moselle,1402,1369,33
44,88,218804276,88427,Saint-Menge,125,125,0
44,88,218804284,88428,Saint-Michel-sur-Meurthe,1877,1820,57
44,88,218804292,88429,Saint-Nabord,4249,3992,257
44,88,218804300,88430,Saint-Ouen-lès-Parey,514,501,13
44,88,218804318,88431,Saint-Paul,161,159,2
44,88,218804326,88432,Saint-Pierremont,155,152,3
44,88,218804334,88433,Saint-Prancher,74,73,1
44,88,218804342,88434,Saint-Remimont,224,220,4
44,88,218804359,88435,Saint-Remy,529,517,12
44,88,218804367,88436,Saint-Stail,72,72,0
44,88,218804375,88437,Saint-Vallier,103,100,3
44,88,218804383,88438,La Salle,398,392,6
44,88,218804391,88439,Sanchey,984,947,37
44,88,218804409,88440,Sandaucourt,172,168,4
44,88,218804417,88441,Sans-Vallois,130,128,2
44,88,218804425,88442,Sapois,643,633,10
44,88,218804433,88443,Sartes,97,95,2
44,88,218804441,88444,Le Saulcy,325,317,8
44,88,218804458,88445,Saulcy-sur-Meurthe,2378,2323,55
44,88,218804466,88446,Saulxures-lès-Bulgnéville,247,244,3
44,88,218804474,88447,Saulxures-sur-Moselotte,2594,2514,80
44,88,218804482,88448,Sauville,183,176,7
44,88,218804490,88449,Savigny,187,187,0
44,88,218804508,88450,Senaide,187,183,4
44,88,218804516,88451,Senones,2429,2394,35
44,88,218804524,88452,Senonges,134,134,0
44,88,218804532,88453,Seraumont,34,34,0
44,88,218804540,88454,Sercoeur,236,226,10
44,88,218804557,88455,Serécourt,100,98,2
44,88,218804565,88456,Serocourt,87,84,3
44,88,218804573,88457,Sionne,146,145,1
44,88,218804581,88458,Socourt,286,283,3
44,88,218804599,88459,Soncourt,44,43,1
44,88,218804607,88460,Soulosse-sous-Saint-Élophe,671,658,13
44,88,218804615,88461,Suriauville,215,210,5
44,88,218804623,88462,Le Syndicat,1927,1887,40
44,88,218804631,88463,Taintrux,1539,1505,34
44,88,218804649,88464,Tendon,517,510,7
44,88,200059939,88465,Thaon-les-Vosges,8799,8583,216
44,88,218804664,88466,They-sous-Montfort,132,127,5
44,88,218804672,88467,Thiéfosse,587,573,14
44,88,218804680,88468,Le Thillot,3372,3316,56
44,88,218804698,88469,Thiraucourt,105,99,6
44,88,218804706,88470,Le Tholy,1574,1536,38
44,88,218804714,88471,Les Thons,102,101,1
44,88,218804722,88472,Thuillières,119,115,4
44,88,218804730,88473,Tignécourt,103,98,5
44,88,218804748,88474,Tilleux,66,66,0
44,88,200064814,88475,Tollaincourt,123,118,5
44,88,218804763,88476,Totainville,121,120,1
44,88,218804771,88477,Trampot,100,99,1
44,88,218804789,88478,Tranqueville-Graux,104,103,1
44,88,218804797,88479,Trémonzey,257,251,6
44,88,218804805,88480,Ubexy,167,167,0
44,88,218804813,88481,Uriménil,1353,1331,22
44,88,218804821,88482,Urville,58,56,2
44,88,218804839,88483,Uxegney,2337,2281,56
44,88,218804847,88484,Uzemain,1066,1040,26
44,88,218804854,88485,La Vacheresse-et-la-Rouillie,117,117,0
44,88,218804862,88486,Vagney,4008,3900,108
44,88,218804870,88487,Le Val-d'Ajol,3955,3860,95
44,88,218804888,88488,Valfroicourt,238,233,5
44,88,218804896,88489,Valleroy-aux-Saules,261,253,8
44,88,218804904,88490,Valleroy-le-Sec,187,183,4
44,88,218804912,88491,Les Vallois,122,117,5
44,88,218804920,88492,Le Valtin,75,74,1
44,88,218804938,88493,Varmonzey,24,23,1
44,88,218804946,88494,Vaubexy,121,119,2
44,88,218804953,88495,Vaudéville,191,185,6
44,88,218804961,88496,Vaudoncourt,164,161,3
44,88,218804979,88497,Vaxoncourt,466,463,3
44,88,218804987,88498,Vecoux,868,848,20
44,88,218804995,88499,Velotte-et-Tatignécourt,162,159,3
44,88,218805000,88500,Ventron,846,832,14
44,88,218805018,88501,Le Vermont,72,72,0
44,88,218805026,88502,Vervezelle,136,134,2
44,88,218805034,88503,Vexaincourt,150,148,2
44,88,218805042,88504,Vicherey,193,191,2
44,88,218805059,88505,Vienville,127,125,2
44,88,218805067,88506,Vieux-Moulin,317,311,6
44,88,218805075,88507,Villers,202,196,6
44,88,218805083,88508,Ville-sur-Illon,544,533,11
44,88,218805091,88509,Villoncourt,109,108,1
44,88,218805109,88510,Villotte,149,143,6
44,88,218805117,88511,Villouxel,89,87,2
44,88,218805125,88512,Viménil,251,247,4
44,88,218805133,88513,Vincey,2190,2151,39
44,88,218805141,88514,Viocourt,169,162,7
44,88,218805158,88515,Vioménil,156,154,2
44,88,218805166,88516,Vittel,4943,4805,138
44,88,218805174,88517,Viviers-le-Gras,200,195,5
44,88,218805182,88518,Viviers-lès-Offroicourt,34,34,0
44,88,218805190,88519,La Voivre,693,672,21
44,88,218805208,88520,Les Voivres,301,292,9
44,88,218805216,88521,Vomécourt,255,252,3
44,88,218805224,88522,Vomécourt-sur-Madon,72,69,3
44,88,218805232,88523,Vouxey,165,160,5
44,88,218805240,88524,Vrécourt,356,352,4
44,88,218805257,88525,Vroville,133,131,2
44,88,218805265,88526,Wisembach,431,423,8
44,88,218805273,88527,Xaffévillers,142,140,2
44,88,218805281,88528,Xamontarupt,157,154,3
44,88,218805299,88529,Xaronval,115,111,4
44,88,218805307,88530,Xertigny,2635,2583,52
44,88,218805315,88531,Xonrupt-Longemer,1532,1500,32
44,88,218805323,88532,Zincourt,81,77,4
27,89,218900025,89002,Aigremont,80,75,5
27,89,200061968,89003,Montholon,2901,2814,87
27,89,218900041,89004,Aisy-sur-Armançon,248,237,11
27,89,218900058,89005,Ancy-le-Franc,865,843,22
27,89,218900066,89006,Ancy-le-Libre,155,149,6
27,89,218900074,89007,Andryes,450,438,12
27,89,218900082,89008,Angely,161,156,5
27,89,218900090,89009,Annay-la-Côte,367,350,17
27,89,218900108,89010,Annay-sur-Serein,210,205,5
27,89,218900116,89011,Annéot,130,120,10
27,89,218900124,89012,Annoux,85,83,2
27,89,218900132,89013,Appoigny,3293,3207,86
27,89,218900140,89014,Arces-Dilo,618,608,10
27,89,218900157,89015,Arcy-sur-Cure,481,469,12
27,89,218900165,89016,Argentenay,79,76,3
27,89,218900173,89017,Argenteuil-sur-Armançon,221,219,2
27,89,218900181,89018,Armeau,776,767,9
27,89,218900199,89019,Arthonnay,152,151,1
27,89,218900207,89020,Asnières-sous-Bois,115,113,2
27,89,218900215,89021,Asquins,300,287,13
27,89,218900223,89022,Athie,134,131,3
27,89,218900231,89023,Augy,1005,983,22
27,89,218900249,89024,Auxerre,35244,34151,1093
27,89,218900256,89025,Avallon,6635,6414,221
27,89,218900272,89027,Bagneaux,205,200,5
27,89,218900280,89028,Baon,66,61,5
27,89,218900298,89029,Bassou,899,880,19
27,89,218900306,89030,Bazarnes,426,417,9
27,89,218900314,89031,Beaumont,641,628,13
27,89,218900322,89032,Beauvilliers,67,64,3
27,89,218900330,89033,Beauvoir,406,395,11
27,89,218900348,89034,Beine,478,462,16
27,89,218900355,89035,Bellechaume,452,440,12
27,89,218900363,89036,La Belliole,247,237,10
27,89,218900371,89037,Béon,541,520,21
27,89,218900389,89038,Bernouil,113,113,0
27,89,218900397,89039,Béru,80,76,4
27,89,218900405,89040,Bessy-sur-Cure,191,187,4
27,89,218900413,89041,Beugnon,315,301,14
27,89,218900421,89042,Bierry-les-Belles-Fontaines,167,162,5
27,89,218900439,89043,Blacy,100,99,1
27,89,218900447,89044,Blannay,104,103,1
27,89,218900454,89045,Bleigny-le-Carreau,290,284,6
27,89,218900462,89046,Bléneau,1184,1164,20
27,89,218900488,89048,Boeurs-en-Othe,346,340,6
27,89,218900496,89049,Bois-d'Arcy,23,22,1
27,89,218900504,89050,Bonnard,893,873,20
27,89,218900512,89051,Les Bordes,550,538,12
27,89,218900538,89053,Branches,446,436,10
27,89,218900546,89054,Brannay,798,787,11
27,89,218900553,89055,Brienon-sur-Armançon,3215,3160,55
27,89,218900561,89056,Brion,641,620,21
27,89,218900579,89057,Brosses,308,303,5
27,89,218900587,89058,Bussières,122,119,3
27,89,218900595,89059,Bussy-en-Othe,716,707,9
27,89,218900603,89060,Bussy-le-Repos,466,456,10
27,89,218900611,89061,Butteaux,248,247,1
27,89,218900629,89062,Carisey,366,362,4
27,89,218900637,89063,La Celle-Saint-Cyr,833,815,18
27,89,218900645,89064,Censy,57,56,1
27,89,218900652,89065,Cérilly,43,43,0
27,89,218900660,89066,Cerisiers,995,972,23
27,89,218900678,89067,Cézy,1126,1102,24
27,89,218900686,89068,Chablis,2210,2171,39
27,89,218900694,89069,Chailley,529,519,10
27,89,218900710,89071,Chamoux,103,101,2
27,89,218900728,89072,Champcevrais,307,307,0
27,89,218900736,89073,Champignelles,953,911,42
27,89,218900744,89074,Champigny,2146,2105,41
27,89,218900751,89075,Champlay,739,725,14
27,89,218900769,89076,Champlost,802,790,12
27,89,218900777,89077,Champs-sur-Yonne,1669,1576,93
27,89,218900793,89079,Chamvres,673,658,15
27,89,218900801,89080,La Chapelle-sur-Oreuse,667,650,17
27,89,218900819,89081,La Chapelle-Vaupelteigne,91,91,0
27,89,218900835,89083,Charbuy,1915,1867,48
27,89,218900843,89084,Charentenay,288,281,7
27,89,218900850,89085,Charmoy,1135,1109,26
27,89,200055788,89086,Charny Orée de Puisaye,4836,4759,77
27,89,218900876,89087,Chassignelles,308,299,9
27,89,218900884,89088,Chassy,476,467,9
27,89,218900892,89089,Chastellux-sur-Cure,139,135,4
27,89,218900918,89091,Châtel-Censoir,585,571,14
27,89,218900926,89092,Châtel-Gérard,213,204,9
27,89,218900934,89093,Chaumont,657,645,12
27,89,218900942,89094,Chaumot,715,703,12
27,89,218900959,89095,Chemilly-sur-Serein,146,138,8
27,89,218900967,89096,Chemilly-sur-Yonne,930,904,26
27,89,218900983,89098,Cheney,235,228,7
27,89,218900991,89099,Cheny,2333,2287,46
27,89,218901007,89100,Chéroy,1728,1705,23
27,89,218901015,89101,Chéu,564,553,11
27,89,218901023,89102,Chevannes,2233,2165,68
27,89,218901049,89104,Chichée,312,302,10
27,89,218901056,89105,Chichery,479,467,12
27,89,218901080,89108,Chitry,350,341,9
27,89,218901114,89111,Les Clérimois,304,299,5
27,89,218901122,89112,Collan,167,159,8
27,89,218901130,89113,Collemiers,685,671,14
27,89,218901155,89115,Compigny,202,198,4
27,89,218901163,89116,Cornant,367,360,7
27,89,218901171,89117,Coulangeron,218,217,1
27,89,218901189,89118,Coulanges-la-Vineuse,814,794,20
27,89,218901197,89119,Coulanges-sur-Yonne,521,511,10
27,89,218901205,89120,Coulours,138,133,5
27,89,218901221,89122,Courgenay,574,566,8
27,89,218901239,89123,Courgis,269,261,8
27,89,218901247,89124,Courlon-sur-Yonne,1209,1189,20
27,89,218901254,89125,Courson-les-Carrières,937,924,13
27,89,218901262,89126,Courtoin,32,31,1
27,89,218901270,89127,Courtois-sur-Yonne,806,782,24
27,89,218901288,89128,Coutarnoux,142,138,4
27,89,218901296,89129,Crain,419,410,9
27,89,200062271,89130,Deux Rivières,1295,1265,30
27,89,218901312,89131,Cruzy-le-Châtel,234,230,4
27,89,218901320,89132,Cry,169,163,6
27,89,218901338,89133,Cudot,369,365,4
27,89,218901346,89134,Cussy-les-Forges,334,326,8
27,89,218901361,89136,Cuy,889,860,29
27,89,218901379,89137,Dannemoine,478,468,10
27,89,218901395,89139,Diges,1120,1083,37
27,89,218901411,89141,Dissangis,125,118,7
27,89,218901429,89142,Dixmont,926,911,15
27,89,218901437,89143,Dollot,317,315,2
27,89,218901445,89144,Domats,814,806,8
27,89,218901452,89145,Domecy-sur-Cure,393,388,5
27,89,218901460,89146,Domecy-sur-le-Vault,88,86,2
27,89,218901478,89147,Dracy,244,242,2
27,89,218901486,89148,Druyes-les-Belles-Fontaines,272,267,5
27,89,218901494,89149,Dyé,208,205,3
27,89,218901502,89150,Égleny,459,450,9
27,89,218901510,89151,Égriselles-le-Bocage,1393,1372,21
27,89,218901528,89152,Épineau-les-Voves,752,740,12
27,89,218901536,89153,Épineuil,549,533,16
27,89,218901544,89154,Escamps,912,887,25
27,89,218901551,89155,Escolives-Sainte-Camille,720,709,11
27,89,218901569,89156,Esnon,402,395,7
27,89,218901585,89158,Étais-la-Sauvin,638,624,14
27,89,218901593,89159,Étaule,400,390,10
27,89,218901601,89160,Étigny,786,763,23
27,89,218901619,89161,Étivey,197,192,5
27,89,218901627,89162,Évry,396,393,3
27,89,218901635,89163,La Ferté-Loupière,535,524,11
27,89,218901643,89164,Festigny,92,92,0
27,89,218901650,89165,Flacy,114,112,2
27,89,218901676,89167,Fleury-la-Vallée,1112,1081,31
27,89,218901684,89168,Fleys,179,176,3
27,89,218901692,89169,Flogny-la-Chapelle,969,946,23
27,89,218901700,89170,Foissy-lès-Vézelay,124,121,3
27,89,218901718,89171,Foissy-sur-Vanne,293,290,3
27,89,218901726,89172,Fontaine-la-Gaillarde,527,502,25
27,89,218901734,89173,Fontaines,474,467,7
27,89,218901759,89175,Fontenay-près-Chablis,149,145,4
27,89,218901767,89176,Fontenay-près-Vézelay,141,138,3
27,89,218901775,89177,Fontenay-sous-Fouronnes,73,73,0
27,89,218901791,89179,Fontenoy,307,298,9
27,89,218901809,89180,Fouchères,507,496,11
27,89,218901817,89181,Fournaudin,120,118,2
27,89,218901825,89182,Fouronnes,178,174,4
27,89,218901833,89183,Fresnes,66,66,0
27,89,218901841,89184,Fulvy,132,130,2
27,89,218901866,89186,Germigny,534,521,13
27,89,218901874,89187,Gigny,85,83,2
27,89,218901882,89188,Girolles,172,166,6
27,89,218901890,89189,Gisy-les-Nobles,590,571,19
27,89,218901908,89190,Givry,186,178,8
27,89,218901916,89191,Gland,48,46,2
27,89,218901940,89194,Grimault,120,114,6
27,89,218901957,89195,Gron,1315,1242,73
27,89,200055747,89196,Valravillon,1803,1752,51
27,89,200087229,89197,Guillon-Terre-Plaine,751,736,15
27,89,218901981,89198,Gurgy,1738,1702,36
27,89,218901999,89199,Gy-l'Évêque,462,453,9
27,89,218902005,89200,Hauterive,397,391,6
27,89,218902013,89201,Héry,1814,1774,40
27,89,218902021,89202,Irancy,263,256,7
27,89,218902039,89203,Island,193,188,5
27,89,218902047,89204,L'Isle-sur-Serein,674,660,14
27,89,218902054,89205,Jaulges,579,575,4
27,89,218902062,89206,Joigny,9691,9381,310
27,89,218902070,89207,Jouancy,26,26,0
27,89,218902088,89208,Joux-la-Ville,1170,1152,18
27,89,218902096,89209,Jouy,523,512,11
27,89,218902104,89210,Jully,135,128,7
27,89,218902112,89211,Junay,68,68,0
27,89,218902120,89212,Jussy,378,364,14
27,89,218902146,89214,Lailly,197,195,2
27,89,218902153,89215,Lain,189,185,4
27,89,218902161,89216,Lainsecq,329,319,10
27,89,218902179,89217,Lalande,139,136,3
27,89,218902187,89218,Laroche-Saint-Cydroine,1282,1258,24
27,89,218902195,89219,Lasson,144,143,1
27,89,218902203,89220,Lavau,438,436,2
27,89,218902211,89221,Leugny,325,320,5
27,89,218902229,89222,Levis,224,218,6
27,89,218902237,89223,Lézinnes,679,662,17
27,89,218902245,89224,Lichères-près-Aigremont,157,154,3
27,89,218902252,89225,Lichères-sur-Yonne,43,43,0
27,89,218902260,89226,Lignorelles,193,188,5
27,89,218902278,89227,Ligny-le-Châtel,1228,1201,27
27,89,218902286,89228,Lindry,1420,1373,47
27,89,218902294,89229,Lixy,489,476,13
27,89,218902302,89230,Looze,459,438,21
27,89,218902328,89232,Lucy-le-Bois,314,300,14
27,89,218902336,89233,Lucy-sur-Cure,203,198,5
27,89,218902344,89234,Lucy-sur-Yonne,121,119,2
27,89,218902351,89235,Magny,897,874,23
27,89,218902369,89236,Maillot,1235,1206,29
27,89,218902377,89237,Mailly-la-Ville,501,492,9
27,89,218902385,89238,Mailly-le-Château,547,540,7
27,89,218902393,89239,Malay-le-Grand,1603,1558,45
27,89,218902401,89240,Malay-le-Petit,331,321,10
27,89,218902427,89242,Maligny,812,797,15
27,89,218902443,89244,Marmeaux,87,83,4
27,89,218902450,89245,Marsangy,853,835,18
27,89,218902468,89246,Massangis,356,349,7
27,89,218902476,89247,Mélisey,231,229,2
27,89,218902484,89248,Menades,42,40,2
27,89,218902492,89249,Mercy,78,77,1
27,89,218902500,89250,Méré,207,204,3
27,89,218902518,89251,Merry-la-Vallée,376,367,9
27,89,218902526,89252,Merry-Sec,182,178,4
27,89,218902534,89253,Merry-sur-Yonne,198,194,4
27,89,218902542,89254,Mézilles,526,518,8
27,89,218902559,89255,Michery,1094,1071,23
27,89,218902567,89256,Migé,411,409,2
27,89,218902575,89257,Migennes,7402,7274,128
27,89,218902591,89259,Môlay,96,94,2
27,89,218902617,89261,Molinons,281,275,6
27,89,218902625,89262,Molosmes,178,170,8
27,89,218902633,89263,Monéteau,4193,4110,83
27,89,218902641,89264,Montacher-Villegardin,741,715,26
27,89,218902658,89265,Montigny-la-Resle,599,579,20
27,89,218902666,89266,Montillot,261,255,6
27,89,218902674,89267,Montréal,183,177,6
27,89,218902682,89268,Mont-Saint-Sulpice,806,787,19
27,89,218902708,89270,Mouffy,128,126,2
27,89,218902716,89271,Moulins-en-Tonnerrois,106,105,1
27,89,218902724,89272,Moulins-sur-Ouanne,290,288,2
27,89,218902732,89273,Moutiers-en-Puisaye,278,275,3
27,89,218902740,89274,Nailly,1370,1333,37
27,89,218902765,89276,Neuvy-Sautour,915,877,38
27,89,218902773,89277,Nitry,377,366,11
27,89,218902781,89278,Noé,555,550,5
27,89,218902799,89279,Noyers,612,593,19
27,89,218902807,89280,Nuits,401,392,9
27,89,218902815,89281,Les Ormes,341,336,5
27,89,218902823,89282,Ormoy,686,675,11
27,89,218902831,89283,Ouanne,611,595,16
27,89,218902849,89284,Pacy-sur-Armançon,183,179,4
27,89,218902856,89285,Pailly,319,316,3
27,89,218902864,89286,Parly,849,833,16
27,89,218902872,89287,Paron,4943,4825,118
27,89,218904878,89288,Paroy-en-Othe,179,171,8
27,89,218902898,89289,Paroy-sur-Tholon,293,280,13
27,89,218902906,89290,Pasilly,44,43,1
27,89,218902914,89291,Passy,348,338,10
27,89,218902922,89292,Percey,253,248,5
27,89,218902955,89295,Perrigny,1297,1266,31
27,89,218902963,89296,Perrigny-sur-Armançon,130,129,1
27,89,218902971,89297,Pierre-Perthuis,108,107,1
27,89,218902989,89298,Piffonds,609,598,11
27,89,218902997,89299,Pimelles,65,63,2
27,89,218903003,89300,Pisy,82,81,1
27,89,218903029,89302,Plessis-Saint-Jean,212,209,3
27,89,218903037,89303,Poilly-sur-Serein,253,247,6
27,89,218903045,89304,Poilly-sur-Tholon,697,675,22
27,89,218903060,89306,Pontaubert,374,363,11
27,89,218903078,89307,Pontigny,764,754,10
27,89,218903086,89308,Pont-sur-Vanne,191,184,7
27,89,218903094,89309,Pont-sur-Yonne,3375,3316,59
27,89,218903102,89310,La Postolle,141,138,3
27,89,218903110,89311,Pourrain,1383,1356,27
27,89,218903128,89312,Précy-le-Sec,250,245,5
27,89,218903136,89313,Précy-sur-Vrin,435,419,16
27,89,218903144,89314,Prégilbert,182,181,1
27,89,218903151,89315,Préhy,160,159,1
27,89,218903169,89316,Provency,258,252,6
27,89,218903185,89318,Quarré-les-Tombes,648,628,20
27,89,218903193,89319,Quenne,497,483,14
27,89,218903201,89320,Quincerot,67,65,2
27,89,218903219,89321,Ravières,730,712,18
27,89,218903235,89323,Roffey,145,141,4
27,89,218903243,89324,Rogny-les-Sept-Écluses,683,672,11
27,89,218903250,89325,Ronchères,91,90,1
27,89,218903268,89326,Rosoy,1105,1074,31
27,89,218903276,89327,Rousson,399,389,10
27,89,218903284,89328,Rouvray,376,369,7
27,89,218903292,89329,Rugny,74,73,1
27,89,218903318,89331,Sainpuits,322,311,11
27,89,218903326,89332,Saint-Agnan,984,957,27
27,89,218903334,89333,Saint-André-en-Terre-Plaine,153,149,4
27,89,200059574,89334,Le Val d'Ocre,562,555,7
27,89,218903359,89335,Saint-Aubin-sur-Yonne,440,427,13
27,89,218903367,89336,Saint-Brancher,287,280,7
27,89,218903375,89337,Saint-Bris-le-Vineux,1049,1023,26
27,89,218903383,89338,Saint-Clément,2893,2812,81
27,89,218903391,89339,Sainte-Colombe,196,187,9
27,89,218903417,89341,Saint-Cyr-les-Colons,453,448,5
27,89,218903425,89342,Saint-Denis-lès-Sens,658,640,18
27,89,218903441,89344,Saint-Fargeau,1495,1482,13
27,89,218903458,89345,Saint-Florentin,4266,4211,55
27,89,218903466,89346,Saint-Georges-sur-Baulche,3370,3225,145
27,89,218903474,89347,Saint-Germain-des-Champs,353,343,10
27,89,218903482,89348,Saint-Julien-du-Sault,2273,2224,49
27,89,218903490,89349,Saint-Léger-Vauban,367,356,11
27,89,218903508,89350,Saint-Loup-d'Ordon,265,260,5
27,89,218903516,89351,Sainte-Magnance,486,478,8
27,89,218903524,89352,Saint-Martin-des-Champs,272,265,7
27,89,218903532,89353,Saint-Martin-d'Ordon,425,421,4
27,89,218903540,89354,Saint-Martin-du-Tertre,1571,1529,42
27,89,218903557,89355,Saint-Martin-sur-Armançon,153,147,6
27,89,218903599,89359,Saint-Maurice-aux-Riches-Hommes,418,413,5
27,89,218903607,89360,Saint-Maurice-le-Vieil,380,372,8
27,89,218903615,89361,Saint-Maurice-Thizouaille,255,253,2
27,89,218903623,89362,Saint-Moré,183,178,5
27,89,218903631,89363,Sainte-Pallaye,108,104,4
27,89,218903649,89364,Saint-Père,298,292,6
27,89,218903656,89365,Saint-Privé,536,525,11
27,89,218903672,89367,Saints-en-Puisaye,554,543,11
27,89,218903680,89368,Saint-Sauveur-en-Puisaye,917,895,22
27,89,218903698,89369,Saint-Sérotin,593,581,12
27,89,218903706,89370,Saint-Valérien,1771,1750,21
27,89,218903714,89371,Sainte-Vertu,83,78,5
27,89,218903730,89373,Saligny,689,679,10
27,89,218903748,89374,Sambourg,73,70,3
27,89,218903755,89375,Santigny,87,84,3
27,89,218903763,89376,Sarry,142,135,7
27,89,218903771,89377,Sauvigny-le-Beuréal,68,68,0
27,89,218903789,89378,Sauvigny-le-Bois,744,729,15
27,89,218903797,89379,Savigny-en-Terre-Plaine,147,144,3
27,89,218903805,89380,Savigny-sur-Clairis,458,451,7
27,89,218903821,89382,Seignelay,1495,1457,38
27,89,218903839,89383,Sementron,105,103,2
27,89,218903847,89384,Senan,699,682,17
27,89,218903854,89385,Sennevoy-le-Bas,79,76,3
27,89,218903862,89386,Sennevoy-le-Haut,114,113,1
27,89,218903870,89387,Sens,27367,26854,513
27,89,200057735,89388,Sépeaux-Saint Romain,523,507,16
27,89,218903904,89390,Serbonnes,678,669,9
27,89,218903912,89391,Sergines,1286,1260,26
27,89,218903920,89392,Sermizelles,247,244,3
27,89,218903938,89393,Serrigny,113,111,2
27,89,218903946,89394,Sery,77,76,1
27,89,218903953,89395,Les Sièges,412,404,8
27,89,218903979,89397,Sommecaise,378,372,6
27,89,218903987,89398,Sormery,369,364,5
27,89,218903995,89399,Soucy,1617,1575,42
27,89,218904001,89400,Sougères-en-Puisaye,323,317,6
27,89,218904027,89402,Soumaintrain,221,218,3
27,89,218904035,89403,Stigny,93,85,8
27,89,218904043,89404,Subligny,534,525,9
27,89,200064111,89405,Les Hauts de Forterre,508,499,9
27,89,218904068,89406,Talcy,78,76,2
27,89,218904076,89407,Tanlay,945,915,30
27,89,218904084,89408,Tannerre-en-Puisaye,281,274,7
27,89,218904092,89409,Tharoiseau,62,61,1
27,89,218904100,89410,Tharot,105,104,1
27,89,200059624,89411,Les Vallées de la Vanne,1038,1020,18
27,89,218904126,89412,Thizy,191,184,7
27,89,218904134,89413,Thorey,40,39,1
27,89,218904142,89414,Thorigny-sur-Oreuse,1434,1405,29
27,89,218904159,89415,Thory,201,198,3
27,89,218904167,89416,Thury,449,442,7
27,89,218904175,89417,Tissey,112,110,2
27,89,218904183,89418,Tonnerre,4508,4345,163
27,89,218904191,89419,Toucy,2732,2589,143
27,89,200085058,89420,Treigny-Perreuse-Sainte-Colombe,1028,1007,21
27,89,218904225,89422,Trichey,44,42,2
27,89,218904233,89423,Tronchoy,130,127,3
27,89,218904241,89424,Trucy-sur-Yonne,139,133,6
27,89,218904258,89425,Turny,685,665,20
27,89,218904266,89426,Val-de-Mercy,399,387,12
27,89,218904274,89427,Vallan,696,677,19
27,89,218904282,89428,Vallery,574,568,6
27,89,218904308,89430,Varennes,329,321,8
27,89,218904316,89431,Vassy-sous-Pisy,73,68,5
27,89,218904324,89432,Vaudeurs,461,453,8
27,89,218904332,89433,Vault-de-Lugny,274,269,5
27,89,218904340,89434,Vaumort,349,341,8
27,89,218904365,89436,Venizy,888,871,17
27,89,218904373,89437,Venouse,305,298,7
27,89,218904381,89438,Venoy,1941,1750,191
27,89,218904399,89439,Vergigny,1540,1519,21
27,89,218904407,89440,Verlin,417,412,5
27,89,200059004,89441,Vermenton,1275,1250,25
27,89,218904423,89442,Vernoy,246,239,7
27,89,218904431,89443,Véron,1916,1855,61
27,89,218904456,89445,Vézannes,54,52,2
27,89,218904464,89446,Vézelay,440,433,7
27,89,218904472,89447,Vézinnes,159,157,2
27,89,218904498,89449,Villeblevin,1831,1796,35
27,89,218904506,89450,Villebougis,643,629,14
27,89,218904514,89451,Villechétive,254,249,5
27,89,218904522,89452,Villecien,380,367,13
27,89,218904530,89453,Villefargeau,1141,1118,23
27,89,218904563,89456,Villemanoche,674,666,8
27,89,218904589,89458,Villenavotte,169,161,8
27,89,218904597,89459,Villeneuve-la-Dondagre,329,329,0
27,89,218904605,89460,Villeneuve-la-Guyard,3524,3458,66
27,89,218904613,89461,Villeneuve-l'Archevêque,1128,1109,19
27,89,218904621,89462,Villeneuve-les-Genêts,309,304,5
27,89,218904639,89463,Villeneuve-Saint-Salves,259,255,4
27,89,218904647,89464,Villeneuve-sur-Yonne,5233,5148,85
27,89,218904654,89465,Villeperrot,325,324,1
27,89,218904662,89466,Villeroy,395,386,9
27,89,218904670,89467,Villethierry,823,809,14
27,89,218904688,89468,Villevallier,482,418,64
27,89,218904696,89469,Perceneige,970,947,23
27,89,218904704,89470,Villiers-les-Hauts,125,122,3
27,89,218904712,89471,Villiers-Louis,486,470,16
27,89,218904720,89472,Villiers-Saint-Benoît,451,442,9
27,89,218904746,89474,Villiers-Vineux,276,270,6
27,89,218904753,89475,Villon,110,108,2
27,89,218904779,89477,Villy,116,114,2
27,89,218904787,89478,Vincelles,931,914,17
27,89,218904795,89479,Vincelottes,295,289,6
27,89,218904803,89480,Vinneuf,1625,1606,19
27,89,218904811,89481,Vireaux,110,104,6
27,89,218904829,89482,Viviers,109,108,1
27,89,218904837,89483,Voisines,533,515,18
27,89,218904852,89485,Voutenay-sur-Cure,205,199,6
27,89,218904860,89486,Yrouerre,154,151,3
27,90,219000015,90001,Andelnans,1186,1165,21
27,90,219000023,90002,Angeot,361,355,6
27,90,219000031,90003,Anjoutey,604,582,22
27,90,219000049,90004,Argiésans,548,540,8
27,90,219000056,90005,Auxelles-Bas,455,443,12
27,90,219000064,90006,Auxelles-Haut,291,284,7
27,90,219000072,90007,Banvillars,303,291,12
27,90,219000080,90008,Bavilliers,4735,4627,108
27,90,219000098,90009,Beaucourt,5081,5016,65
27,90,219000106,90010,Belfort,46225,45458,767
27,90,219000114,90011,Bermont,385,376,9
27,90,219000122,90012,Bessoncourt,1349,1302,47
27,90,219000130,90013,Bethonvilliers,254,243,11
27,90,219000148,90014,Boron,497,489,8
27,90,219000155,90015,Botans,251,238,13
27,90,219000163,90016,Bourg-sous-Châtelet,125,123,2
27,90,219000171,90017,Bourogne,1874,1848,26
27,90,219000189,90018,Brebotte,407,400,7
27,90,219000197,90019,Bretagne,291,285,6
27,90,219000205,90020,Buc,275,264,11
27,90,219000213,90021,Charmois,379,375,4
27,90,219000221,90022,Châtenois-les-Forges,2675,2625,50
27,90,219000239,90023,Chaux,1207,1176,31
27,90,219000247,90024,Chavanatte,141,138,3
27,90,219000254,90025,Chavannes-les-Grands,344,340,4
27,90,219000262,90026,Chèvremont,1609,1572,37
27,90,219000270,90027,Courcelles,120,120,0
27,90,219000288,90028,Courtelevant,389,382,7
27,90,219000296,90029,Cravanche,1989,1938,51
27,90,219000304,90030,Croix,176,173,3
27,90,219000312,90031,Cunelières,347,338,9
27,90,219000320,90032,Danjoutin,3640,3573,67
27,90,219000338,90033,Delle,5774,5689,85
27,90,219000346,90034,Denney,786,760,26
27,90,219000353,90035,Dorans,818,808,10
27,90,219000361,90036,Eguenigue,278,269,9
27,90,219000379,90037,Éloie,982,955,27
27,90,219000395,90039,Essert,3420,3316,104
27,90,219000411,90041,Étueffont,1444,1401,43
27,90,219000429,90042,Évette-Salbert,2090,2021,69
27,90,219000437,90043,Faverois,587,586,1
27,90,219000445,90044,Felon,243,239,4
27,90,219000452,90045,Fêche-l'Église,771,758,13
27,90,219000460,90046,Florimont,455,449,6
27,90,219000478,90047,Fontaine,609,594,15
27,90,219000486,90048,Fontenelle,131,127,4
27,90,219000494,90049,Foussemagne,935,917,18
27,90,219000502,90050,Frais,244,237,7
27,90,219000510,90051,Froidefontaine,480,472,8
27,90,219000528,90052,Giromagny,2994,2914,80
27,90,219000536,90053,Grandvillars,3056,2995,61
27,90,219000544,90054,Grosmagny,525,516,9
27,90,219000551,90055,Grosne,337,331,6
27,90,219000569,90056,Joncherey,1445,1416,29
27,90,219000577,90057,Lachapelle-sous-Chaux,781,754,27
27,90,219000585,90058,Lachapelle-sous-Rougemont,590,584,6
27,90,219000593,90059,Lacollonge,236,226,10
27,90,219000601,90060,Lagrange,144,139,5
27,90,219000619,90061,Lamadeleine-Val-des-Anges,46,44,2
27,90,219000627,90062,Larivière,289,279,10
27,90,219000635,90063,Lebetain,422,413,9
27,90,219000643,90064,Lepuix-Neuf,312,308,4
27,90,219000650,90065,Lepuix,1161,1141,20
27,90,219000668,90066,Leval,244,243,1
27,90,219000676,90067,Menoncourt,418,400,18
27,90,200087195,90068,Meroux-Moval,1417,1390,27
27,90,219000692,90069,Méziré,1319,1294,25
27,90,219000700,90070,Montbouton,412,403,9
27,90,219000718,90071,Montreux-Château,1193,1172,21
27,90,219000726,90072,Morvillars,1089,1068,21
27,90,219000742,90074,Novillard,308,304,4
27,90,219000759,90075,Offemont,4255,4164,91
27,90,219000767,90076,Pérouse,1222,1180,42
27,90,219000775,90077,Petit-Croix,305,298,7
27,90,219000783,90078,Petitefontaine,195,190,5
27,90,219000791,90079,Petitmagny,326,321,5
27,90,219000809,90080,Phaffans,448,435,13
27,90,219000817,90081,Réchésy,780,767,13
27,90,219000825,90082,Autrechêne,285,276,9
27,90,219000833,90083,Recouvrance,132,132,0
27,90,219000841,90084,Reppe,339,336,3
27,90,219000858,90085,Riervescemont,95,93,2
27,90,219000866,90086,Romagny-sous-Rougemont,226,219,7
27,90,219000874,90087,Roppe,1068,1037,31
27,90,219000882,90088,Rougegoutte,995,973,22
27,90,219000890,90089,Rougemont-le-Château,1543,1492,51
27,90,219000908,90090,Saint-Dizier-l'Évêque,445,433,12
27,90,219000916,90091,Saint-Germain-le-Châtelet,675,652,23
27,90,219000932,90093,Sermamagny,944,924,20
27,90,219000940,90094,Sevenans,725,703,22
27,90,219000957,90095,Suarce,435,432,3
27,90,219000965,90096,Thiancourt,288,280,8
27,90,219000973,90097,Trévenans,1313,1281,32
27,90,219000981,90098,Urcerey,249,245,4
27,90,219000999,90099,Valdoie,5489,5251,238
27,90,219001005,90100,Vauthiermont,206,195,11
27,90,219001013,90101,Vellescot,249,243,6
27,90,219001021,90102,Vescemont,735,712,23
27,90,219001039,90103,Vétrigne,690,668,22
27,90,219001047,90104,Vézelois,1022,999,23
27,90,219001054,90105,Villars-le-Sec,183,178,5
11,91,219100013,91001,Abbéville-la-Rivière,336,328,8
11,91,219100161,91016,Angerville,4427,4374,53
11,91,219100179,91017,Angervilliers,1750,1725,25
11,91,219100211,91021,Arpajon,11266,11165,101
11,91,219100229,91022,Arrancourt,131,126,5
11,91,219100278,91027,Athis-Mons,35927,35641,286
11,91,219100351,91035,Authon-la-Plaine,381,373,8
11,91,219100377,91037,Auvernaux,326,325,1
11,91,219100385,91038,Auvers-Saint-Georges,1293,1272,21
11,91,219100419,91041,Avrainville,1024,1017,7
11,91,219100443,91044,Ballainvilliers,4711,4666,45
11,91,219100450,91045,Ballancourt-sur-Essonne,7812,7706,106
11,91,219100476,91047,Baulne,1377,1363,14
11,91,219100641,91064,Bièvres,4873,4796,77
11,91,219100674,91067,Blandy,119,115,4
11,91,219100690,91069,Boigneville,399,390,9
11,91,219100757,91075,Bois-Herpin,82,81,1
11,91,219100799,91079,Boissy-la-Rivière,506,500,6
11,91,219100807,91080,Boissy-le-Cutté,1380,1367,13
11,91,219100815,91081,Boissy-le-Sec,708,692,16
11,91,219100856,91085,Boissy-sous-Saint-Yon,3853,3806,47
11,91,219100864,91086,Bondoufle,10426,10326,100
11,91,219100930,91093,Boullay-les-Troux,668,647,21
11,91,219100955,91095,Bouray-sur-Juine,2122,2095,27
11,91,219100971,91097,Boussy-Saint-Antoine,8057,7980,77
11,91,219100989,91098,Boutervilliers,435,430,5
11,91,219100997,91099,Boutigny-sur-Essonne,2994,2952,42
11,91,219101003,91100,Bouville,665,650,15
11,91,219101037,91103,Brétigny-sur-Orge,27361,27006,355
11,91,219101052,91105,Breuillet,8882,8759,123
11,91,219101060,91106,Breux-Jouy,1292,1280,12
11,91,219101094,91109,Brières-les-Scellés,1292,1282,10
11,91,219101110,91111,Briis-sous-Forges,3432,3394,38
11,91,219101128,91112,Brouy,129,125,4
11,91,219101144,91114,Brunoy,25775,25344,431
11,91,219101151,91115,Bruyères-le-Châtel,3639,3594,45
11,91,219101219,91121,Buno-Bonnevaux,468,464,4
11,91,219101227,91122,Bures-sur-Yvette,9442,9240,202
11,91,219101292,91129,Cerny,3510,3346,164
11,91,219101300,91130,Chalo-Saint-Mars,1048,1020,28
11,91,219101318,91131,Chalou-Moulineux,398,390,8
11,91,219101326,91132,Chamarande,1146,1134,12
11,91,219101359,91135,Champcueil,2937,2880,57
11,91,219101367,91136,Champlan,2788,2771,17
11,91,219101375,91137,Champmotteux,374,367,7
11,91,219101458,91145,Chatignonville,72,72,0
11,91,219101482,91148,Chauffour-lès-Étréchy,140,140,0
11,91,219101565,91156,Cheptainville,2257,2227,30
11,91,219101599,91159,Chevannes,1597,1569,28
11,91,219101615,91161,Chilly-Mazarin,20050,19943,107
11,91,219101748,91174,Corbeil-Essonnes,52613,52340,273
11,91,219101755,91175,Corbreuse,1742,1712,30
11,91,219101797,91179,Le Coudray-Montceaux,4871,4828,43
11,91,219101805,91180,Courances,342,332,10
11,91,219101847,91184,Courdimanche-sur-Essonne,284,277,7
11,91,219101862,91186,Courson-Monteloup,591,583,8
11,91,219101912,91191,Crosne,9508,9458,50
11,91,219101953,91195,Dannemois,845,833,12
11,91,219101987,91198,D'Huison-Longueville,1532,1509,23
11,91,219102001,91200,Dourdan,10910,10733,177
11,91,219102019,91201,Draveil,28851,28595,256
11,91,219102043,91204,Écharcon,781,768,13
11,91,219102076,91207,Égly,6595,6539,56
11,91,219102159,91215,Épinay-sous-Sénart,12280,12197,83
11,91,219102167,91216,Épinay-sur-Orge,11216,11102,114
11,91,219102233,91223,Étampes,26454,26251,203
11,91,219102258,91225,Étiolles,3262,3114,148
11,91,219102266,91226,Étréchy,6900,6806,94
11,91,200083525,91228,Évry-Courcouronnes,66543,66106,437
11,91,219102324,91232,La Ferté-Alais,3711,3656,55
11,91,219102357,91235,Fleury-Mérogis,13729,13708,21
11,91,219102407,91240,Fontaine-la-Rivière,183,179,4
11,91,219102431,91243,Fontenay-lès-Briis,2314,2281,33
11,91,219102449,91244,Fontenay-le-Vicomte,1592,1565,27
11,91,219102472,91247,La Forêt-le-Roi,521,510,11
11,91,219102480,91248,La Forêt-Sainte-Croix,164,163,1
11,91,219102498,91249,Forges-les-Bains,4048,3973,75
11,91,219102720,91272,Gif-sur-Yvette,21996,21439,557
11,91,219102738,91273,Gironville-sur-Essonne,781,763,18
11,91,219102746,91274,Gometz-la-Ville,1535,1511,24
11,91,219102753,91275,Gometz-le-Châtel,2666,2618,48
11,91,219102845,91284,Les Granges-le-Roi,1207,1184,23
11,91,219102860,91286,Grigny,27655,27571,84
11,91,219102928,91292,Guibeville,877,871,6
11,91,219102936,91293,Guigneville-sur-Essonne,910,893,17
11,91,219102944,91294,Guillerval,821,813,8
11,91,219103124,91312,Igny,10487,10157,330
11,91,219103157,91315,Itteville,6701,6638,63
11,91,219103181,91318,Janville-sur-Juine,2012,1964,48
11,91,219103199,91319,Janvry,648,638,10
11,91,219103264,91326,Juvisy-sur-Orge,17773,17656,117
11,91,219103306,91330,Lardy,5564,5462,102
11,91,219103322,91332,Leudeville,1582,1557,25
11,91,219103330,91333,Leuville-sur-Orge,4393,4350,43
11,91,219103389,91338,Limours,6581,6460,121
11,91,219103397,91339,Linas,6913,6864,49
11,91,219103405,91340,Lisses,7366,7302,64
11,91,219103454,91345,Longjumeau,21242,21105,137
11,91,219103470,91347,Longpont-sur-Orge,6461,6378,83
11,91,219103595,91359,Maisse,2848,2809,39
11,91,219103637,91363,Marcoussis,8398,8262,136
11,91,219103744,91374,Marolles-en-Beauce,243,239,4
11,91,219103769,91376,Marolles-en-Hurepoix,5660,5607,53
11,91,219103777,91377,Massy,50844,50506,338
11,91,219103785,91378,Mauchamps,334,331,3
11,91,219103868,91386,Mennecy,15914,15669,245
11,91,200082949,91390,Le Mérévillois,3350,3307,43
11,91,219103934,91393,Mérobert,638,630,8
11,91,219103991,91399,Mespuits,215,214,1
11,91,219104056,91405,Milly-la-Forêt,4711,4620,91
11,91,219104080,91408,Moigny-sur-École,1283,1252,31
11,91,219104114,91411,Les Molières,1905,1856,49
11,91,219104122,91412,Mondeville,744,733,11
11,91,219104148,91414,Monnerville,383,378,5
11,91,219104213,91421,Montgeron,24217,23943,274
11,91,219104254,91425,Montlhéry,8788,8561,227
11,91,219104320,91432,Morangis,13215,13131,84
11,91,219104338,91433,Morigny-Champigny,4481,4376,105
11,91,219104346,91434,Morsang-sur-Orge,20319,20149,170
11,91,219104353,91435,Morsang-sur-Seine,579,561,18
11,91,219104411,91441,Nainville-les-Roches,528,517,11
11,91,219104577,91457,La Norville,4362,4316,46
11,91,219104585,91458,Nozay,4563,4490,73
11,91,219104619,91461,Ollainville,4862,4803,59
11,91,219104635,91463,Oncy-sur-École,1061,1040,21
11,91,219104684,91468,Ormoy,2221,2200,21
11,91,219104692,91469,Ormoy-la-Rivière,959,909,50
11,91,219104718,91471,Orsay,15890,15554,336
11,91,219104734,91473,Orveau,157,155,2
11,91,219104775,91477,Palaiseau,35056,34750,306
11,91,219104791,91479,Paray-Vieille-Poste,7885,7823,62
11,91,219104825,91482,Pecqueuse,558,547,11
11,91,219104940,91494,Le Plessis-Pâté,4172,4114,58
11,91,219104957,91495,Plessis-Saint-Benoist,335,331,4
11,91,219105079,91507,Prunay-sur-Essonne,292,287,5
11,91,219105087,91508,Puiselet-le-Marais,263,259,4
11,91,219105111,91511,Pussay,2149,2120,29
11,91,219105145,91514,Quincy-sous-Sénart,9522,9463,59
11,91,219105194,91519,Richarville,402,391,11
11,91,219105210,91521,Ris-Orangis,29829,29643,186
11,91,219105251,91525,Roinville,1338,1313,25
11,91,219105269,91526,Roinvilliers,107,106,1
11,91,219105335,91533,Saclas,1878,1854,24
11,91,219105343,91534,Saclay,4319,4261,58
11,91,219105384,91538,Saint-Aubin,709,691,18
11,91,219105400,91540,Saint-Chéron,5343,5264,79
11,91,219105442,91544,Saint-Cyr-la-Rivière,512,506,6
11,91,219105467,91546,Saint-Cyr-sous-Dourdan,963,941,22
11,91,219105475,91547,Saint-Escobille,494,478,16
11,91,219105491,91549,Sainte-Geneviève-des-Bois,36190,35879,311
11,91,219105525,91552,Saint-Germain-lès-Arpajon,11150,11068,82
11,91,219105533,91553,Saint-Germain-lès-Corbeil,7571,7474,97
11,91,219105566,91556,Saint-Hilaire,416,408,8
11,91,219105608,91560,Saint-Jean-de-Beauregard,487,482,5
11,91,219105681,91568,Saint-Maurice-Montcouronne,1577,1540,37
11,91,219105707,91570,Saint-Michel-sur-Orge,21441,21298,143
11,91,219105731,91573,Saint-Pierre-du-Perray,11618,11514,104
11,91,219105772,91577,Saintry-sur-Seine,5901,5835,66
11,91,219105780,91578,Saint-Sulpice-de-Favières,273,268,5
11,91,219105798,91579,Saint-Vrain,3080,3029,51
11,91,219105814,91581,Saint-Yon,917,907,10
11,91,219105871,91587,Saulx-les-Chartreux,6650,6593,57
11,91,219105897,91589,Savigny-sur-Orge,37441,37190,251
11,91,219105939,91593,Sermaise,1642,1605,37
11,91,219105996,91599,Soisy-sur-École,1264,1245,19
11,91,219106002,91600,Soisy-sur-Seine,7357,7218,139
11,91,219106028,91602,Souzy-la-Briche,454,445,9
11,91,219106135,91613,Congerville-Thionville,223,215,8
11,91,219106176,91617,Tigery,4457,4380,77
11,91,219106192,91619,Torfou,283,273,10
11,91,219106291,91629,Valpuiseaux,634,620,14
11,91,219106309,91630,Le Val-Saint-Germain,1530,1498,32
11,91,219106317,91631,Varennes-Jarcy,2333,2302,31
11,91,219106341,91634,Vaugrigneuse,1421,1389,32
11,91,219106358,91635,Vauhallan,2087,2054,33
11,91,219106390,91639,Vayres-sur-Essonne,1030,962,68
11,91,219106457,91645,Verrières-le-Buisson,14931,14602,329
11,91,219106481,91648,Vert-le-Grand,2286,2260,26
11,91,219106499,91649,Vert-le-Petit,2810,2782,28
11,91,219106549,91654,Videlles,607,590,17
11,91,219106572,91657,Vigneux-sur-Seine,31640,31495,145
11,91,219106598,91659,Villabé,5513,5469,44
11,91,219106614,91661,Villebon-sur-Yvette,10573,10406,167
11,91,219106622,91662,Villeconin,761,747,14
11,91,219106655,91665,La Ville-du-Bois,8112,8021,91
11,91,219106663,91666,Villejust,2464,2446,18
11,91,219106671,91667,Villemoisson-sur-Orge,7102,7014,88
11,91,219106713,91671,Villeneuve-sur-Auvers,604,598,6
11,91,219106796,91679,Villiers-le-Bâcle,1177,1155,22
11,91,219106853,91685,Villiers-sur-Orge,4625,4592,33
11,91,219106879,91687,Viry-Châtillon,31297,31098,199
11,91,219106895,91689,Wissous,7134,7063,71
11,91,219106911,91691,Yerres,29325,29097,228
11,91,219106929,91692,Les Ulis,25299,25165,134
11,92,219200029,92002,Antony,63639,62906,733
11,92,219200045,92004,Asnières-sur-Seine,88672,88004,668
11,92,219200078,92007,Bagneux,42122,41967,155
11,92,219200094,92009,Bois-Colombes,29817,29555,262
11,92,219200128,92012,Boulogne-Billancourt,122162,120911,1251
11,92,219200144,92014,Bourg-la-Reine,21291,20974,317
11,92,219200193,92019,Châtenay-Malabry,34748,34383,365
11,92,219200201,92020,Châtillon,36688,36392,296
11,92,219200227,92022,Chaville,20830,20524,306
11,92,219200235,92023,Clamart,53740,53179,561
11,92,219200243,92024,Clichy,63166,62933,233
11,92,219200250,92025,Colombes,87328,86775,553
11,92,219200268,92026,Courbevoie,82701,82074,627
11,92,219200326,92032,Fontenay-aux-Roses,25389,25174,215
11,92,219200334,92033,Garches,17960,17557,403
11,92,219200359,92035,La Garenne-Colombes,29890,29624,266
11,92,219200367,92036,Gennevilliers,50096,49880,216
11,92,219200409,92040,Issy-les-Moulineaux,68641,67937,704
11,92,219200441,92044,Levallois-Perret,67809,67258,551
11,92,219200466,92046,Malakoff,31412,31230,182
11,92,219200474,92047,Marnes-la-Coquette,1815,1756,59
11,92,219200482,92048,Meudon,46517,45825,692
11,92,219200490,92049,Montrouge,48174,47907,267
11,92,219200508,92050,Nanterre,96402,95782,620
11,92,219200516,92051,Neuilly-sur-Seine,60411,59388,1023
11,92,219200607,92060,Le Plessis-Robinson,29719,29562,157
11,92,219200623,92062,Puteaux,44275,44009,266
11,92,219200631,92063,Rueil-Malmaison,79713,78265,1448
11,92,219200649,92064,Saint-Cloud,30115,29560,555
11,92,219200714,92071,Sceaux,20721,20359,362
11,92,219200722,92072,Sèvres,23472,23108,364
11,92,219200730,92073,Suresnes,49992,49482,510
11,92,219200755,92075,Vanves,28157,27871,286
11,92,219200763,92076,Vaucresson,8941,8627,314
11,92,219200771,92077,Ville-d'Avray,11170,10883,287
11,92,219200789,92078,Villeneuve-la-Garenne,24670,24592,78
11,93,219300019,93001,Aubervilliers,89559,89401,158
11,93,219300050,93005,Aulnay-sous-Bois,86873,86485,388
11,93,219300068,93006,Bagnolet,38571,38470,101
11,93,219300076,93007,Le Blanc-Mesnil,58116,57989,127
11,93,219300084,93008,Bobigny,55066,54906,160
11,93,219300100,93010,Bondy,53509,53342,167
11,93,219300134,93013,Le Bourget,15695,15660,35
11,93,219300142,93014,Clichy-sous-Bois,29624,29568,56
11,93,219300159,93015,Coubron,5017,4975,42
11,93,219300274,93027,La Courneuve,46951,46828,123
11,93,219300290,93029,Drancy,71535,71276,259
11,93,219300308,93030,Dugny,11232,11200,32
11,93,219300316,93031,Épinay-sur-Seine,54569,54419,150
11,93,219300324,93032,Gagny,39817,39588,229
11,93,219300332,93033,Gournay-sur-Marne,6876,6814,62
11,93,219300399,93039,L'Île-Saint-Denis,8665,8646,19
11,93,219300456,93045,Les Lilas,23396,23276,120
11,93,219300464,93046,Livry-Gargan,45818,45618,200
11,93,219300472,93047,Montfermeil,28141,28006,135
11,93,219300480,93048,Montreuil,111954,111367,587
11,93,219300498,93049,Neuilly-Plaisance,21059,20934,125
11,93,219300506,93050,Neuilly-sur-Marne,36640,36535,105
11,93,219300514,93051,Noisy-le-Grand,69352,68930,422
11,93,219300530,93053,Noisy-le-Sec,45156,45043,113
11,93,219300555,93055,Pantin,60597,60419,178
11,93,219300571,93057,Les Pavillons-sous-Bois,24003,23904,99
11,93,219300597,93059,Pierrefitte-sur-Seine,31393,31344,49
11,93,219300613,93061,Le Pré-Saint-Gervais,17342,17290,52
11,93,219300621,93062,Le Raincy,14949,14753,196
11,93,219300639,93063,Romainville,31554,31469,85
11,93,219300647,93064,Rosny-sous-Bois,45622,45442,180
11,93,219300662,93066,Saint-Denis,114027,113116,911
11,93,219300704,93070,Saint-Ouen-sur-Seine,51656,51547,109
11,93,219300712,93071,Sevran,51957,51778,179
11,93,219300720,93072,Stains,39277,39193,84
11,93,219300738,93073,Tremblay-en-France,36653,36477,176
11,93,219300746,93074,Vaujours,7283,7194,89
11,93,219300779,93077,Villemomble,30763,30583,180
11,93,219300787,93078,Villepinte,38283,38204,79
11,93,219300795,93079,Villetaneuse,13513,13433,80
11,94,219400017,94001,Ablon-sur-Seine,5938,5906,32
11,94,219400025,94002,Alfortville,45317,45151,166
11,94,219400033,94003,Arcueil,21962,21840,122
11,94,219400041,94004,Boissy-Saint-Léger,17345,17286,59
11,94,219400116,94011,Bonneuil-sur-Marne,18488,18424,64
11,94,219400157,94015,Bry-sur-Marne,17796,17592,204
11,94,219400165,94016,Cachan,30492,30214,278
11,94,219400173,94017,Champigny-sur-Marne,77751,77439,312
11,94,219400181,94018,Charenton-le-Pont,29842,29632,210
11,94,219400199,94019,Chennevières-sur-Marne,18115,18011,104
11,94,219400215,94021,Chevilly-Larue,20447,20372,75
11,94,219400223,94022,Choisy-le-Roi,46466,46229,237
11,94,219400280,94028,Créteil,92984,92566,418
11,94,219400330,94033,Fontenay-sous-Bois,51807,51386,421
11,94,219400348,94034,Fresnes,28679,28556,123
11,94,219400371,94037,Gentilly,18950,18813,137
11,94,219400389,94038,L'Haÿ-les-Roses,31847,31647,200
11,94,219400413,94041,Ivry-sur-Seine,64248,64016,232
11,94,219400421,94042,Joinville-le-Pont,19278,19128,150
11,94,219400439,94043,Le Kremlin-Bicêtre,24642,24513,129
11,94,219400447,94044,Limeil-Brévannes,28391,28290,101
11,94,219400462,94046,Maisons-Alfort,57944,57639,305
11,94,219400470,94047,Mandres-les-Roses,4836,4788,48
11,94,219400488,94048,Marolles-en-Brie,4844,4737,107
11,94,219400520,94052,Nogent-sur-Marne,33820,33578,242
11,94,219400538,94053,Noiseau,4644,4602,42
11,94,219400546,94054,Orly,24526,24361,165
11,94,219400553,94055,Ormesson-sur-Marne,10611,10528,83
11,94,219400561,94056,Périgny,2740,2707,33
11,94,219400587,94058,Le Perreux-sur-Marne,33981,33697,284
11,94,219400595,94059,Le Plessis-Trévise,19733,19651,82
11,94,219400603,94060,La Queue-en-Brie,12273,12148,125
11,94,219400652,94065,Rungis,5673,5625,48
11,94,219400678,94067,Saint-Mandé,22191,21991,200
11,94,219400686,94068,Saint-Maur-des-Fossés,75449,74520,929
11,94,219400694,94069,Saint-Maurice,14673,14560,113
11,94,219400702,94070,Santeny,4055,3994,61
11,94,219400710,94071,Sucy-en-Brie,27318,27040,278
11,94,219400736,94073,Thiais,30994,30788,206
11,94,219400744,94074,Valenton,14579,14538,41
11,94,219400751,94075,Villecresnes,11919,11846,73
11,94,219400769,94076,Villejuif,56585,56349,236
11,94,219400777,94077,Villeneuve-le-Roi,21493,21411,82
11,94,219400785,94078,Villeneuve-Saint-Georges,34939,34845,94
11,94,219400793,94079,Villiers-sur-Marne,29820,29672,148
11,94,219400801,94080,Vincennes,50168,49697,471
11,94,219400819,94081,Vitry-sur-Seine,96138,95649,489
11,95,219500022,95002,Ableiges,1119,1105,14
11,95,219500089,95008,Aincourt,891,879,12
11,95,219500113,95011,Ambleville,397,394,3
11,95,219500121,95012,Amenucourt,207,206,1
11,95,219500147,95014,Andilly,2744,2703,41
11,95,219500188,95018,Argenteuil,109058,108567,491
11,95,219500196,95019,Arnouville,14434,14364,70
11,95,219500238,95023,Arronville,633,630,3
11,95,219500246,95024,Arthies,275,271,4
11,95,219500261,95026,Asnières-sur-Oise,3125,3083,42
11,95,219500287,95028,Attainville,1703,1695,8
11,95,219500394,95039,Auvers-sur-Oise,6892,6792,100
11,95,200076446,95040,Avernes,873,860,13
11,95,219500428,95042,Baillet-en-France,1908,1893,15
11,95,219500469,95046,Banthelu,151,149,2
11,95,219500519,95051,Beauchamp,8993,8900,93
11,95,219500527,95052,Beaumont-sur-Oise,9671,9572,99
11,95,219500543,95054,Le Bellay-en-Vexin,219,214,5
11,95,219500550,95055,Bellefontaine,476,473,3
11,95,219500568,95056,Belloy-en-France,2227,2217,10
11,95,219500584,95058,Bernes-sur-Oise,2768,2743,25
11,95,219500592,95059,Berville,366,362,4
11,95,219500600,95060,Bessancourt,7933,7876,57
11,95,219500618,95061,Béthemont-la-Forêt,411,409,2
11,95,219500634,95063,Bezons,31978,31866,112
11,95,219500741,95074,Boisemont,872,855,17
11,95,219500782,95078,Boissy-l'Aillerie,1960,1934,26
11,95,219500881,95088,Bonneuil-en-France,1160,1158,2
11,95,219500915,95091,Bouffémont,6654,6596,58
11,95,219500949,95094,Bouqueval,306,303,3
11,95,219501012,95101,Bray-et-Lû,976,966,10
11,95,219501020,95102,Bréançon,429,420,9
11,95,219501103,95110,Brignancourt,224,221,3
11,95,219501160,95116,Bruyères-sur-Oise,4402,4367,35
11,95,219501194,95119,Buhy,323,320,3
11,95,219501202,95120,Butry-sur-Oise,2294,2266,28
11,95,219501277,95127,Cergy,68275,67790,485
11,95,219501343,95134,Champagne-sur-Oise,5080,5019,61
11,95,219501392,95139,La Chapelle-en-Vexin,327,322,5
11,95,219501418,95141,Charmont,36,36,0
11,95,219501426,95142,Chars,2059,2042,17
11,95,219501442,95144,Châtenay-en-France,78,77,1
11,95,219501491,95149,Chaumontel,3283,3230,53
11,95,219501509,95150,Chaussy,607,599,8
11,95,219501517,95151,Chauvry,302,297,5
11,95,219501541,95154,Chennevières-lès-Louvres,311,308,3
11,95,219501574,95157,Chérence,124,121,3
11,95,219501665,95166,Cléry-en-Vexin,479,473,6
11,95,219501699,95169,Commeny,514,511,3
11,95,219501707,95170,Condécourt,546,544,2
11,95,219501764,95176,Cormeilles-en-Parisis,26297,26074,223
11,95,219501772,95177,Cormeilles-en-Vexin,1312,1298,14
11,95,219501814,95181,Courcelles-sur-Viosne,301,298,3
11,95,219501830,95183,Courdimanche,6828,6720,108
11,95,219501970,95197,Deuil-la-Barre,22246,22050,196
11,95,219501996,95199,Domont,15874,15685,189
11,95,219502036,95203,Eaubonne,25782,25498,284
11,95,219502051,95205,Écouen,7142,7099,43
11,95,219502101,95210,Enghien-les-Bains,11574,11416,158
11,95,219502119,95211,Ennery,2490,2467,23
11,95,219502127,95212,Épiais-lès-Louvres,112,112,0
11,95,219502135,95213,Épiais-Rhus,631,616,15
11,95,219502143,95214,Épinay-Champlâtreux,66,66,0
11,95,219502184,95218,Éragny,18450,18317,133
11,95,219502192,95219,Ermont,29453,29230,223
11,95,219502291,95229,Ézanville,9651,9594,57
11,95,219502416,95241,Fontenay-en-Parisis,2091,2078,13
11,95,219502507,95250,Fosses,9895,9830,65
11,95,219502523,95252,Franconville,37494,37347,147
11,95,219502531,95253,Frémainville,524,515,9
11,95,219502549,95254,Frémécourt,558,551,7
11,95,219502564,95256,Frépillon,3392,3346,46
11,95,219502572,95257,La Frette-sur-Seine,4709,4655,54
11,95,219502580,95258,Frouville,357,349,8
11,95,219502689,95268,Garges-lès-Gonesse,43294,43215,79
11,95,219502705,95270,Genainville,546,537,9
11,95,219502713,95271,Génicourt,523,514,9
11,95,219502770,95277,Gonesse,25950,25853,97
11,95,219502804,95280,Goussainville,31052,30910,142
11,95,219502820,95282,Gouzangrez,160,156,4
11,95,219502879,95287,Grisy-les-Plâtres,711,698,13
11,95,219502887,95288,Groslay,8519,8474,45
11,95,219502952,95295,Guiry-en-Vexin,146,143,3
11,95,219502986,95298,Haravilliers,572,566,6
11,95,219503018,95301,Haute-Isle,296,290,6
11,95,219503034,95303,Le Heaulme,204,203,1
11,95,219503042,95304,Hédouville,283,281,2
11,95,219503067,95306,Herblay-sur-Seine,31970,31747,223
11,95,219503083,95308,Hérouville-en-Vexin,585,572,13
11,95,219503091,95309,Hodent,213,213,0
11,95,219503133,95313,L'Isle-Adam,11923,11723,200
11,95,219503166,95316,Jagny-sous-Bois,278,271,7
11,95,219503232,95323,Jouy-le-Moutier,17357,17225,132
11,95,219503281,95328,Labbeville,651,644,7
11,95,219503315,95331,Lassy,194,191,3
11,95,219503414,95341,Livilliers,386,382,4
11,95,219503489,95348,Longuesse,544,535,9
11,95,219503513,95351,Louvres,11436,11356,80
11,95,219503521,95352,Luzarches,4906,4828,78
11,95,219503539,95353,Maffliers,1848,1830,18
11,95,219503554,95355,Magny-en-Vexin,5865,5810,55
11,95,219503653,95365,Mareil-en-France,726,718,8
11,95,219503695,95369,Margency,2877,2830,47
11,95,219503703,95370,Marines,3491,3438,53
11,95,219503711,95371,Marly-la-Ville,5703,5661,42
11,95,219503794,95379,Maudétour-en-Vexin,196,193,3
11,95,219503877,95387,Menouville,63,63,0
11,95,219503885,95388,Menucourt,6045,5998,47
11,95,219503927,95392,Mériel,5266,5211,55
11,95,219503943,95394,Méry-sur-Oise,10083,9983,100
11,95,219503950,95395,Le Mesnil-Aubry,916,907,9
11,95,219504099,95409,Moisselles,1267,1264,3
11,95,219504222,95422,Montgeroult,341,338,3
11,95,219504248,95424,Montigny-lès-Cormeilles,22305,22186,119
11,95,219504263,95426,Montlignon,2991,2917,74
11,95,219504271,95427,Montmagny,14615,14550,65
11,95,219504289,95428,Montmorency,21942,21688,254
11,95,219504297,95429,Montreuil-sur-Epte,406,398,8
11,95,219504305,95430,Montsoult,3737,3703,34
11,95,219504362,95436,Mours,1663,1655,8
11,95,219504388,95438,Moussy,118,116,2
11,95,219504453,95445,Nerville-la-Forêt,758,753,5
11,95,219504461,95446,Nesles-la-Vallée,1811,1780,31
11,95,219504479,95447,Neuilly-en-Vexin,233,229,4
11,95,219504503,95450,Neuville-sur-Oise,2084,2056,28
11,95,219504529,95452,Nointel,875,868,7
11,95,219504560,95456,Noisy-sur-Oise,651,647,4
11,95,219504594,95459,Nucourt,718,706,12
11,95,219504628,95462,Omerville,330,322,8
11,95,219504768,95476,Osny,17330,17111,219
11,95,219504800,95480,Parmain,5714,5602,112
11,95,219504834,95483,Le Perchay,535,531,4
11,95,219504875,95487,Persan,14082,14029,53
11,95,219504883,95488,Pierrelaye,9772,9734,38
11,95,219504891,95489,Piscop,737,669,68
11,95,219504917,95491,Le Plessis-Bouchard,8524,8454,70
11,95,219504925,95492,Le Plessis-Gassot,84,82,2
11,95,219504933,95493,Le Plessis-Luzarches,131,130,1
11,95,219505005,95500,Pontoise,32453,31973,480
11,95,219505047,95504,Presles,3999,3948,51
11,95,219505096,95509,Puiseux-en-France,3615,3583,32
11,95,219505104,95510,Puiseux-Pontoise,582,571,11
11,95,219505237,95523,La Roche-Guyon,516,479,37
11,95,219505278,95527,Roissy-en-France,2817,2793,24
11,95,219505294,95529,Ronquerolles,894,874,20
11,95,219505351,95535,Sagy,1125,1103,22
11,95,219505393,95539,Saint-Brice-sous-Forêt,15182,15102,80
11,95,219505419,95541,Saint-Clair-sur-Epte,1003,993,10
11,95,219505435,95543,Saint-Cyr-en-Arthies,240,239,1
11,95,219505542,95554,Saint-Gervais,910,891,19
11,95,219505559,95555,Saint-Gratien,21060,20914,146
11,95,219505633,95563,Saint-Leu-la-Forêt,16242,16076,166
11,95,219505666,95566,Saint-Martin-du-Tertre,2679,2656,23
11,95,219505724,95572,Saint-Ouen-l'Aumône,24849,24743,106
11,95,219505740,95574,Saint-Prix,7298,7220,78
11,95,219505807,95580,Saint-Witz,2548,2439,109
11,95,219505823,95582,Sannois,26878,26524,354
11,95,219505849,95584,Santeuil,670,663,7
11,95,219505856,95585,Sarcelles,58715,58483,232
11,95,219505922,95592,Seraincourt,1311,1297,14
11,95,219505948,95594,Seugy,1052,1038,14
11,95,219505989,95598,Soisy-sous-Montmorency,18228,18061,167
11,95,219506045,95604,Survilliers,4305,4276,29
11,95,219506078,95607,Taverny,26773,26607,166
11,95,219506102,95610,Théméricourt,308,301,7
11,95,219506110,95611,Theuville,53,53,0
11,95,219506128,95612,Le Thillay,4617,4597,20
11,95,219506250,95625,Us,1350,1339,11
11,95,219506276,95627,Vallangoujard,606,594,12
11,95,219506284,95628,Valmondois,1247,1222,25
11,95,219506334,95633,Vaudherland,101,101,0
11,95,219506375,95637,Vauréal,16207,16020,187
11,95,219506417,95641,Vémars,2728,2710,18
11,95,219506516,95651,Vétheuil,903,885,18
11,95,219506524,95652,Viarmes,5329,5264,65
11,95,219506565,95656,Vienne-en-Arthies,382,376,6
11,95,219506581,95658,Vigny,1118,1098,20
11,95,219506607,95660,Villaines-sous-Bois,771,762,9
11,95,219506755,95675,Villeron,1548,1534,14
11,95,219506763,95676,Villers-en-Arthies,500,490,10
11,95,219506789,95678,Villiers-Adam,873,857,16
11,95,219506805,95680,Villiers-le-Bel,28742,28636,106
11,95,219506821,95682,Villiers-le-Sec,196,193,3
11,95,219506904,95690,Wy-dit-Joli-Village,333,330,3
01,971,219711017,97101,Les Abymes,53443,52948,495
01,971,219711025,97102,Anse-Bertrand,3929,3871,58
01,971,219711033,97103,Baie-Mahault,30774,30316,458
01,971,219711041,97104,Baillif,5210,5122,88
01,971,219711058,97105,Basse-Terre,10108,9892,216
01,971,219711066,97106,Bouillante,6869,6760,109
01,971,219711074,97107,Capesterre-Belle-Eau,17788,17628,160
01,971,219711082,97108,Capesterre-de-Marie-Galante,3274,3247,27
01,971,219711090,97109,Gourbeyre,7748,7638,110
01,971,219711108,97110,La Désirade,1436,1406,30
01,971,219711116,97111,Deshaies,4023,3963,60
01,971,219711124,97112,Grand-Bourg,4874,4803,71
01,971,219711132,97113,Le Gosier,27186,26919,267
01,971,219711140,97114,Goyave,7778,7635,143
01,971,219711157,97115,Lamentin,18071,17774,297
01,971,219711165,97116,Morne-à-l'Eau,16436,16223,213
01,971,219711173,97117,Le Moule,22499,22230,269
01,971,219711181,97118,Petit-Bourg,24781,24412,369
01,971,219711199,97119,Petit-Canal,8319,8195,124
01,971,219711207,97120,Pointe-à-Pitre,14581,14498,83
01,971,219711215,97121,Pointe-Noire,6095,5963,132
01,971,219711223,97122,Port-Louis,5680,5601,79
01,971,219711249,97124,Saint-Claude,10735,10506,229
01,971,219711256,97125,Saint-François,12322,12184,138
01,971,219711264,97126,Saint-Louis,2494,2462,32
01,971,219711280,97128,Sainte-Anne,24665,24430,235
01,971,219711298,97129,Sainte-Rose,18101,17840,261
01,971,219711306,97130,Terre-de-Bas,960,939,21
01,971,219711314,97131,Terre-de-Haut,1562,1513,49
01,971,219711322,97132,Trois-Rivières,7870,7733,137
01,971,219711330,97133,Vieux-Fort,1871,1841,30
01,971,219711348,97134,Vieux-Habitants,7245,7067,178
02,972,219722014,97201,L'Ajoupa-Bouillon,1770,1736,34
02,972,219722022,97202,Les Anses-d'Arlet,3656,3630,26
02,972,219722030,97203,Basse-Pointe,2768,2727,41
02,972,219722048,97204,Le Carbet,3475,3424,51
02,972,219722055,97205,Case-Pilote,4533,4475,58
02,972,219722063,97206,Le Diamant,5519,5447,72
02,972,219722071,97207,Ducos,17765,17504,261
02,972,219722089,97208,Fonds-Saint-Denis,673,661,12
02,972,219722097,97209,Fort-de-France,76085,75286,799
02,972,219722105,97210,Le François,16256,16082,174
02,972,219722113,97211,Grand'Rivière,568,554,14
02,972,219722121,97212,Gros-Morne,9822,9758,64
02,972,219722139,97213,Le Lamentin,40191,39628,563
02,972,219722147,97214,Le Lorrain,6798,6713,85
02,972,219722154,97215,Macouba,1037,1034,3
02,972,219722162,97216,Le Marigot,3126,3078,48
02,972,219722170,97217,Le Marin,8718,8647,71
02,972,219722188,97218,Le Morne-Rouge,4695,4635,60
02,972,219722196,97219,Le Prêcheur,1304,1291,13
02,972,219722204,97220,Rivière-Pilote,11818,11675,143
02,972,219722212,97221,Rivière-Salée,12024,11780,244
02,972,219722220,97222,Le Robert,21793,21627,166
02,972,219722238,97223,Saint-Esprit,10218,10120,98
02,972,219722246,97224,Saint-Joseph,16362,16137,225
02,972,219722253,97225,Saint-Pierre,4159,4107,52
02,972,219722261,97226,Sainte-Anne,4532,4464,68
02,972,219722279,97227,Sainte-Luce,9627,9425,202
02,972,219722287,97228,Sainte-Marie,15021,14843,178
02,972,219722295,97229,Schoelcher,19638,19467,171
02,972,219722303,97230,La Trinité,11995,11860,135
02,972,219722311,97231,Les Trois-Îlets,7320,7194,126
02,972,219722329,97232,Le Vauclin,8647,8552,95
02,972,219722337,97233,Le Morne-Vert,1837,1806,31
02,972,219722345,97234,Bellefontaine,1984,1858,126
03,973,219733011,97301,Régina,870,844,26
03,973,219733029,97302,Cayenne,66327,65956,371
03,973,219733037,97303,Iracoubo,1742,1729,13
03,973,219733045,97304,Kourou,25037,24805,232
03,973,219733052,97305,Macouria,19252,19087,165
03,973,219733060,97306,Mana,11763,11605,158
03,973,219733078,97307,Matoury,34666,34474,192
03,973,219733086,97308,Saint-Georges,4396,4303,93
03,973,219733094,97309,Remire-Montjoly,26126,25793,333
03,973,219733102,97310,Roura,3490,3436,54
03,973,219733110,97311,Saint-Laurent-du-Maroni,49475,49173,302
03,973,219733128,97312,Sinnamary,2899,2855,44
03,973,219733136,97313,Montsinéry-Tonnegrande,3161,3141,20
03,973,219733144,97314,Ouanary,267,266,1
03,973,219733524,97352,Saül,160,153,7
03,973,219733532,97353,Maripasoula,9904,9768,136
03,973,219733565,97356,Camopi,1918,1894,24
03,973,219733573,97357,Grand-Santi,8865,8859,6
03,973,219733581,97358,Saint-Élie,245,244,1
03,973,219733607,97360,Apatou,9603,9582,21
03,973,219733615,97361,Awala-Yalimapo,1488,1482,6
03,973,219733623,97362,Papaichton,5701,5684,17
04,974,219740016,97401,Les Avirons,11680,11470,210
04,974,219740024,97402,Bras-Panon,13622,13416,206
04,974,219740032,97403,Entre-Deux,7109,7040,69
04,974,219740040,97404,L'Étang-Salé,13841,13645,196
04,974,219740057,97405,Petite-Île,12543,12401,142
04,974,219740065,97406,La Plaine-des-Palmistes,6819,6723,96
04,974,219740073,97407,Le Port,32864,32619,245
04,974,219740081,97408,La Possession,33766,33370,396
04,974,219740099,97409,Saint-André,57329,56857,472
04,974,219740107,97410,Saint-Benoît,37265,36994,271
04,974,219740115,97411,Saint-Denis,154459,153001,1458
04,974,219740123,97412,Saint-Joseph,38997,38465,532
04,974,219740131,97413,Saint-Leu,35224,34740,484
04,974,219740149,97414,Saint-Louis,54322,53744,578
04,974,219740156,97415,Saint-Paul,105597,104301,1296
04,974,219740164,97416,Saint-Pierre,84822,83930,892
04,974,219740172,97417,Saint-Philippe,5150,5085,65
04,974,219740180,97418,Sainte-Marie,34774,34350,424
04,974,219740198,97419,Sainte-Rose,6317,6237,80
04,974,219740206,97420,Sainte-Suzanne,24327,24086,241
04,974,219740214,97421,Salazie,7386,7310,76
04,974,219740222,97422,Le Tampon,81728,80778,950
04,974,219740230,97423,Les Trois-Bassins,7043,6953,90
04,974,219740248,97424,Cilaos,5651,5568,83
06,976,200008712,97601,Acoua,5384,5192,192
06,976,200008720,97602,Bandraboua,14211,13989,222
06,976,200008738,97603,Bandrele,10529,10282,247
06,976,200008746,97604,Bouéni,6503,6189,314
06,976,200008753,97605,Chiconi,8616,8295,321
06,976,200008779,97606,Chirongui,9197,8920,277
06,976,200008787,97607,Dembeni,16116,15848,268
06,976,200008795,97608,Dzaoudzi,18237,17831,406
06,976,200008803,97609,Kani-Kéli,5716,5507,209
06,976,200008811,97610,Koungou,32752,32156,596
06,976,200008837,97611,Mamoudzou,72974,71437,1537
06,976,200008845,97612,Mtsamboro,8025,7705,320
06,976,200008829,97613,M'Tsangamouji,6586,6432,154
06,976,200008852,97614,Ouangani,10393,10203,190
06,976,200008860,97615,Pamandzi,11802,11442,360
06,976,200008878,97616,Sada,11619,11156,463
06,976,200008886,97617,Tsingoni,14235,13934,301
